County Name,Breed,Sex,0-1 Years,1-2 Years,2-3 Years,3-4 Years,4-5 Years,Over 5 Years,Totals
Bedfordshire,AA,F,43,66,1,4,10,11,135
Bedfordshire,AA,M,25,111,25,2,3,7,173
Bedfordshire,AAX,F,170,192,46,17,16,63,504
Bedfordshire,AAX,M,152,395,151,1,0,11,710
Bedfordshire,AN,F,0,0,0,0,0,3,3
Bedfordshire,AN,M,0,0,0,0,0,1,1
Bedfordshire,AY,F,0,0,0,1,0,0,1
Bedfordshire,AY,M,0,5,3,0,0,0,8
Bedfordshire,AYX,F,0,2,3,0,0,0,5
Bedfordshire,AYX,M,0,2,0,0,0,0,2
Bedfordshire,BA,F,1,18,0,2,5,4,30
Bedfordshire,BA,M,2,19,1,0,0,4,26
Bedfordshire,BABX,F,0,0,0,0,0,3,3
Bedfordshire,BAR,F,0,0,0,0,0,4,4
Bedfordshire,BAX,F,96,137,18,4,10,57,322
Bedfordshire,BAX,M,62,151,15,0,0,2,230
Bedfordshire,BAZX,F,1,1,0,0,0,0,2
Bedfordshire,BB,F,21,20,12,2,1,25,81
Bedfordshire,BB,M,14,16,5,2,1,13,51
Bedfordshire,BBX,F,182,217,110,20,18,59,606
Bedfordshire,BBX,M,114,136,83,0,0,14,347
Bedfordshire,BF,F,41,26,25,32,54,91,269
Bedfordshire,BF,M,29,100,31,0,0,0,160
Bedfordshire,BFX,F,0,5,8,0,0,1,14
Bedfordshire,BFX,M,0,4,3,0,0,0,7
Bedfordshire,BG,F,0,1,0,0,0,1,2
Bedfordshire,BG,M,0,0,0,0,0,1,1
Bedfordshire,BGX,F,0,0,1,0,0,0,1
Bedfordshire,BGX,M,0,1,1,0,0,0,2
Bedfordshire,BH,F,0,0,0,0,0,1,1
Bedfordshire,BH,M,0,0,0,0,0,1,1
Bedfordshire,BI,F,4,3,0,2,3,6,18
Bedfordshire,BI,M,3,1,2,2,1,2,11
Bedfordshire,BLGX,F,0,0,0,0,0,1,1
Bedfordshire,BSH,F,0,0,0,1,1,1,3
Bedfordshire,BSH,M,12,11,0,0,0,1,24
Bedfordshire,BSHX,F,6,1,0,0,0,0,7
Bedfordshire,BSHX,M,3,15,0,0,0,0,18
Bedfordshire,BSX,F,0,1,1,5,3,0,10
Bedfordshire,BSX,M,1,2,0,0,0,0,3
Bedfordshire,BW,F,19,14,6,12,7,15,73
Bedfordshire,BW,M,17,6,3,0,0,1,27
Bedfordshire,BWX,F,7,3,0,3,1,14,28
Bedfordshire,BWX,M,14,4,0,0,0,0,18
Bedfordshire,CB,F,0,0,0,0,0,3,3
Bedfordshire,CH,F,11,32,5,2,8,58,116
Bedfordshire,CH,M,20,48,13,0,2,12,95
Bedfordshire,CHX,F,176,221,75,31,24,267,794
Bedfordshire,CHX,M,114,245,63,1,1,8,432
Bedfordshire,DEV,F,13,10,11,6,5,16,61
Bedfordshire,DEV,M,10,5,3,1,0,1,20
Bedfordshire,DEVX,F,3,23,1,0,0,11,38
Bedfordshire,DEVX,M,6,21,2,0,0,0,29
Bedfordshire,DEX,F,7,10,12,6,6,24,65
Bedfordshire,DEX,M,12,13,3,3,1,3,35
Bedfordshire,DEXX,F,1,0,0,0,0,0,1
Bedfordshire,DG,F,0,0,0,0,0,17,17
Bedfordshire,DS,F,0,0,0,0,1,0,1
Bedfordshire,DS,M,1,0,0,0,0,0,1
Bedfordshire,DVX,F,0,0,0,0,0,1,1
Bedfordshire,FR,F,0,0,0,0,0,292,292
Bedfordshire,FR,M,0,0,0,0,0,34,34
Bedfordshire,FRX,F,0,0,0,0,0,10,10
Bedfordshire,FRX,M,0,0,0,0,0,3,3
Bedfordshire,GA,F,22,19,16,4,0,46,107
Bedfordshire,GA,M,19,31,4,0,0,4,58
Bedfordshire,GAX,F,0,1,1,1,0,5,8
Bedfordshire,GBX,M,0,1,0,0,0,0,1
Bedfordshire,GE,F,0,0,0,0,0,1,1
Bedfordshire,GE,M,0,0,0,0,1,3,4
Bedfordshire,GEX,F,8,20,2,0,1,4,35
Bedfordshire,GEX,M,31,15,0,0,0,0,46
Bedfordshire,GU,M,0,0,2,0,0,0,2
Bedfordshire,GUX,M,0,1,0,0,0,0,1
Bedfordshire,H,F,0,0,0,0,0,8,8
Bedfordshire,H,M,0,0,0,0,0,2,2
Bedfordshire,HE,F,18,6,14,8,3,13,62
Bedfordshire,HE,M,10,17,3,1,1,2,34
Bedfordshire,HEBL,F,0,0,0,0,0,6,6
Bedfordshire,HEBLX,F,0,0,0,0,0,14,14
Bedfordshire,HERX,F,0,0,0,0,0,2,2
Bedfordshire,HEX,F,49,118,59,35,22,92,375
Bedfordshire,HEX,M,51,102,47,3,1,3,207
Bedfordshire,HF,F,279,407,411,285,205,334,"1,921"
Bedfordshire,HF,M,89,109,65,2,4,17,286
Bedfordshire,HFX,F,0,1,1,0,0,2,4
Bedfordshire,HFX,M,9,19,3,0,0,0,31
Bedfordshire,HI,F,9,3,5,3,5,24,49
Bedfordshire,HI,M,7,10,1,0,1,1,20
Bedfordshire,HIX,F,2,5,2,1,0,3,13
Bedfordshire,HIX,M,7,2,0,3,0,0,12
Bedfordshire,HO,F,110,34,31,21,22,36,254
Bedfordshire,HO,M,10,26,8,1,2,1,48
Bedfordshire,HOX,F,48,18,21,10,5,0,102
Bedfordshire,HOX,M,4,0,0,1,0,0,5
Bedfordshire,HX,F,0,0,0,0,0,37,37
Bedfordshire,HX,M,0,0,0,0,0,3,3
Bedfordshire,JE,F,108,83,80,67,49,137,524
Bedfordshire,JE,M,4,3,2,0,0,0,9
Bedfordshire,JEX,F,4,7,15,0,0,0,26
Bedfordshire,JEX,M,0,2,0,0,0,0,2
Bedfordshire,LH,F,7,5,2,1,4,16,35
Bedfordshire,LH,M,5,16,0,0,0,1,22
Bedfordshire,LHX,F,0,0,0,0,0,1,1
Bedfordshire,LI,F,0,0,0,0,0,6,6
Bedfordshire,LI,M,0,0,0,0,0,5,5
Bedfordshire,LIM,F,26,33,3,8,4,25,99
Bedfordshire,LIM,M,24,146,13,4,5,15,207
Bedfordshire,LIM X,F,0,0,0,0,0,1,1
Bedfordshire,LIMBX,F,0,0,0,0,0,7,7
Bedfordshire,LIMBX,M,0,0,0,0,0,1,1
Bedfordshire,LIMR,F,0,0,0,0,0,1,1
Bedfordshire,LIMRX,F,0,0,0,0,0,11,11
Bedfordshire,LIMRX,M,0,0,0,0,0,1,1
Bedfordshire,LIMX,F,357,381,143,63,56,222,"1,222"
Bedfordshire,LIMX,M,346,477,80,9,0,8,920
Bedfordshire,LIX,F,0,0,0,0,0,93,93
Bedfordshire,LIX,M,0,0,0,0,0,20,20
Bedfordshire,LMX,F,0,0,0,0,0,1,1
Bedfordshire,LR,F,0,0,0,4,1,19,24
Bedfordshire,LR,M,1,0,0,0,0,0,1
Bedfordshire,MARX,F,0,0,0,0,0,1,1
Bedfordshire,MG,F,0,0,0,0,0,1,1
Bedfordshire,MGX,F,0,0,0,0,0,5,5
Bedfordshire,MGX,M,0,1,1,0,0,0,2
Bedfordshire,MO,F,0,0,0,0,0,2,2
Bedfordshire,MOX,F,1,3,1,1,0,0,6
Bedfordshire,MOX,M,3,0,0,0,0,0,3
Bedfordshire,MRI,F,0,0,0,0,0,2,2
Bedfordshire,MRI,M,0,0,3,0,0,0,3
Bedfordshire,MRIX,F,0,1,0,0,0,0,1
Bedfordshire,MRIX,M,0,7,0,0,0,0,7
Bedfordshire,NO,F,0,0,0,1,1,0,2
Bedfordshire,NO,M,0,1,0,0,0,0,1
Bedfordshire,NOX,F,1,1,0,0,0,0,2
Bedfordshire,NS,F,0,0,0,0,0,57,57
Bedfordshire,PI,F,0,0,0,0,0,1,1
Bedfordshire,PI,M,0,1,0,0,0,0,1
Bedfordshire,PIX,F,0,2,0,0,0,2,4
Bedfordshire,PIX,M,0,10,0,0,0,0,10
Bedfordshire,RP,F,4,4,4,1,1,10,24
Bedfordshire,RP,M,4,8,2,1,0,0,15
Bedfordshire,RPX,F,4,0,0,1,0,2,7
Bedfordshire,RPX,M,1,0,1,0,0,0,2
Bedfordshire,SAX,F,0,2,0,2,0,3,7
Bedfordshire,SAX,M,1,7,0,0,0,0,8
Bedfordshire,SD,F,9,2,5,6,2,9,33
Bedfordshire,SD,M,6,3,1,1,1,2,14
Bedfordshire,SDX,F,18,11,12,1,0,19,61
Bedfordshire,SDX,M,20,1,15,0,0,1,37
Bedfordshire,SH,F,1,4,0,2,1,3,11
Bedfordshire,SH,M,3,0,0,0,0,1,4
Bedfordshire,SHO,M,1,1,4,0,0,0,6
Bedfordshire,SHOX,F,1,0,0,0,0,0,1
Bedfordshire,SHOX,M,0,2,0,0,0,0,2
Bedfordshire,SHX,F,0,1,0,0,0,0,1
Bedfordshire,SHX,M,0,1,0,0,0,0,1
Bedfordshire,SM,F,30,35,16,10,6,32,129
Bedfordshire,SM,M,20,29,4,1,1,8,63
Bedfordshire,SMX,F,167,167,59,46,29,202,670
Bedfordshire,SMX,M,147,201,55,5,1,25,434
Bedfordshire,SOB,F,0,0,1,0,0,0,1
Bedfordshire,SOB,M,0,0,2,0,0,0,2
Bedfordshire,SOBX,F,0,0,0,0,0,1,1
Bedfordshire,SRWX,M,1,0,0,0,0,0,1
Bedfordshire,SU,F,5,1,0,4,0,4,14
Bedfordshire,SU,M,0,1,4,0,0,1,6
Bedfordshire,SUX,F,11,15,7,6,7,14,60
Bedfordshire,SUX,M,15,8,9,0,0,0,32
Bedfordshire,WBX,F,1,1,0,0,0,1,3
Bedfordshire,WP,F,0,0,3,0,0,0,3
Berkshire,AA,F,67,117,42,18,38,64,346
Berkshire,AA,M,65,92,12,5,6,14,194
Berkshire,AAX,F,563,640,147,85,54,392,"1,881"
Berkshire,AAX,M,597,455,58,3,4,42,"1,159"
Berkshire,ARX,F,0,0,1,0,0,0,1
Berkshire,AY,F,80,66,57,49,33,89,374
Berkshire,AY,M,10,3,1,0,0,1,15
Berkshire,AYX,F,1,9,24,20,6,2,62
Berkshire,AYX,M,0,12,0,0,0,0,12
Berkshire,BA,F,17,13,1,0,5,10,46
Berkshire,BA,M,6,5,2,0,0,4,17
Berkshire,BABX,F,0,0,0,0,0,4,4
Berkshire,BAWX,F,0,0,0,0,0,1,1
Berkshire,BAX,F,26,110,29,4,17,50,236
Berkshire,BAX,M,36,31,1,0,1,2,71
Berkshire,BAZX,F,0,0,0,2,0,1,3
Berkshire,BB,F,24,36,25,17,21,18,141
Berkshire,BB,M,13,25,2,2,1,10,53
Berkshire,BBX,F,184,363,89,47,29,142,854
Berkshire,BBX,M,227,133,26,2,0,23,411
Berkshire,BF,F,72,108,55,129,116,232,712
Berkshire,BF,M,141,181,68,8,7,14,419
Berkshire,BFX,F,28,63,18,13,0,1,123
Berkshire,BFX,M,44,55,3,0,1,0,103
Berkshire,BG,F,10,5,0,8,3,4,30
Berkshire,BG,M,7,3,0,0,0,0,10
Berkshire,BGX,F,1,3,1,0,0,1,6
Berkshire,BGX,M,3,2,0,0,0,0,5
Berkshire,BH,F,0,0,0,0,0,2,2
Berkshire,BLG,F,0,0,0,0,0,1,1
Berkshire,BS,F,1,0,4,0,0,3,8
Berkshire,BS,M,1,1,0,0,0,1,3
Berkshire,BSH,F,2,1,3,0,0,2,8
Berkshire,BSH,M,1,5,0,0,0,1,7
Berkshire,BSHX,F,24,21,5,17,4,9,80
Berkshire,BSHX,M,10,15,0,0,0,0,25
Berkshire,BSX,F,0,7,4,16,13,5,45
Berkshire,BSX,M,0,17,0,0,0,0,17
Berkshire,BU,F,7,13,0,0,0,0,20
Berkshire,BU,M,54,44,8,0,0,0,106
Berkshire,BW,F,17,13,11,11,9,31,92
Berkshire,BW,M,19,20,4,0,0,6,49
Berkshire,BWX,F,20,19,1,1,0,10,51
Berkshire,BWX,M,28,7,0,0,0,4,39
Berkshire,CB,F,0,0,2,0,8,10,20
Berkshire,CH,F,38,35,20,11,30,117,251
Berkshire,CH,M,39,25,2,5,8,21,100
Berkshire,CHX,F,369,336,44,25,50,298,"1,122"
Berkshire,CHX,M,348,180,18,1,1,32,580
Berkshire,DEV,F,6,1,2,1,1,5,16
Berkshire,DEV,M,9,0,0,0,0,0,9
Berkshire,DEVX,F,14,14,29,2,3,7,69
Berkshire,DEVX,M,11,3,7,0,0,0,21
Berkshire,DEX,F,44,23,24,15,21,77,204
Berkshire,DEX,M,53,22,11,2,1,13,102
Berkshire,DS,F,0,1,1,1,0,6,9
Berkshire,DS,M,0,6,1,1,0,0,8
Berkshire,DSX,F,1,0,0,0,0,0,1
Berkshire,DV,F,0,0,0,0,0,12,12
Berkshire,DV,M,0,0,0,0,0,1,1
Berkshire,DVX,F,0,0,0,0,0,2,2
Berkshire,FR,F,0,0,0,0,0,891,891
Berkshire,FR,M,0,0,0,0,0,38,38
Berkshire,FRX,F,0,0,0,0,0,40,40
Berkshire,FRX,M,0,0,0,0,0,7,7
Berkshire,GA,F,0,0,0,5,3,20,28
Berkshire,GA,M,0,2,0,0,1,1,4
Berkshire,GE,F,0,1,0,0,0,2,3
Berkshire,GEX,F,0,1,1,0,4,2,8
Berkshire,GEX,M,4,0,0,0,0,0,4
Berkshire,GL,F,1,0,1,0,1,4,7
Berkshire,GL,M,0,0,1,0,0,0,1
Berkshire,GLX,F,0,0,1,0,0,1,2
Berkshire,GU,F,14,15,13,15,16,73,146
Berkshire,GU,M,0,1,0,0,0,0,1
Berkshire,GUX,F,2,1,0,0,0,1,4
Berkshire,GUX,M,2,0,0,0,0,0,2
Berkshire,H,F,0,0,0,0,0,35,35
Berkshire,H,M,0,0,0,0,0,5,5
Berkshire,HE,F,42,42,17,19,27,72,219
Berkshire,HE,M,52,56,7,0,2,8,125
Berkshire,HEBL,F,0,0,0,0,0,4,4
Berkshire,HEBLX,F,0,0,0,0,0,18,18
Berkshire,HER,F,0,0,0,0,0,5,5
Berkshire,HER,M,0,0,0,0,0,2,2
Berkshire,HERX,F,0,0,0,0,0,10,10
Berkshire,HERX,M,0,0,0,0,0,2,2
Berkshire,HEX,F,186,316,66,89,95,282,"1,034"
Berkshire,HEX,M,194,223,40,10,2,1,470
Berkshire,HF,F,993,794,753,627,651,"1,084","4,902"
Berkshire,HF,M,597,459,71,10,7,17,"1,161"
Berkshire,HFX,F,90,73,73,52,59,116,463
Berkshire,HFX,M,46,6,17,0,0,4,73
Berkshire,HI,F,14,22,7,11,16,57,127
Berkshire,HI,M,23,22,9,1,0,5,60
Berkshire,HIX,F,1,1,0,6,0,2,10
Berkshire,HIX,M,0,1,0,0,0,0,1
Berkshire,HO,F,146,153,141,104,80,66,690
Berkshire,HO,M,87,70,4,0,0,4,165
Berkshire,HOX,F,0,1,0,0,0,13,14
Berkshire,HOX,M,4,0,0,0,0,0,4
Berkshire,HX,F,0,0,0,0,0,67,67
Berkshire,HX,M,0,0,0,0,0,8,8
Berkshire,IM,F,0,0,0,0,0,1,1
Berkshire,IM,M,1,0,0,0,0,0,1
Berkshire,JE,F,66,70,26,30,49,98,339
Berkshire,JE,M,15,15,0,0,0,1,31
Berkshire,JEX,F,65,3,2,0,1,4,75
Berkshire,JEX,M,38,24,0,0,0,0,62
Berkshire,JY,F,1,0,0,0,0,0,1
Berkshire,LH,F,4,3,2,2,2,12,25
Berkshire,LH,M,1,5,2,0,1,0,9
Berkshire,LHX,F,5,2,2,1,2,2,14
Berkshire,LHX,M,0,1,0,0,0,0,1
Berkshire,LI,F,0,0,0,0,0,5,5
Berkshire,LI,M,0,0,0,0,0,6,6
Berkshire,LIM,F,32,39,8,3,4,24,110
Berkshire,LIM,M,49,13,6,4,2,5,79
Berkshire,LIM X,F,0,0,0,0,0,1,1
Berkshire,LIMB,F,0,0,0,0,0,1,1
Berkshire,LIMBX,F,0,0,0,0,0,10,10
Berkshire,LIMBX,M,0,0,0,0,0,1,1
Berkshire,LIMRX,F,0,0,0,0,0,13,13
Berkshire,LIMX,F,356,418,77,31,61,142,"1,085"
Berkshire,LIMX,M,391,256,47,3,1,10,708
Berkshire,LIX,F,0,0,0,0,0,68,68
Berkshire,LIX,M,0,0,0,0,0,28,28
Berkshire,LMX,F,0,0,0,0,0,1,1
Berkshire,LR,F,5,2,0,0,1,3,11
Berkshire,LR,M,1,1,0,0,0,0,2
Berkshire,LRX,F,0,1,0,0,0,0,1
Berkshire,MAR,F,0,0,2,0,0,0,2
Berkshire,MAR,M,0,0,0,0,0,1,1
Berkshire,MARX,F,3,3,4,3,9,15,37
Berkshire,MARX,M,5,0,0,0,0,1,6
Berkshire,MG,F,0,0,1,0,0,1,2
Berkshire,MG,M,0,0,0,0,0,1,1
Berkshire,MGX,F,0,0,0,0,0,6,6
Berkshire,MO,M,0,1,0,0,0,0,1
Berkshire,MOX,F,0,0,1,0,0,0,1
Berkshire,MOX,M,3,0,1,0,0,0,4
Berkshire,MRI,F,0,0,0,0,0,1,1
Berkshire,MRIX,F,0,0,0,0,0,4,4
Berkshire,MRIX,M,2,5,0,0,0,0,7
Berkshire,ND,F,0,0,0,0,0,3,3
Berkshire,NO,F,0,0,0,5,0,0,5
Berkshire,NO,M,0,8,0,0,0,0,8
Berkshire,NRX,F,3,0,0,0,0,0,3
Berkshire,NS,F,0,0,0,0,0,40,40
Berkshire,NS,M,0,0,0,0,0,1,1
Berkshire,PI,F,13,11,0,0,0,0,24
Berkshire,PI,M,7,12,0,0,0,1,20
Berkshire,PIX,F,2,4,3,5,1,4,19
Berkshire,PIX,M,1,2,0,0,0,1,4
Berkshire,ROX,F,0,0,0,0,0,3,3
Berkshire,RP,F,14,5,5,1,3,23,51
Berkshire,RP,M,8,5,0,1,0,1,15
Berkshire,RPX,F,0,0,0,1,1,2,4
Berkshire,RPX,M,0,0,0,0,0,4,4
Berkshire,SA,F,0,2,3,0,0,20,25
Berkshire,SA,M,0,9,1,0,0,0,10
Berkshire,SAX,F,2,12,0,0,0,23,37
Berkshire,SAX,M,1,0,1,0,0,0,2
Berkshire,SD,F,13,32,37,19,9,33,143
Berkshire,SD,M,24,23,7,2,1,7,64
Berkshire,SDX,F,101,100,19,22,17,12,271
Berkshire,SDX,M,102,88,2,0,1,0,193
Berkshire,SH,F,0,0,0,0,0,1,1
Berkshire,SHO,F,0,0,0,0,42,5,47
Berkshire,SHO,M,0,0,1,0,0,0,1
Berkshire,SHOX,F,0,2,0,0,1,3,6
Berkshire,SHOX,M,2,7,0,0,0,0,9
Berkshire,SHX,F,0,1,0,0,1,1,3
Berkshire,SM,F,41,45,30,13,11,54,194
Berkshire,SM,M,37,27,9,1,2,16,92
Berkshire,SMX,F,306,406,138,84,124,609,"1,667"
Berkshire,SMX,M,297,152,24,2,2,22,499
Berkshire,SRWX,F,0,2,0,0,0,0,2
Berkshire,SRWX,M,6,6,0,0,0,0,12
Berkshire,SU,F,45,44,18,8,7,64,186
Berkshire,SU,M,33,35,3,1,1,1,74
Berkshire,SUX,F,1,7,10,1,5,10,34
Berkshire,SUX,M,2,4,9,1,0,1,17
Berkshire,WB,M,0,1,0,0,0,0,1
Berkshire,WBX,F,1,0,1,0,0,0,2
Berkshire,WBX,M,3,0,0,0,0,0,3
Berkshire,WG,F,7,5,0,0,0,3,15
Berkshire,WG,M,6,1,0,0,0,0,7
Berkshire,WP,F,0,3,0,0,0,3,6
Berkshire,WP,M,0,5,2,1,0,0,8
Berkshire,WPX,F,0,0,0,0,0,2,2
Buckinghamshire,AA,F,238,183,101,70,50,142,784
Buckinghamshire,AA,M,264,242,62,18,7,47,640
Buckinghamshire,AAX,F,995,952,272,128,128,394,"2,869"
Buckinghamshire,AAX,M,"1,060","1,332",226,8,2,15,"2,643"
Buckinghamshire,ARX,M,1,0,0,0,0,0,1
Buckinghamshire,AY,F,17,25,50,27,20,106,245
Buckinghamshire,AY,M,6,9,15,6,0,3,39
Buckinghamshire,AYX,F,0,1,0,0,1,2,4
Buckinghamshire,AYX,M,0,2,0,0,0,0,2
Buckinghamshire,BA,F,8,25,10,7,1,51,102
Buckinghamshire,BA,M,8,30,13,6,4,22,83
Buckinghamshire,BABX,F,0,0,0,0,0,4,4
Buckinghamshire,BABX,M,0,0,0,0,0,1,1
Buckinghamshire,BAL,M,1,0,0,0,0,0,1
Buckinghamshire,BARX,F,0,0,0,0,0,4,4
Buckinghamshire,BAWX,F,0,0,0,0,0,2,2
Buckinghamshire,BAWX,M,0,0,0,0,0,1,1
Buckinghamshire,BAX,F,480,503,132,110,105,421,"1,751"
Buckinghamshire,BAX,M,497,603,89,1,3,30,"1,223"
Buckinghamshire,BAZX,M,0,2,1,0,0,0,3
Buckinghamshire,BB,F,51,39,18,22,12,111,253
Buckinghamshire,BB,M,60,63,21,4,6,42,196
Buckinghamshire,BBX,F,584,730,330,265,244,798,"2,951"
Buckinghamshire,BBX,M,868,837,322,10,1,44,"2,082"
Buckinghamshire,BF,F,389,350,344,416,401,658,"2,558"
Buckinghamshire,BF,M,288,212,135,5,2,9,651
Buckinghamshire,BFX,F,53,43,38,6,21,16,177
Buckinghamshire,BFX,M,47,40,17,0,1,2,107
Buckinghamshire,BG,F,2,4,1,2,1,11,21
Buckinghamshire,BG,M,7,6,0,0,0,1,14
Buckinghamshire,BGX,F,0,0,2,1,0,0,3
Buckinghamshire,BGX,M,2,0,1,0,0,0,3
Buckinghamshire,BH,F,0,0,0,0,0,24,24
Buckinghamshire,BHX,F,0,0,0,0,0,3,3
Buckinghamshire,BHX,M,0,0,0,0,0,1,1
Buckinghamshire,BP,F,0,1,0,0,0,0,1
Buckinghamshire,BRX,F,1,0,0,0,0,0,1
Buckinghamshire,BRX,M,1,0,0,0,0,0,1
Buckinghamshire,BS,F,2,0,3,4,0,4,13
Buckinghamshire,BSH,F,17,8,4,7,6,19,61
Buckinghamshire,BSH,M,6,3,0,3,0,0,12
Buckinghamshire,BSHO,M,0,0,0,0,0,1,1
Buckinghamshire,BSHX,F,0,7,1,1,4,1,14
Buckinghamshire,BSHX,M,3,7,0,0,0,0,10
Buckinghamshire,BSX,F,3,3,3,6,4,5,24
Buckinghamshire,BSX,M,3,30,8,1,0,0,42
Buckinghamshire,BU,F,6,4,8,0,1,9,28
Buckinghamshire,BU,M,0,0,3,0,0,0,3
Buckinghamshire,BW,F,7,3,13,6,2,14,45
Buckinghamshire,BW,M,11,1,1,1,1,3,18
Buckinghamshire,BWX,F,1,1,1,4,0,3,10
Buckinghamshire,BWX,M,3,2,0,0,0,0,5
Buckinghamshire,BX,F,0,0,0,0,0,2,2
Buckinghamshire,CB,F,0,1,0,0,0,33,34
Buckinghamshire,CB,M,1,1,0,0,0,0,2
Buckinghamshire,CD,F,0,0,1,1,0,0,2
Buckinghamshire,CH,F,217,238,104,68,68,349,"1,044"
Buckinghamshire,CH,M,180,178,41,14,10,53,476
Buckinghamshire,CHX,F,861,873,254,112,106,873,"3,079"
Buckinghamshire,CHX,M,921,"1,277",241,12,2,76,"2,529"
Buckinghamshire,CON,F,0,0,0,0,0,11,11
Buckinghamshire,CON,M,0,0,0,0,0,20,20
Buckinghamshire,DE,F,0,0,0,0,0,3,3
Buckinghamshire,DEV,F,5,6,1,8,3,26,49
Buckinghamshire,DEV,M,4,11,3,1,0,2,21
Buckinghamshire,DEVX,F,45,28,23,8,9,23,136
Buckinghamshire,DEVX,M,43,51,5,1,0,1,101
Buckinghamshire,DEX,F,30,16,20,13,24,83,186
Buckinghamshire,DEX,M,39,20,4,3,1,8,75
Buckinghamshire,DEXX,F,0,3,0,0,0,4,7
Buckinghamshire,DEXX,M,0,1,1,0,0,0,2
Buckinghamshire,DRX,M,0,1,0,0,0,0,1
Buckinghamshire,DS,F,1,2,1,0,0,5,9
Buckinghamshire,DS,M,0,2,0,0,0,0,2
Buckinghamshire,DSX,F,16,6,0,0,0,0,22
Buckinghamshire,DSX,M,14,5,0,0,0,0,19
Buckinghamshire,DV,F,0,0,0,0,0,53,53
Buckinghamshire,DV,M,0,0,0,0,0,6,6
Buckinghamshire,DVX,F,0,0,0,0,0,9,9
Buckinghamshire,DVX,M,0,0,0,0,0,1,1
Buckinghamshire,FR,F,0,0,0,0,0,"1,781","1,781"
Buckinghamshire,FR,M,0,0,0,0,0,58,58
Buckinghamshire,FRX,F,0,0,0,0,0,80,80
Buckinghamshire,FRX,M,0,0,0,0,0,10,10
Buckinghamshire,GA,F,0,0,0,0,0,7,7
Buckinghamshire,GA,M,0,5,0,0,0,1,6
Buckinghamshire,GAX,F,0,0,0,0,0,7,7
Buckinghamshire,GAX,M,0,2,0,0,0,0,2
Buckinghamshire,GAY,F,0,0,0,0,1,2,3
Buckinghamshire,GAY,M,0,1,0,0,0,0,1
Buckinghamshire,GBX,F,1,0,0,0,0,1,2
Buckinghamshire,GBX,M,1,1,0,0,0,0,2
Buckinghamshire,GE,F,3,4,0,0,1,13,21
Buckinghamshire,GE,M,6,5,0,0,0,2,13
Buckinghamshire,GEX,F,11,8,0,0,1,13,33
Buckinghamshire,GEX,M,14,23,1,0,0,1,39
Buckinghamshire,GL,F,0,0,0,0,0,5,5
Buckinghamshire,GL,M,0,1,0,0,0,0,1
Buckinghamshire,GLX,F,0,0,1,0,1,0,2
Buckinghamshire,GU,F,38,28,57,68,61,198,450
Buckinghamshire,GU,M,14,6,3,0,0,2,25
Buckinghamshire,GUX,M,0,0,0,0,0,1,1
Buckinghamshire,H,F,0,0,0,0,0,69,69
Buckinghamshire,H,M,0,0,0,0,0,15,15
Buckinghamshire,HE,F,65,65,35,42,31,133,371
Buckinghamshire,HE,M,63,109,33,10,5,15,235
Buckinghamshire,HEBLX,F,0,0,0,0,0,59,59
Buckinghamshire,HEBLX,M,0,0,0,0,0,4,4
Buckinghamshire,HER,F,0,0,0,0,0,6,6
Buckinghamshire,HER,M,0,0,0,0,0,2,2
Buckinghamshire,HERX,F,0,0,0,0,0,20,20
Buckinghamshire,HEX,F,469,480,262,129,86,644,"2,070"
Buckinghamshire,HEX,M,518,732,248,2,1,22,"1,523"
Buckinghamshire,HF,F,901,"1,003","1,061",877,958,"1,671","6,471"
Buckinghamshire,HF,M,830,727,434,29,7,28,"2,055"
Buckinghamshire,HFX,F,96,92,83,97,51,107,526
Buckinghamshire,HFX,M,123,82,26,4,1,0,236
Buckinghamshire,HI,F,13,21,15,17,10,89,165
Buckinghamshire,HI,M,10,16,7,2,5,22,62
Buckinghamshire,HIX,F,3,5,2,1,3,2,16
Buckinghamshire,HIX,M,2,4,0,0,0,2,8
Buckinghamshire,HL,F,0,0,0,0,0,1,1
Buckinghamshire,HO,F,207,203,195,178,99,249,"1,131"
Buckinghamshire,HO,M,54,72,24,1,1,2,154
Buckinghamshire,HOX,F,22,6,6,0,1,14,49
Buckinghamshire,HOX,M,3,2,3,0,0,0,8
Buckinghamshire,HX,F,0,0,0,0,0,196,196
Buckinghamshire,HX,M,0,0,0,0,0,20,20
Buckinghamshire,IM,F,0,0,0,0,0,1,1
Buckinghamshire,JE,F,140,101,176,110,139,397,"1,063"
Buckinghamshire,JE,M,11,5,3,1,0,1,21
Buckinghamshire,JEX,F,5,1,4,1,1,17,29
Buckinghamshire,JEX,M,2,0,0,0,0,0,2
Buckinghamshire,JY,F,9,0,0,0,0,4,13
Buckinghamshire,LH,F,16,11,14,7,13,48,109
Buckinghamshire,LH,M,17,22,3,0,0,4,46
Buckinghamshire,LHX,F,0,8,0,1,3,7,19
Buckinghamshire,LHX,M,1,3,1,0,0,0,5
Buckinghamshire,LI,F,0,0,0,0,0,101,101
Buckinghamshire,LI,M,0,0,0,0,0,23,23
Buckinghamshire,LIM,F,315,256,176,147,99,493,"1,486"
Buckinghamshire,LIM,M,377,255,58,32,14,55,791
Buckinghamshire,LIM X,F,0,0,0,0,0,6,6
Buckinghamshire,LIMB,F,0,0,0,0,0,5,5
Buckinghamshire,LIMBX,F,0,0,0,0,0,58,58
Buckinghamshire,LIMR,F,0,0,0,0,0,6,6
Buckinghamshire,LIMRX,F,0,0,0,0,0,52,52
Buckinghamshire,LIMRX,M,0,0,0,0,0,1,1
Buckinghamshire,LIMX,F,"1,418","1,526",449,238,237,"1,325","5,193"
Buckinghamshire,LIMX,M,"1,595","1,761",402,31,7,36,"3,832"
Buckinghamshire,LIX,F,0,0,0,0,0,384,384
Buckinghamshire,LIX,M,0,0,0,0,0,50,50
Buckinghamshire,LM,F,0,0,0,0,0,3,3
Buckinghamshire,LMX,F,0,0,0,0,0,3,3
Buckinghamshire,LMX,M,0,0,0,0,0,1,1
Buckinghamshire,LRX,F,0,1,0,0,0,0,1
Buckinghamshire,LU,F,0,0,1,0,0,0,1
Buckinghamshire,MARX,F,0,2,0,0,0,0,2
Buckinghamshire,MARX,M,0,1,1,0,0,0,2
Buckinghamshire,MG,F,7,4,2,2,5,22,42
Buckinghamshire,MG,M,1,8,2,0,1,5,17
Buckinghamshire,MGX,F,6,3,3,0,0,13,25
Buckinghamshire,MGX,M,7,9,0,0,0,1,17
Buckinghamshire,MO,F,1,1,0,0,0,0,2
Buckinghamshire,MO,M,9,8,1,0,0,0,18
Buckinghamshire,MOX,F,0,1,2,0,0,1,4
Buckinghamshire,MOX,M,6,12,9,1,0,0,28
Buckinghamshire,MRI,F,0,0,0,0,0,6,6
Buckinghamshire,MRI,M,0,2,0,0,0,4,6
Buckinghamshire,MRIX,F,0,0,0,1,0,4,5
Buckinghamshire,MRIX,M,2,25,11,0,0,0,38
Buckinghamshire,NDX,M,0,0,0,0,0,1,1
Buckinghamshire,NO,F,1,2,1,3,0,0,7
Buckinghamshire,NO,M,1,0,0,0,0,0,1
Buckinghamshire,NOX,F,1,1,2,0,0,1,5
Buckinghamshire,NOX,M,4,1,0,0,0,0,5
Buckinghamshire,NR,M,1,0,0,0,0,0,1
Buckinghamshire,NRX,F,7,0,0,0,0,0,7
Buckinghamshire,NRX,M,3,0,0,0,0,0,3
Buckinghamshire,NS,F,0,0,0,0,0,153,153
Buckinghamshire,OB,F,0,0,0,0,0,1,1
Buckinghamshire,PAX,F,5,2,0,1,0,0,8
Buckinghamshire,PAX,M,1,2,0,0,0,0,3
Buckinghamshire,PI,F,0,0,2,1,0,3,6
Buckinghamshire,PI,M,0,0,1,1,0,3,5
Buckinghamshire,PIX,F,39,25,11,3,1,15,94
Buckinghamshire,PIX,M,21,31,7,1,0,0,60
Buckinghamshire,ROX,F,0,6,1,3,0,1,11
Buckinghamshire,ROX,M,0,1,4,0,0,0,5
Buckinghamshire,RP,F,26,14,13,18,11,39,121
Buckinghamshire,RP,M,20,7,2,1,1,2,33
Buckinghamshire,RPX,F,11,7,4,3,0,7,32
Buckinghamshire,RPX,M,12,5,0,0,0,0,17
Buckinghamshire,RWFR,F,0,0,0,0,0,1,1
Buckinghamshire,SA,F,3,1,1,1,2,3,11
Buckinghamshire,SA,M,1,1,2,0,0,0,4
Buckinghamshire,SAX,F,1,7,2,0,5,30,45
Buckinghamshire,SAX,M,0,37,4,0,1,1,43
Buckinghamshire,SBX,M,0,1,0,0,0,0,1
Buckinghamshire,SD,F,97,95,79,54,50,176,551
Buckinghamshire,SD,M,88,27,4,5,1,5,130
Buckinghamshire,SDX,F,101,65,35,5,11,43,260
Buckinghamshire,SDX,M,121,89,18,0,0,3,231
Buckinghamshire,SH,F,3,0,4,0,1,0,8
Buckinghamshire,SH,M,0,1,0,0,0,0,1
Buckinghamshire,SHO,F,1,1,1,0,1,23,27
Buckinghamshire,SHO,M,0,6,1,0,0,2,9
Buckinghamshire,SHOX,F,34,19,16,9,5,17,100
Buckinghamshire,SHOX,M,26,18,5,0,0,0,49
Buckinghamshire,SHX,F,0,2,0,0,0,1,3
Buckinghamshire,SHX,M,4,2,0,0,0,0,6
Buckinghamshire,SM,F,83,135,59,51,38,274,640
Buckinghamshire,SM,M,131,126,37,14,11,40,359
Buckinghamshire,SMX,F,907,"1,005",360,235,267,"1,371","4,145"
Buckinghamshire,SMX,M,"1,094","1,245",273,4,13,90,"2,719"
Buckinghamshire,SRWX,F,2,0,0,0,1,1,4
Buckinghamshire,ST,M,0,0,0,1,0,0,1
Buckinghamshire,STX,F,7,0,0,0,0,0,7
Buckinghamshire,STX,M,8,5,0,0,0,0,13
Buckinghamshire,SU,F,0,2,0,0,0,4,6
Buckinghamshire,SU,M,2,9,3,5,0,1,20
Buckinghamshire,SUX,F,13,23,12,1,0,6,55
Buckinghamshire,SUX,M,29,77,22,0,0,0,128
Buckinghamshire,WB,F,0,0,0,0,2,10,12
Buckinghamshire,WB,M,0,1,0,0,0,1,2
Buckinghamshire,WBX,F,5,0,2,8,0,6,21
Buckinghamshire,WBX,M,2,6,2,0,0,3,13
Buckinghamshire,WP,M,0,0,2,0,0,0,2
Buckinghamshire,WPX,F,0,0,0,2,0,0,2
Buckinghamshire,WPX,M,1,0,0,0,0,0,1
Buckinghamshire,WSX,F,0,0,0,0,0,9,9
Buckinghamshire,WSX,M,0,1,0,0,0,0,1
Buckinghamshire,YK,F,1,0,2,1,1,0,5
Buckinghamshire,YK,M,1,0,0,1,0,0,2
Buckinghamshire,ZE,F,1,2,0,1,2,0,6
Buckinghamshire,ZE,M,0,0,0,1,0,0,1
Cleveland,AA,F,22,32,9,9,11,63,146
Cleveland,AA,M,28,28,8,4,3,6,77
Cleveland,AAX,F,133,119,42,36,41,227,598
Cleveland,AAX,M,114,78,34,8,0,14,248
Cleveland,AR,M,0,1,0,0,0,0,1
Cleveland,ARX,F,0,1,0,0,0,0,1
Cleveland,AY,F,8,26,35,21,11,64,165
Cleveland,AY,M,11,15,5,8,0,2,41
Cleveland,AYX,F,18,3,3,0,1,1,26
Cleveland,AYX,M,7,2,1,0,0,0,10
Cleveland,BA,F,47,44,21,16,13,52,193
Cleveland,BA,M,48,23,3,5,2,11,92
Cleveland,BABX,F,0,0,0,0,0,1,1
Cleveland,BALX,F,0,0,0,0,1,0,1
Cleveland,BARX,F,0,0,0,0,0,1,1
Cleveland,BAWX,F,0,0,0,0,0,1,1
Cleveland,BAX,F,77,157,30,24,20,73,381
Cleveland,BAX,M,109,66,13,1,1,5,195
Cleveland,BAZ,M,0,1,0,0,0,0,1
Cleveland,BAZX,F,4,4,1,1,0,0,10
Cleveland,BAZX,M,1,2,0,0,0,0,3
Cleveland,BB,F,39,34,13,2,9,22,119
Cleveland,BB,M,33,34,10,1,0,5,83
Cleveland,BBX,F,148,207,86,85,42,162,730
Cleveland,BBX,M,206,181,22,2,0,8,419
Cleveland,BF,F,82,47,62,78,63,130,462
Cleveland,BF,M,85,32,28,3,0,0,148
Cleveland,BFX,F,11,7,14,13,8,25,78
Cleveland,BFX,M,8,2,1,0,0,0,11
Cleveland,BG,F,0,0,0,1,0,1,2
Cleveland,BG,M,1,0,0,0,0,0,1
Cleveland,BGX,F,1,0,0,0,0,1,2
Cleveland,BGX,M,1,0,0,2,0,0,3
Cleveland,BH,F,0,0,0,0,0,6,6
Cleveland,BLG,F,0,0,0,0,0,3,3
Cleveland,BRX,F,0,0,0,0,0,1,1
Cleveland,BS,F,0,0,0,0,0,1,1
Cleveland,BS,M,1,3,0,0,0,0,4
Cleveland,BSH,F,8,9,7,4,4,21,53
Cleveland,BSH,M,16,5,1,0,0,2,24
Cleveland,BSHO,F,0,0,0,0,0,1,1
Cleveland,BSHX,F,1,2,1,2,0,9,15
Cleveland,BSHX,M,3,1,1,0,0,0,5
Cleveland,BSX,F,0,0,0,3,0,0,3
Cleveland,BSX,M,1,0,0,0,0,0,1
Cleveland,BW,F,3,2,3,1,0,7,16
Cleveland,BW,M,1,1,0,0,0,0,2
Cleveland,BWX,F,1,0,0,0,0,2,3
Cleveland,BWX,M,0,1,0,0,0,0,1
Cleveland,CA,F,0,0,0,0,0,2,2
Cleveland,CAX,F,0,0,0,0,0,1,1
Cleveland,CB,F,0,0,0,0,0,1,1
Cleveland,CB,M,0,0,0,2,0,0,2
Cleveland,CH,F,68,72,28,17,26,97,308
Cleveland,CH,M,57,31,2,3,0,10,103
Cleveland,CHX,F,225,290,75,18,13,146,767
Cleveland,CHX,M,254,173,28,3,0,14,472
Cleveland,DEV,F,4,0,2,0,0,1,7
Cleveland,DEV,M,1,2,0,0,0,0,3
Cleveland,DEVX,F,0,1,2,0,0,0,3
Cleveland,DEVX,M,1,0,0,0,0,0,1
Cleveland,DEX,F,13,6,6,3,2,9,39
Cleveland,DEX,M,4,4,2,0,0,0,10
Cleveland,DS,F,0,0,0,0,0,2,2
Cleveland,DS,M,0,2,11,0,0,0,13
Cleveland,DVX,F,0,0,0,0,0,2,2
Cleveland,FR,F,0,0,0,0,0,507,507
Cleveland,FR,M,0,0,0,0,0,78,78
Cleveland,FRX,F,0,0,0,0,0,6,6
Cleveland,FRX,M,0,0,0,0,0,2,2
Cleveland,GA,F,3,0,1,1,3,32,40
Cleveland,GA,M,10,0,1,2,0,0,13
Cleveland,GAX,F,0,0,0,0,0,2,2
Cleveland,GAX,M,1,1,0,3,0,0,5
Cleveland,GEX,M,0,0,1,0,0,0,1
Cleveland,H,F,0,0,0,0,0,23,23
Cleveland,H,M,0,0,0,0,0,1,1
Cleveland,HE,F,15,16,8,4,5,30,78
Cleveland,HE,M,14,22,1,1,1,2,41
Cleveland,HEBL,F,0,0,0,0,0,1,1
Cleveland,HEBLX,F,0,0,0,0,0,4,4
Cleveland,HER,F,0,0,0,0,0,4,4
Cleveland,HERX,F,0,0,0,0,0,3,3
Cleveland,HEX,F,24,30,26,19,8,107,214
Cleveland,HEX,M,28,18,6,0,1,0,53
Cleveland,HF,F,442,474,390,342,273,525,"2,446"
Cleveland,HF,M,520,316,54,7,1,5,903
Cleveland,HFX,F,9,2,1,2,1,2,17
Cleveland,HFX,M,28,20,5,1,0,0,54
Cleveland,HI,F,0,1,3,0,1,9,14
Cleveland,HI,M,0,1,0,0,0,1,2
Cleveland,HIX,F,0,0,0,0,0,1,1
Cleveland,HIX,M,2,2,0,0,0,0,4
Cleveland,HL,F,0,0,0,0,0,1,1
Cleveland,HLX,F,0,0,0,0,0,1,1
Cleveland,HO,F,53,49,65,54,39,91,351
Cleveland,HO,M,51,11,6,0,0,1,69
Cleveland,HOX,F,4,0,0,2,1,1,8
Cleveland,HOX,M,7,0,1,0,0,0,8
Cleveland,HX,F,0,0,0,0,0,42,42
Cleveland,HX,M,0,0,0,0,0,6,6
Cleveland,JE,F,0,1,2,4,1,7,15
Cleveland,JE,M,3,1,0,0,0,0,4
Cleveland,JEX,M,1,0,0,0,0,0,1
Cleveland,LH,F,0,0,0,1,0,0,1
Cleveland,LHX,F,0,0,1,0,0,1,2
Cleveland,LI,F,0,0,0,0,0,28,28
Cleveland,LI,M,0,0,0,0,0,7,7
Cleveland,LIM,F,135,122,97,38,27,95,514
Cleveland,LIM,M,124,122,21,14,5,14,300
Cleveland,LIMB,F,0,0,0,0,0,1,1
Cleveland,LIMBX,F,0,0,0,0,0,46,46
Cleveland,LIMRX,F,0,0,0,0,0,22,22
Cleveland,LIMX,F,725,"1,059",272,114,154,458,"2,782"
Cleveland,LIMX,M,834,886,90,26,7,5,"1,848"
Cleveland,LIX,F,0,0,0,0,0,97,97
Cleveland,LIX,M,0,0,0,0,0,17,17
Cleveland,LMX,F,0,0,0,0,0,17,17
Cleveland,LR,F,8,0,0,0,0,0,8
Cleveland,LR,M,8,1,0,1,0,0,10
Cleveland,LRX,F,0,0,4,0,0,0,4
Cleveland,LU,M,0,0,0,1,0,0,1
Cleveland,MARX,M,0,2,0,0,0,0,2
Cleveland,MO,F,0,0,0,1,0,3,4
Cleveland,MOX,F,0,1,0,0,0,0,1
Cleveland,MOX,M,2,2,0,0,0,0,4
Cleveland,MRI,F,0,0,0,0,1,1,2
Cleveland,MRI,M,1,0,0,0,0,0,1
Cleveland,MRIX,F,0,0,0,0,0,2,2
Cleveland,MRIX,M,2,0,0,0,0,0,2
Cleveland,NO,F,0,0,0,1,0,0,1
Cleveland,NS,F,0,0,0,0,0,32,32
Cleveland,PAX,F,0,0,0,0,1,0,1
Cleveland,PAX,M,1,1,0,0,0,0,2
Cleveland,PI,F,0,0,0,0,0,1,1
Cleveland,PIX,F,0,0,0,0,0,1,1
Cleveland,PIX,M,1,3,0,0,0,0,4
Cleveland,SA,F,3,2,0,1,1,21,28
Cleveland,SA,M,2,1,0,0,0,0,3
Cleveland,SAX,F,9,22,7,16,11,34,99
Cleveland,SAX,M,26,1,0,0,0,0,27
Cleveland,SD,F,0,0,0,1,0,2,3
Cleveland,SDX,F,0,1,1,0,0,2,4
Cleveland,SDX,M,5,0,0,0,0,0,5
Cleveland,SH,F,0,0,0,0,0,1,1
Cleveland,SHO,F,1,0,1,2,2,8,14
Cleveland,SHO,M,2,3,1,0,0,0,6
Cleveland,SHOX,F,9,9,4,1,1,14,38
Cleveland,SHOX,M,11,9,5,0,0,0,25
Cleveland,SHX,F,0,0,0,0,0,4,4
Cleveland,SHX,M,0,0,0,0,0,1,1
Cleveland,SM,F,28,46,26,13,13,60,186
Cleveland,SM,M,37,23,4,3,0,4,71
Cleveland,SMX,F,227,193,71,50,75,308,924
Cleveland,SMX,M,265,147,23,4,4,7,450
Cleveland,SRWX,F,1,0,0,0,0,0,1
Cleveland,SRWX,M,2,0,0,0,0,0,2
Cleveland,ST,M,1,0,0,0,0,0,1
Cleveland,STX,F,1,0,0,0,0,0,1
Cleveland,SU,F,5,2,8,0,0,7,22
Cleveland,SU,M,3,1,0,0,0,0,4
Cleveland,SUX,F,0,2,0,1,0,0,3
Cleveland,SUX,M,0,1,0,0,0,0,1
Cleveland,WB,F,0,0,0,0,1,1,2
Cleveland,WB,M,0,1,0,0,0,0,1
Cleveland,WBX,F,0,0,0,0,0,2,2
Cleveland,WBX,M,0,1,1,0,0,0,2
Cleveland,WSX,M,0,3,1,0,0,0,4
Cambridgeshire,AA,F,21,44,31,17,13,40,166
Cambridgeshire,AA,M,30,63,35,2,1,7,138
Cambridgeshire,AAX,F,158,266,105,42,46,182,799
Cambridgeshire,AAX,M,171,467,242,1,0,9,890
Cambridgeshire,AR,M,1,0,0,0,0,0,1
Cambridgeshire,AY,F,0,0,0,0,1,0,1
Cambridgeshire,AY,M,3,1,1,0,0,0,5
Cambridgeshire,BA,F,31,26,19,20,19,66,181
Cambridgeshire,BA,M,28,24,4,4,8,21,89
Cambridgeshire,BABX,F,0,0,0,0,0,2,2
Cambridgeshire,BAL,M,0,0,1,0,0,0,1
Cambridgeshire,BARX,F,0,0,0,0,0,3,3
Cambridgeshire,BAX,F,430,300,63,43,33,197,"1,066"
Cambridgeshire,BAX,M,430,331,59,3,0,9,832
Cambridgeshire,BAZX,F,0,2,0,0,0,1,3
Cambridgeshire,BAZX,M,1,6,1,0,0,0,8
Cambridgeshire,BB,F,4,8,5,1,3,23,44
Cambridgeshire,BB,M,10,21,4,1,1,6,43
Cambridgeshire,BBX,F,224,154,65,29,21,101,594
Cambridgeshire,BBX,M,235,294,48,0,1,10,588
Cambridgeshire,BF,F,2,16,4,42,43,66,173
Cambridgeshire,BF,M,71,132,45,1,0,0,249
Cambridgeshire,BFX,F,22,6,1,0,0,7,36
Cambridgeshire,BFX,M,15,13,4,0,0,1,33
Cambridgeshire,BG,M,0,0,0,0,0,2,2
Cambridgeshire,BH,F,0,0,0,0,0,15,15
Cambridgeshire,BRX,F,0,2,0,0,0,0,2
Cambridgeshire,BS,F,0,0,1,0,0,1,2
Cambridgeshire,BS,M,0,2,0,0,1,0,3
Cambridgeshire,BSH,F,23,48,31,18,20,42,182
Cambridgeshire,BSH,M,40,21,0,3,0,0,64
Cambridgeshire,BSHX,F,14,11,4,1,0,10,40
Cambridgeshire,BSHX,M,13,6,0,0,0,4,23
Cambridgeshire,BSX,F,1,5,3,0,1,1,11
Cambridgeshire,BSX,M,5,3,4,0,0,0,12
Cambridgeshire,BU,M,0,0,0,0,0,8,8
Cambridgeshire,BW,F,11,15,2,3,3,29,63
Cambridgeshire,BW,M,8,21,3,0,0,4,36
Cambridgeshire,BWB,M,0,5,0,0,0,0,5
Cambridgeshire,BWX,F,1,0,1,2,0,1,5
Cambridgeshire,BWX,M,1,2,1,1,0,0,5
Cambridgeshire,BX,F,0,0,0,0,0,2,2
Cambridgeshire,CB,F,1,0,0,0,0,0,1
Cambridgeshire,CH,F,95,68,39,18,13,235,468
Cambridgeshire,CH,M,107,94,17,3,3,22,246
Cambridgeshire,CHX,F,249,306,81,40,62,417,"1,155"
Cambridgeshire,CHX,M,306,541,86,2,4,30,969
Cambridgeshire,DE,F,0,0,0,0,0,4,4
Cambridgeshire,DEV,F,38,25,6,12,9,21,111
Cambridgeshire,DEV,M,34,42,2,0,0,3,81
Cambridgeshire,DEVX,F,6,5,6,6,3,30,56
Cambridgeshire,DEVX,M,5,12,3,0,0,1,21
Cambridgeshire,DEX,F,46,38,15,23,19,67,208
Cambridgeshire,DEX,M,42,26,10,2,1,7,88
Cambridgeshire,DS,M,0,1,0,0,0,0,1
Cambridgeshire,DV,F,0,0,0,0,0,5,5
Cambridgeshire,DV,M,0,0,0,0,0,3,3
Cambridgeshire,DVX,F,0,0,0,0,0,3,3
Cambridgeshire,DVX,M,0,0,0,0,0,1,1
Cambridgeshire,FR,F,0,0,0,0,0,209,209
Cambridgeshire,FR,M,0,0,0,0,0,12,12
Cambridgeshire,FRX,F,0,0,0,0,0,26,26
Cambridgeshire,FRX,M,0,0,0,0,0,4,4
Cambridgeshire,GA,F,0,0,0,0,0,1,1
Cambridgeshire,GA,M,7,0,0,0,0,5,12
Cambridgeshire,GAX,F,0,0,0,0,0,2,2
Cambridgeshire,GBX,F,0,1,0,0,0,0,1
Cambridgeshire,GE,F,3,3,1,0,0,10,17
Cambridgeshire,GE,M,6,1,0,0,0,3,10
Cambridgeshire,GEX,F,25,13,5,2,0,17,62
Cambridgeshire,GEX,M,17,24,2,0,0,1,44
Cambridgeshire,GL,F,10,10,2,3,5,17,47
Cambridgeshire,GL,M,7,7,0,0,0,2,16
Cambridgeshire,GLX,F,0,3,1,0,0,1,5
Cambridgeshire,GLX,M,0,1,0,0,0,0,1
Cambridgeshire,GU,F,0,0,0,0,0,4,4
Cambridgeshire,GU,M,0,0,0,1,0,0,1
Cambridgeshire,GUX,F,0,0,0,0,3,4,7
Cambridgeshire,GUX,M,0,0,0,0,0,6,6
Cambridgeshire,H,F,0,0,0,0,0,42,42
Cambridgeshire,H,M,0,0,0,0,0,6,6
Cambridgeshire,HE,F,103,74,52,38,36,99,402
Cambridgeshire,HE,M,97,86,15,6,5,10,219
Cambridgeshire,HEBL,F,0,0,0,0,0,5,5
Cambridgeshire,HEBLX,F,0,0,0,0,0,17,17
Cambridgeshire,HER,F,0,0,0,0,0,6,6
Cambridgeshire,HER,M,0,0,0,0,0,2,2
Cambridgeshire,HERX,F,0,0,0,0,0,7,7
Cambridgeshire,HEX,F,152,189,117,86,109,317,970
Cambridgeshire,HEX,M,205,493,259,2,1,2,962
Cambridgeshire,HF,F,197,285,244,163,135,220,"1,244"
Cambridgeshire,HF,M,377,457,152,10,0,5,"1,001"
Cambridgeshire,HFX,F,6,24,7,12,13,13,75
Cambridgeshire,HFX,M,4,25,2,1,0,0,32
Cambridgeshire,HI,F,17,8,8,15,3,33,84
Cambridgeshire,HI,M,16,9,2,2,1,4,34
Cambridgeshire,HIX,F,3,2,0,0,0,6,11
Cambridgeshire,HIX,M,2,3,0,0,0,0,5
Cambridgeshire,HO,F,4,1,1,7,6,23,42
Cambridgeshire,HO,M,7,35,4,1,1,1,49
Cambridgeshire,HOX,F,21,7,3,1,0,3,35
Cambridgeshire,HOX,M,4,8,0,0,0,0,12
Cambridgeshire,HX,F,0,0,0,0,0,110,110
Cambridgeshire,HX,M,0,0,0,0,0,6,6
Cambridgeshire,IM,F,0,3,0,0,1,3,7
Cambridgeshire,IM,M,4,0,1,0,0,2,7
Cambridgeshire,IMX,F,1,1,0,1,0,0,3
Cambridgeshire,IMX,M,2,2,1,0,0,0,5
Cambridgeshire,JE,F,0,10,4,6,1,32,53
Cambridgeshire,JE,M,0,1,0,0,0,0,1
Cambridgeshire,JEX,F,1,3,4,1,1,14,24
Cambridgeshire,JEX,M,3,1,2,0,0,2,8
Cambridgeshire,LH,F,31,22,15,17,13,42,140
Cambridgeshire,LH,M,23,18,3,1,1,3,49
Cambridgeshire,LHX,F,1,0,0,0,1,1,3
Cambridgeshire,LHX,M,0,4,0,0,0,0,4
Cambridgeshire,LI,F,0,0,0,0,0,35,35
Cambridgeshire,LI,M,0,0,0,0,0,7,7
Cambridgeshire,LIM,F,93,93,50,40,21,126,423
Cambridgeshire,LIM,M,71,92,34,6,5,20,228
Cambridgeshire,LIMBX,F,0,0,0,0,0,3,3
Cambridgeshire,LIMR,F,0,0,0,0,0,7,7
Cambridgeshire,LIMR,M,0,0,0,0,0,1,1
Cambridgeshire,LIMRX,F,0,0,0,0,0,11,11
Cambridgeshire,LIMRX,M,0,0,0,0,0,1,1
Cambridgeshire,LIMX,F,705,683,173,138,127,388,"2,214"
Cambridgeshire,LIMX,M,806,"1,299",226,2,8,14,"2,355"
Cambridgeshire,LIX,F,0,0,0,0,0,113,113
Cambridgeshire,LIX,M,0,0,0,0,0,24,24
Cambridgeshire,LMX,F,0,0,0,0,0,5,5
Cambridgeshire,LR,F,1,4,3,0,0,0,8
Cambridgeshire,LR,M,1,0,0,0,0,0,1
Cambridgeshire,LRX,M,0,6,0,0,0,0,6
Cambridgeshire,MAX,F,0,0,0,0,0,2,2
Cambridgeshire,MG,F,1,2,0,3,0,21,27
Cambridgeshire,MG,M,1,2,0,0,0,0,3
Cambridgeshire,MGX,F,7,6,0,2,0,3,18
Cambridgeshire,MGX,M,6,3,0,0,0,0,9
Cambridgeshire,MO,F,0,0,1,0,0,0,1
Cambridgeshire,MO,M,0,6,4,0,0,0,10
Cambridgeshire,MOX,F,0,1,0,2,0,1,4
Cambridgeshire,MOX,M,16,13,1,0,0,0,30
Cambridgeshire,MRI,F,0,0,0,0,0,1,1
Cambridgeshire,MRI,M,1,0,0,0,0,0,1
Cambridgeshire,MRIX,M,0,2,12,0,0,0,14
Cambridgeshire,NOX,F,0,0,1,0,0,0,1
Cambridgeshire,NS,F,0,0,0,0,0,66,66
Cambridgeshire,OEX,F,0,2,0,0,0,0,2
Cambridgeshire,OEX,M,0,1,1,0,0,0,2
Cambridgeshire,OO,F,0,0,0,0,0,1,1
Cambridgeshire,PAX,F,3,0,0,0,0,0,3
Cambridgeshire,PAX,M,1,0,0,0,0,0,1
Cambridgeshire,PI,F,0,4,2,0,0,1,7
Cambridgeshire,PIX,F,1,1,0,0,0,9,11
Cambridgeshire,PIX,M,2,3,0,0,0,4,9
Cambridgeshire,ROX,M,0,1,0,0,0,0,1
Cambridgeshire,RP,F,12,0,0,3,4,10,29
Cambridgeshire,RP,M,8,9,0,0,0,0,17
Cambridgeshire,RPX,F,2,1,1,2,2,9,17
Cambridgeshire,RPX,M,1,2,0,0,0,0,3
Cambridgeshire,RWFR,F,0,0,0,0,0,2,2
Cambridgeshire,SA,F,2,3,0,0,0,3,8
Cambridgeshire,SA,M,0,3,1,0,0,0,4
Cambridgeshire,SAX,F,11,15,8,16,9,22,81
Cambridgeshire,SAX,M,13,9,2,0,0,0,24
Cambridgeshire,SD,F,11,14,8,13,9,26,81
Cambridgeshire,SD,M,18,12,1,1,1,1,34
Cambridgeshire,SDX,F,22,33,19,4,1,14,93
Cambridgeshire,SDX,M,19,41,3,1,0,0,64
Cambridgeshire,SH,F,1,0,2,1,5,9,18
Cambridgeshire,SH,M,11,12,2,0,0,1,26
Cambridgeshire,SHO,F,3,1,2,0,1,23,30
Cambridgeshire,SHO,M,3,4,1,0,0,2,10
Cambridgeshire,SHOX,F,10,3,0,2,0,9,24
Cambridgeshire,SHOX,M,12,13,5,0,0,0,30
Cambridgeshire,SM,F,52,59,33,33,40,177,394
Cambridgeshire,SM,M,63,76,22,6,3,21,191
Cambridgeshire,SMX,F,471,375,141,164,158,594,"1,903"
Cambridgeshire,SMX,M,481,572,115,5,2,46,"1,221"
Cambridgeshire,SRWX,F,2,0,1,0,0,0,3
Cambridgeshire,SRWX,M,2,0,0,0,0,0,2
Cambridgeshire,STX,M,0,3,1,0,0,0,4
Cambridgeshire,SU,F,0,1,0,1,2,0,4
Cambridgeshire,SU,M,0,2,0,0,0,0,2
Cambridgeshire,SUX,F,1,8,2,0,1,12,24
Cambridgeshire,SUX,M,4,6,1,0,0,0,11
Cambridgeshire,WB,F,0,0,0,1,0,1,2
Cambridgeshire,WBX,F,1,0,0,0,0,1,2
Cambridgeshire,WBX,M,0,1,3,0,0,0,4
Cambridgeshire,WP,F,7,8,5,3,2,15,40
Cambridgeshire,WP,M,5,13,2,0,0,3,23
Cambridgeshire,WPX,F,1,0,2,0,0,0,3
Cambridgeshire,WPX,M,2,2,0,0,0,0,4
Cambridgeshire,WSX,M,2,0,0,0,0,0,2
Cheshire,AA,F,363,252,133,85,59,337,"1,229"
Cheshire,AA,M,386,263,108,42,18,86,903
Cheshire,AAX,F,"1,329","1,053",350,169,144,571,"3,616"
Cheshire,AAX,M,"1,418","1,129",292,29,13,91,"2,972"
Cheshire,AR,F,0,2,0,0,0,0,2
Cheshire,AR,M,2,2,0,0,0,0,4
Cheshire,ARX,F,0,2,1,0,0,0,3
Cheshire,ARX,M,0,0,2,0,0,0,2
Cheshire,AY,F,199,191,175,203,270,620,"1,658"
Cheshire,AY,M,31,17,11,0,3,2,64
Cheshire,AYX,F,79,38,67,21,35,45,285
Cheshire,AYX,M,26,2,3,0,1,1,33
Cheshire,BA,F,42,53,28,19,13,76,231
Cheshire,BA,M,44,35,13,10,8,24,134
Cheshire,BABX,F,0,0,0,0,0,2,2
Cheshire,BABX,M,0,0,0,0,0,1,1
Cheshire,BAL,F,1,1,2,1,0,10,15
Cheshire,BALX,F,15,12,2,0,0,4,33
Cheshire,BALX,M,1,0,0,0,0,0,1
Cheshire,BAX,F,310,335,57,30,18,102,852
Cheshire,BAX,M,329,241,47,5,0,35,657
Cheshire,BAZ,F,9,16,5,8,8,16,62
Cheshire,BAZ,M,20,15,0,5,1,2,43
Cheshire,BAZX,F,37,10,1,6,3,17,74
Cheshire,BAZX,M,44,15,2,0,0,0,61
Cheshire,BB,F,301,282,106,28,31,272,"1,020"
Cheshire,BB,M,334,207,88,18,15,141,803
Cheshire,BBX,F,"1,836","1,467",503,178,109,770,"4,863"
Cheshire,BBX,M,"1,999","1,165",288,27,10,174,"3,663"
Cheshire,BF,F,"2,012","1,764","2,255","2,710","2,858","5,132","16,731"
Cheshire,BF,M,"1,143",568,236,42,22,40,"2,051"
Cheshire,BFX,F,403,437,379,315,274,402,"2,210"
Cheshire,BFX,M,204,110,21,4,0,2,341
Cheshire,BG,F,3,5,4,3,1,14,30
Cheshire,BG,M,4,4,0,1,0,1,10
Cheshire,BGX,F,1,11,3,0,0,3,18
Cheshire,BGX,M,4,12,3,0,0,0,19
Cheshire,BH,F,25,0,0,0,0,"1,074","1,099"
Cheshire,BH,M,9,0,0,0,0,17,26
Cheshire,BHX,F,33,0,0,0,0,139,172
Cheshire,BHX,M,9,0,0,0,0,0,9
Cheshire,BLGX,F,0,1,0,0,0,0,1
Cheshire,BLGX,M,1,0,0,0,0,0,1
Cheshire,BP,F,0,0,0,0,0,1,1
Cheshire,BR,F,0,1,0,1,0,1,3
Cheshire,BRX,F,0,0,0,1,0,0,1
Cheshire,BRX,M,3,0,0,0,0,1,4
Cheshire,BS,F,92,67,95,59,46,163,522
Cheshire,BS,M,36,22,1,2,0,2,63
Cheshire,BSH,F,7,6,2,7,5,12,39
Cheshire,BSH,M,6,23,1,0,2,1,33
Cheshire,BSHX,F,9,3,7,10,2,10,41
Cheshire,BSHX,M,14,9,2,1,0,0,26
Cheshire,BSX,F,191,137,151,116,119,240,954
Cheshire,BSX,M,54,8,5,1,0,2,70
Cheshire,BW,F,6,7,2,1,2,5,23
Cheshire,BW,M,2,0,0,0,0,1,3
Cheshire,BWB,M,0,0,0,0,0,1,1
Cheshire,BWX,F,6,2,0,0,0,0,8
Cheshire,BWX,M,7,1,0,0,0,1,9
Cheshire,CB,F,0,0,0,0,1,13,14
Cheshire,CD,F,0,3,7,0,0,6,16
Cheshire,CD,M,0,1,0,0,0,0,1
Cheshire,CH,F,117,143,52,36,38,470,856
Cheshire,CH,M,121,111,42,21,16,184,495
Cheshire,CHI,F,0,0,0,0,0,1,1
Cheshire,CHIX,F,0,0,0,0,0,2,2
Cheshire,CHX,F,792,937,255,87,81,797,"2,949"
Cheshire,CHX,M,777,771,202,19,10,235,"2,014"
Cheshire,DEV,F,0,0,0,1,0,2,3
Cheshire,DEVX,F,16,3,3,0,2,3,27
Cheshire,DEVX,M,15,1,3,0,0,0,19
Cheshire,DEX,F,22,24,14,27,15,60,162
Cheshire,DEX,M,29,18,5,3,1,5,61
Cheshire,DEXX,F,1,1,0,0,0,0,2
Cheshire,DEXX,M,1,0,0,0,0,0,1
Cheshire,DR,F,1,0,0,0,1,1,3
Cheshire,DRX,F,14,0,1,0,0,0,15
Cheshire,DRX,M,2,0,0,0,0,0,2
Cheshire,DS,F,36,16,21,27,51,132,283
Cheshire,DS,M,23,31,0,2,1,5,62
Cheshire,DSHO,F,1,0,0,0,0,2,3
Cheshire,DSX,F,31,17,21,45,51,89,254
Cheshire,DSX,M,5,1,2,0,0,0,8
Cheshire,DV,F,0,0,0,0,0,2,2
Cheshire,DV,M,0,0,0,0,0,2,2
Cheshire,DVX,M,0,0,0,0,0,1,1
Cheshire,FE,F,0,0,0,1,0,0,1
Cheshire,FEX,M,0,2,0,0,0,0,2
Cheshire,FR,F,0,0,0,0,1,"20,471","20,472"
Cheshire,FR,M,0,0,0,0,0,256,256
Cheshire,FRX,F,0,1,0,0,0,675,676
Cheshire,FRX,M,0,0,0,0,0,37,37
Cheshire,GA,F,8,9,5,0,0,11,33
Cheshire,GA,M,3,2,0,0,0,1,6
Cheshire,GASX,F,2,0,0,0,0,0,2
Cheshire,GAX,F,3,5,2,2,0,10,22
Cheshire,GAX,M,4,2,0,0,0,0,6
Cheshire,GB,F,0,1,0,0,0,0,1
Cheshire,GB,M,0,1,0,0,0,0,1
Cheshire,GBX,F,2,0,0,0,0,1,3
Cheshire,GBX,M,1,0,0,0,0,0,1
Cheshire,GE,F,0,1,0,0,0,0,1
Cheshire,GEX,F,1,1,0,0,0,1,3
Cheshire,GEX,M,1,2,0,0,0,0,3
Cheshire,GL,F,2,0,0,0,0,8,10
Cheshire,GL,M,0,0,0,0,0,1,1
Cheshire,GLX,F,0,0,1,0,0,0,1
Cheshire,GU,F,18,24,45,60,80,183,410
Cheshire,GU,M,20,7,1,0,2,0,30
Cheshire,GUX,F,7,3,1,0,1,8,20
Cheshire,GUX,M,1,0,0,0,0,0,1
Cheshire,GY,F,1,0,0,0,0,0,1
Cheshire,H,F,0,0,0,0,0,203,203
Cheshire,H,M,0,0,0,0,0,53,53
Cheshire,HE,F,318,221,161,78,56,175,"1,009"
Cheshire,HE,M,314,202,70,36,36,59,717
Cheshire,HEBL,F,0,0,0,0,0,17,17
Cheshire,HEBL,M,0,0,0,0,0,1,1
Cheshire,HEBLX,F,0,0,0,0,0,83,83
Cheshire,HEBLX,M,0,0,0,0,0,7,7
Cheshire,HER,F,0,0,0,0,0,23,23
Cheshire,HER,M,0,0,0,0,0,8,8
Cheshire,HERX,F,0,0,0,0,0,26,26
Cheshire,HEX,F,"1,312","1,224",365,222,197,499,"3,819"
Cheshire,HEX,M,"1,188",909,177,30,3,48,"2,355"
Cheshire,HF,F,"12,599","12,637","13,761","13,049","12,001","25,367","89,414"
Cheshire,HF,M,"2,899","1,118",388,101,37,133,"4,676"
Cheshire,HFX,F,631,709,869,732,492,"1,389","4,822"
Cheshire,HFX,M,196,76,15,2,1,5,295
Cheshire,HI,F,29,10,14,12,12,78,155
Cheshire,HI,M,12,22,1,6,2,17,60
Cheshire,HIX,F,5,7,0,1,0,4,17
Cheshire,HIX,M,1,3,0,0,1,0,5
Cheshire,HL,F,0,0,0,0,0,8,8
Cheshire,HO,F,"2,673","2,727","2,841","2,547","2,389","4,123","17,300"
Cheshire,HO,M,493,146,98,18,16,40,811
Cheshire,HOX,F,128,100,123,80,81,255,767
Cheshire,HOX,M,16,8,3,0,0,4,31
Cheshire,HX,F,0,0,0,0,0,421,421
Cheshire,HX,M,0,0,0,0,0,93,93
Cheshire,IM,F,0,0,0,0,0,2,2
Cheshire,IM,M,1,0,0,0,0,0,1
Cheshire,IMX,F,0,1,0,0,1,1,3
Cheshire,IMX,M,1,0,2,0,0,0,3
Cheshire,JE,F,168,244,219,200,237,543,"1,611"
Cheshire,JE,M,11,16,6,2,1,3,39
Cheshire,JEX,F,603,250,148,138,64,52,"1,255"
Cheshire,JEX,M,41,15,2,3,0,2,63
Cheshire,JY,F,89,0,0,0,0,3,92
Cheshire,JY,M,1,0,0,0,0,0,1
Cheshire,JYX,F,18,0,0,0,0,0,18
Cheshire,JYX,M,1,0,0,0,0,0,1
Cheshire,KE,F,0,0,0,0,0,1,1
Cheshire,LH,F,61,38,34,30,20,111,294
Cheshire,LH,M,44,52,9,2,1,2,110
Cheshire,LHX,F,10,20,4,0,4,9,47
Cheshire,LHX,M,14,12,2,0,0,1,29
Cheshire,LI,F,0,0,0,0,0,199,199
Cheshire,LI,M,0,0,0,0,0,104,104
Cheshire,LIM,F,446,550,290,142,95,439,"1,962"
Cheshire,LIM,M,435,436,163,43,37,107,"1,221"
Cheshire,LIMB,F,0,0,0,0,0,1,1
Cheshire,LIMBX,F,0,0,0,0,0,55,55
Cheshire,LIMBX,M,0,0,0,0,0,3,3
Cheshire,LIMR,F,0,0,0,0,0,23,23
Cheshire,LIMR,M,0,0,0,0,0,1,1
Cheshire,LIMRX,F,0,0,0,0,0,26,26
Cheshire,LIMRX,M,0,0,0,0,0,1,1
Cheshire,LIMX,F,"2,292","2,511",698,278,255,738,"6,772"
Cheshire,LIMX,M,"2,051","2,082",684,35,21,97,"4,970"
Cheshire,LIX,F,0,0,0,0,0,371,371
Cheshire,LIX,M,0,0,0,0,0,157,157
Cheshire,LM,F,0,0,0,0,0,28,28
Cheshire,LM,M,0,0,0,0,0,1,1
Cheshire,LMX,F,0,0,0,0,0,14,14
Cheshire,LMX,M,0,0,0,0,0,1,1
Cheshire,LR,F,7,4,6,3,1,4,25
Cheshire,LR,M,3,0,0,1,0,1,5
Cheshire,MA,F,0,1,0,0,0,0,1
Cheshire,MAR,F,0,0,0,0,0,1,1
Cheshire,MG,F,0,1,0,0,0,2,3
Cheshire,MG,M,0,0,0,0,0,1,1
Cheshire,MGX,F,0,2,0,0,1,7,10
Cheshire,MGX,M,0,3,0,0,0,1,4
Cheshire,MO,F,13,5,6,3,11,12,50
Cheshire,MO,M,10,4,2,3,0,1,20
Cheshire,MOX,F,141,22,13,14,5,32,227
Cheshire,MOX,M,80,3,3,1,0,1,88
Cheshire,MRI,F,53,76,42,40,29,95,335
Cheshire,MRI,M,57,53,3,0,0,1,114
Cheshire,MRIX,F,9,16,37,25,40,73,200
Cheshire,MRIX,M,11,13,4,0,1,2,31
Cheshire,NO,F,0,0,0,1,0,1,2
Cheshire,NOX,F,4,0,0,0,0,1,5
Cheshire,NRX,F,17,0,0,0,0,1,18
Cheshire,NRX,M,2,0,0,0,0,0,2
Cheshire,NS,F,0,0,0,0,0,"1,212","1,212"
Cheshire,NS,M,0,0,0,0,0,2,2
Cheshire,OD,F,0,0,0,0,0,1,1
Cheshire,OEX,F,0,0,1,0,0,0,1
Cheshire,OO,F,0,0,0,0,0,2,2
Cheshire,PAX,F,2,0,1,0,1,2,6
Cheshire,PAX,M,8,1,0,0,0,0,9
Cheshire,PI,F,0,0,0,0,0,3,3
Cheshire,PI,M,0,0,0,0,0,6,6
Cheshire,PIX,F,2,0,0,1,0,1,4
Cheshire,PIX,M,2,0,0,0,0,2,4
Cheshire,ROT,M,1,0,0,0,0,0,1
Cheshire,ROTX,F,0,0,34,0,0,0,34
Cheshire,ROX,F,0,0,0,0,0,1,1
Cheshire,RP,F,15,11,14,1,5,32,78
Cheshire,RP,M,16,11,2,0,1,2,32
Cheshire,RPX,F,32,17,14,17,0,0,80
Cheshire,RPX,M,17,23,2,0,0,0,42
Cheshire,RWFR,F,1,0,0,0,0,6,7
Cheshire,RWFR,M,4,0,0,0,0,0,4
Cheshire,SA,F,15,26,12,2,8,45,108
Cheshire,SA,M,14,12,16,7,1,7,57
Cheshire,SAX,F,26,46,22,17,5,66,182
Cheshire,SAX,M,38,27,15,3,2,3,88
Cheshire,SB,F,0,0,0,0,1,0,1
Cheshire,SBX,F,1,0,1,5,1,0,8
Cheshire,SD,F,29,29,8,7,18,23,114
Cheshire,SD,M,48,25,3,3,3,6,88
Cheshire,SDX,F,27,13,4,8,4,6,62
Cheshire,SDX,M,21,15,0,0,1,0,37
Cheshire,SH,F,3,2,1,1,3,4,14
Cheshire,SH,M,1,1,1,0,0,1,4
Cheshire,SHO,F,210,208,119,109,121,317,"1,084"
Cheshire,SHO,M,81,78,12,3,3,31,208
Cheshire,SHOX,F,269,169,108,81,39,110,776
Cheshire,SHOX,M,77,58,13,3,0,5,156
Cheshire,SHX,F,1,3,2,2,1,4,13
Cheshire,SHX,M,1,1,0,0,0,0,2
Cheshire,SM,F,483,273,106,101,64,410,"1,437"
Cheshire,SM,M,437,230,98,54,35,167,"1,021"
Cheshire,SMX,F,"2,265","1,407",433,203,161,912,"5,381"
Cheshire,SMX,M,"2,161","1,111",257,32,19,265,"3,845"
Cheshire,SOB,F,0,0,0,1,0,0,1
Cheshire,SRW,F,6,0,0,1,0,0,7
Cheshire,SRW,M,2,1,0,0,0,0,3
Cheshire,SRWX,F,88,6,30,16,12,7,159
Cheshire,SRWX,M,21,0,1,0,0,0,22
Cheshire,ST,M,0,3,0,0,0,0,3
Cheshire,STX,F,3,0,0,0,0,0,3
Cheshire,STX,M,2,3,0,0,0,0,5
Cheshire,SU,F,14,7,9,6,7,17,60
Cheshire,SU,M,18,4,1,0,0,0,23
Cheshire,SUX,F,5,34,8,3,0,5,55
Cheshire,SUX,M,14,19,0,0,0,1,34
Cheshire,WB,F,5,7,9,4,2,45,72
Cheshire,WB,M,3,31,6,2,0,5,47
Cheshire,WBX,F,27,31,20,3,3,27,111
Cheshire,WBX,M,42,32,4,0,0,4,82
Cheshire,WP,F,1,0,0,1,0,2,4
Cheshire,WP,M,2,1,0,0,0,0,3
Cheshire,WPX,F,0,0,0,0,1,1,2
Cheshire,WS,F,0,0,0,0,0,3,3
Cheshire,WS,M,0,0,0,0,0,1,1
Cheshire,WSX,F,1,0,0,0,0,5,6
Cheshire,WSX,M,0,7,2,0,0,0,9
Cornwall,AA,F,795,555,265,210,188,730,"2,743"
Cornwall,AA,M,881,634,126,62,21,117,"1,841"
Cornwall,AAX,F,"2,427","2,037",920,595,596,"2,068","8,643"
Cornwall,AAX,M,"2,699","2,048",419,54,17,92,"5,329"
Cornwall,AR,M,1,0,0,0,0,0,1
Cornwall,ARX,F,0,2,0,1,0,0,3
Cornwall,ARX,M,2,0,0,0,0,0,2
Cornwall,AUX,M,1,0,0,0,0,0,1
Cornwall,AY,F,377,325,338,334,262,"1,017","2,653"
Cornwall,AY,M,135,54,49,8,1,5,252
Cornwall,AYX,F,51,40,25,48,16,74,254
Cornwall,AYX,M,5,5,5,0,0,0,15
Cornwall,BA,F,193,204,84,53,52,279,865
Cornwall,BA,M,176,176,51,13,13,65,494
Cornwall,BABX,F,0,0,0,0,0,13,13
Cornwall,BABX,M,0,0,0,0,0,1,1
Cornwall,BAL,F,1,2,3,0,0,2,8
Cornwall,BAL,M,0,0,1,0,0,0,1
Cornwall,BALX,F,0,0,0,0,0,5,5
Cornwall,BALX,M,0,1,0,0,0,0,1
Cornwall,BARX,F,0,0,0,0,0,19,19
Cornwall,BAWX,F,0,0,0,0,0,11,11
Cornwall,BAX,F,"1,199",998,403,191,176,790,"3,757"
Cornwall,BAX,M,"1,224",986,267,25,5,75,"2,582"
Cornwall,BAZX,F,0,4,2,0,1,6,13
Cornwall,BAZX,M,0,0,2,0,0,0,2
Cornwall,BB,F,140,147,56,34,34,116,527
Cornwall,BB,M,150,170,49,10,10,30,419
Cornwall,BBX,F,"1,796","1,499",600,308,180,762,"5,145"
Cornwall,BBX,M,"1,964","1,668",515,5,4,69,"4,225"
Cornwall,BF,F,"2,039","2,093","2,536","2,450","2,698","4,536","16,352"
Cornwall,BF,M,"2,143","1,810",875,77,50,44,"4,999"
Cornwall,BFX,F,298,257,151,194,198,243,"1,341"
Cornwall,BFX,M,254,212,64,4,3,1,538
Cornwall,BG,F,105,83,68,56,47,266,625
Cornwall,BG,M,102,47,25,12,12,25,223
Cornwall,BGX,F,25,19,7,2,8,50,111
Cornwall,BGX,M,23,35,5,0,1,2,66
Cornwall,BH,F,7,0,0,0,0,617,624
Cornwall,BH,M,10,0,0,0,0,6,16
Cornwall,BHX,F,2,0,0,0,0,37,39
Cornwall,BHX,M,2,0,0,0,0,2,4
Cornwall,BLG,F,14,14,29,28,22,149,256
Cornwall,BLG,M,11,3,0,2,2,1,19
Cornwall,BLGX,F,0,0,1,0,1,5,7
Cornwall,BLGX,M,0,0,0,0,0,1,1
Cornwall,BP,F,0,0,0,0,1,1,2
Cornwall,BR,F,0,0,0,0,1,2,3
Cornwall,BR,M,0,1,1,0,0,0,2
Cornwall,BRX,F,0,1,1,0,0,0,2
Cornwall,BS,F,5,3,8,27,15,17,75
Cornwall,BS,M,1,1,3,1,0,1,7
Cornwall,BSH,F,32,30,17,8,13,19,119
Cornwall,BSH,M,23,30,6,4,1,8,72
Cornwall,BSHX,F,32,68,33,11,11,43,198
Cornwall,BSHX,M,56,38,2,0,1,1,98
Cornwall,BSX,F,58,27,20,37,14,41,197
Cornwall,BSX,M,37,11,9,3,0,0,60
Cornwall,BU,F,0,1,0,0,0,0,1
Cornwall,BW,F,11,13,14,19,11,34,102
Cornwall,BW,M,7,2,2,2,0,0,13
Cornwall,BWB,F,0,1,0,1,0,3,5
Cornwall,BWB,M,0,1,0,0,0,0,1
Cornwall,BWX,F,14,14,9,6,2,11,56
Cornwall,BWX,M,9,19,5,0,0,1,34
Cornwall,BX,F,0,0,0,0,0,1,1
Cornwall,CA,F,0,0,0,0,0,1,1
Cornwall,CAX,F,0,0,0,0,0,6,6
Cornwall,CB,F,5,5,0,0,2,86,98
Cornwall,CB,M,5,1,0,0,0,1,7
Cornwall,CD,M,0,4,0,0,0,0,4
Cornwall,CH,F,708,686,283,206,184,"1,266","3,333"
Cornwall,CH,M,771,702,180,79,55,267,"2,054"
Cornwall,CHIX,F,0,0,1,0,0,11,12
Cornwall,CHX,F,"5,117","4,309","1,294",685,587,"4,277","16,269"
Cornwall,CHX,M,"5,394","5,211","1,116",58,33,363,"12,175"
Cornwall,DE,F,0,0,0,0,0,1,1
Cornwall,DEV,F,366,308,204,158,160,489,"1,685"
Cornwall,DEV,M,359,278,59,18,18,40,772
Cornwall,DEVX,F,308,303,145,109,83,395,"1,343"
Cornwall,DEVX,M,331,314,94,22,1,14,776
Cornwall,DEX,F,98,80,90,50,51,219,588
Cornwall,DEX,M,126,93,37,12,6,14,288
Cornwall,DEXX,F,7,5,2,2,3,7,26
Cornwall,DEXX,M,10,2,1,0,0,1,14
Cornwall,DG,F,0,0,0,0,0,30,30
Cornwall,DGX,F,0,0,0,0,0,15,15
Cornwall,DR,F,1,0,2,1,0,16,20
Cornwall,DR,M,0,1,0,0,0,0,1
Cornwall,DRX,F,29,48,89,47,0,0,213
Cornwall,DRX,M,16,21,3,0,0,0,40
Cornwall,DS,F,28,28,22,15,10,51,154
Cornwall,DS,M,8,9,7,3,0,0,27
Cornwall,DSHO,F,1,0,0,0,0,0,1
Cornwall,DSX,F,2,12,7,8,18,12,59
Cornwall,DSX,M,3,1,1,1,0,0,6
Cornwall,DV,F,0,0,0,0,0,307,307
Cornwall,DV,M,0,0,0,0,0,23,23
Cornwall,DVX,F,0,0,0,0,0,125,125
Cornwall,DVX,M,0,0,0,0,0,14,14
Cornwall,FE,F,0,0,1,0,1,0,2
Cornwall,FR,F,0,0,0,0,0,"16,236","16,236"
Cornwall,FR,M,0,0,0,0,0,277,277
Cornwall,FRX,F,0,0,0,0,0,443,443
Cornwall,FRX,M,0,0,0,0,0,61,61
Cornwall,GA,F,196,151,97,44,47,398,933
Cornwall,GA,M,167,94,20,9,2,32,324
Cornwall,GAX,F,37,39,61,79,83,432,731
Cornwall,GAX,M,31,24,9,3,0,4,71
Cornwall,GBX,F,1,1,0,1,0,0,3
Cornwall,GBX,M,0,1,0,0,0,0,1
Cornwall,GE,F,0,2,0,4,0,1,7
Cornwall,GE,M,0,2,0,0,0,1,3
Cornwall,GEX,F,10,9,1,9,0,2,31
Cornwall,GEX,M,7,10,2,0,0,0,19
Cornwall,GL,F,2,4,3,1,4,13,27
Cornwall,GL,M,0,3,1,0,0,1,5
Cornwall,GLX,F,11,5,0,0,3,1,20
Cornwall,GLX,M,16,5,0,0,0,1,22
Cornwall,GU,F,424,363,440,389,344,"1,409","3,369"
Cornwall,GU,M,35,15,12,6,3,11,82
Cornwall,GUX,F,25,18,12,17,27,51,150
Cornwall,GUX,M,2,2,3,1,0,0,8
Cornwall,GY,F,7,0,0,0,0,0,7
Cornwall,GY,M,1,0,0,0,0,0,1
Cornwall,GYX,F,2,0,0,0,0,0,2
Cornwall,H,F,0,0,0,0,0,228,228
Cornwall,H,M,0,0,0,0,0,38,38
Cornwall,HE,F,312,264,179,159,121,388,"1,423"
Cornwall,HE,M,334,272,52,32,26,36,752
Cornwall,HEBL,F,0,0,0,0,0,55,55
Cornwall,HEBLX,F,0,0,0,0,0,213,213
Cornwall,HEBLX,M,0,0,0,0,0,3,3
Cornwall,HER,F,0,0,0,0,0,52,52
Cornwall,HER,M,0,0,0,0,0,4,4
Cornwall,HERX,F,0,0,0,0,0,112,112
Cornwall,HERX,M,0,0,0,0,0,5,5
Cornwall,HEX,F,"1,701","1,489",726,807,613,"2,470","7,806"
Cornwall,HEX,M,"1,789","1,280",261,36,13,37,"3,416"
Cornwall,HF,F,"11,154","10,395","11,087","9,577","8,386","16,265","66,864"
Cornwall,HF,M,"6,036","4,636","2,061",221,69,95,"13,118"
Cornwall,HFX,F,424,445,340,301,311,615,"2,436"
Cornwall,HFX,M,339,211,69,21,1,7,648
Cornwall,HI,F,95,58,71,60,49,218,551
Cornwall,HI,M,75,53,34,19,25,23,229
Cornwall,HIX,F,3,4,6,7,1,24,45
Cornwall,HIX,M,5,2,0,0,0,0,7
Cornwall,HL,F,0,0,0,0,0,4,4
Cornwall,HL,M,0,0,0,0,0,1,1
Cornwall,HO,F,"1,954","1,846","1,705","1,390","1,276","2,023","10,194"
Cornwall,HO,M,728,510,239,23,4,11,"1,515"
Cornwall,HOX,F,114,100,35,84,129,201,663
Cornwall,HOX,M,125,91,12,4,0,3,235
Cornwall,HX,F,0,0,0,0,0,"1,003","1,003"
Cornwall,HX,M,0,0,0,0,0,90,90
Cornwall,IM,F,0,0,0,2,0,2,4
Cornwall,IM,M,0,1,0,0,0,0,1
Cornwall,IMX,F,1,0,0,0,0,1,2
Cornwall,IMX,M,1,0,0,0,0,0,1
Cornwall,JE,F,630,448,843,783,333,"1,273","4,310"
Cornwall,JE,M,30,29,14,5,0,5,83
Cornwall,JEX,F,272,192,111,90,115,131,911
Cornwall,JEX,M,26,11,10,0,0,1,48
Cornwall,JY,F,100,0,0,0,0,0,100
Cornwall,JY,M,7,0,0,0,0,0,7
Cornwall,JYX,F,12,0,0,0,0,0,12
Cornwall,JYX,M,2,0,0,0,0,0,2
Cornwall,KE,F,3,0,0,3,6,2,14
Cornwall,KE,M,4,0,0,0,0,0,4
Cornwall,KEX,F,2,0,0,0,0,0,2
Cornwall,KEX,M,1,0,0,0,0,0,1
Cornwall,LH,F,15,19,14,6,5,48,107
Cornwall,LH,M,18,10,8,1,1,3,41
Cornwall,LHX,F,31,13,13,5,15,79,156
Cornwall,LHX,M,21,15,8,0,0,1,45
Cornwall,LI,F,0,0,0,0,0,268,268
Cornwall,LI,M,0,0,0,0,0,92,92
Cornwall,LIM,F,"1,131",961,403,327,232,987,"4,041"
Cornwall,LIM,M,"1,205","1,022",292,105,123,226,"2,973"
Cornwall,LIM X,F,0,0,0,0,0,3,3
Cornwall,LIMB,F,0,0,0,0,0,10,10
Cornwall,LIMBX,F,0,0,0,0,0,166,166
Cornwall,LIMBX,M,0,0,0,0,0,4,4
Cornwall,LIMR,F,0,0,0,0,0,33,33
Cornwall,LIMR,M,0,0,0,0,0,8,8
Cornwall,LIMRX,F,0,0,0,0,0,120,120
Cornwall,LIMRX,M,0,0,0,0,0,6,6
Cornwall,LIMX,F,"8,519","7,557","2,309","1,111","1,127","3,732","24,355"
Cornwall,LIMX,M,"9,245","8,467","2,061",83,45,189,"20,090"
Cornwall,LIX,F,0,0,0,0,0,"1,304","1,304"
Cornwall,LIX,M,0,0,0,0,0,229,229
Cornwall,LM,F,0,0,0,0,0,29,29
Cornwall,LM,M,0,0,0,0,0,3,3
Cornwall,LMX,F,0,0,0,0,0,18,18
Cornwall,LR,F,7,1,1,3,2,11,25
Cornwall,LR,M,3,1,0,1,0,0,5
Cornwall,LRX,F,1,0,0,2,0,3,6
Cornwall,LU,F,10,10,0,0,0,0,20
Cornwall,LU,M,0,6,0,0,0,0,6
Cornwall,LUX,F,0,0,0,0,0,1,1
Cornwall,MA,F,3,1,0,0,0,0,4
Cornwall,MA,M,0,2,3,0,0,0,5
Cornwall,MAR,F,0,0,0,0,0,1,1
Cornwall,MARX,M,0,0,1,0,0,0,1
Cornwall,MAX,F,0,0,1,0,0,4,5
Cornwall,MAX,M,2,1,1,0,0,0,4
Cornwall,MG,F,0,1,0,1,1,8,11
Cornwall,MG,M,2,1,0,0,0,1,4
Cornwall,MGX,F,6,4,3,2,1,18,34
Cornwall,MGX,M,10,15,4,1,0,3,33
Cornwall,MO,F,33,23,44,14,19,33,166
Cornwall,MO,M,17,28,5,3,0,0,53
Cornwall,MOX,F,138,104,63,35,8,39,387
Cornwall,MOX,M,106,106,37,0,0,1,250
Cornwall,MRI,F,96,130,92,62,103,225,708
Cornwall,MRI,M,117,68,16,2,1,2,206
Cornwall,MRIX,F,84,104,108,131,169,412,"1,008"
Cornwall,MRIX,M,93,132,21,4,5,12,267
Cornwall,ND,F,0,0,0,0,0,40,40
Cornwall,ND,M,0,0,0,0,0,8,8
Cornwall,NDX,F,0,0,0,0,0,29,29
Cornwall,NDX,M,0,0,0,0,0,3,3
Cornwall,NO,F,1,11,0,0,1,7,20
Cornwall,NO,M,0,2,0,0,0,0,2
Cornwall,NOX,F,3,13,3,1,0,3,23
Cornwall,NOX,M,3,16,0,0,0,0,19
Cornwall,NRX,F,30,0,0,0,0,0,30
Cornwall,NRX,M,27,0,0,0,0,1,28
Cornwall,NS,F,0,0,0,0,0,979,979
Cornwall,OB,F,0,0,0,0,0,2,2
Cornwall,OEX,M,1,0,0,0,0,0,1
Cornwall,PA,F,1,0,0,0,0,0,1
Cornwall,PA,M,1,0,0,0,1,0,2
Cornwall,PAX,F,1,0,0,1,0,1,3
Cornwall,PAX,M,0,1,0,0,0,0,1
Cornwall,PI,F,0,1,0,0,1,5,7
Cornwall,PI,M,0,0,0,0,0,1,1
Cornwall,PIX,F,0,9,0,0,1,16,26
Cornwall,PIX,M,1,7,0,0,0,2,10
Cornwall,RO,F,0,0,0,0,0,6,6
Cornwall,RO,M,0,0,0,0,0,2,2
Cornwall,RP,F,10,6,2,7,2,24,51
Cornwall,RP,M,4,4,0,0,0,2,10
Cornwall,RPX,F,7,11,3,1,2,6,30
Cornwall,RPX,M,9,6,4,0,0,2,21
Cornwall,RWFR,F,1,0,0,0,0,10,11
Cornwall,SA,F,73,69,37,32,14,76,301
Cornwall,SA,M,85,76,12,8,5,9,195
Cornwall,SAX,F,268,200,66,32,48,233,847
Cornwall,SAX,M,271,189,24,1,0,15,500
Cornwall,SB,F,1,0,0,0,0,0,1
Cornwall,SB,M,1,1,0,0,0,0,2
Cornwall,SBX,F,0,0,1,0,1,0,2
Cornwall,SBX,M,0,2,0,0,0,0,2
Cornwall,SD,F,"1,576","1,386",897,741,691,"3,191","8,482"
Cornwall,SD,M,"1,578","1,396",261,43,38,126,"3,442"
Cornwall,SDX,F,890,721,259,228,195,981,"3,274"
Cornwall,SDX,M,"1,007",697,72,28,10,31,"1,845"
Cornwall,SH,F,7,3,3,0,2,10,25
Cornwall,SH,M,3,4,0,0,0,2,9
Cornwall,SHO,F,78,42,30,39,31,208,428
Cornwall,SHO,M,101,38,17,2,2,13,173
Cornwall,SHOX,F,85,110,85,86,50,265,681
Cornwall,SHOX,M,93,86,14,4,1,6,204
Cornwall,SHX,F,2,0,1,0,0,7,10
Cornwall,SHX,M,6,1,2,0,0,0,9
Cornwall,SM,F,379,382,163,152,135,602,"1,813"
Cornwall,SM,M,406,393,90,35,31,104,"1,059"
Cornwall,SMX,F,"2,494","2,467",849,627,593,"3,035","10,065"
Cornwall,SMX,M,"2,685","2,383",559,28,24,176,"5,855"
Cornwall,SRW,F,5,0,0,1,9,2,17
Cornwall,SRW,M,0,1,1,0,0,0,2
Cornwall,SRWX,F,148,76,65,59,36,10,394
Cornwall,SRWX,M,64,33,2,1,0,0,100
Cornwall,ST,F,1,10,0,0,0,0,11
Cornwall,ST,M,3,10,1,5,0,2,21
Cornwall,STX,F,179,53,32,17,0,0,281
Cornwall,STX,M,145,31,0,1,0,0,177
Cornwall,SU,F,13,10,10,2,3,47,85
Cornwall,SU,M,17,13,2,2,0,3,37
Cornwall,SUX,F,62,43,17,9,6,19,156
Cornwall,SUX,M,68,28,6,0,0,2,104
Cornwall,VNX,M,0,0,0,0,0,1,1
Cornwall,WB,F,105,153,81,91,59,247,736
Cornwall,WB,M,123,94,44,7,4,6,278
Cornwall,WBX,F,42,84,48,53,29,139,395
Cornwall,WBX,M,58,82,26,0,2,4,172
Cornwall,WG,F,10,3,7,2,8,26,56
Cornwall,WG,M,13,2,4,0,0,0,19
Cornwall,WGX,F,0,0,1,0,0,1,2
Cornwall,WGX,M,1,0,0,0,0,0,1
Cornwall,WP,F,7,6,3,6,3,10,35
Cornwall,WP,M,4,2,0,2,0,1,9
Cornwall,WPX,F,0,2,0,0,0,0,2
Cornwall,WPX,M,1,0,0,0,0,1,2
Cornwall,WS,F,2,1,0,2,0,2,7
Cornwall,WS,M,0,0,2,0,0,2,4
Cornwall,WSX,F,7,11,46,37,26,96,223
Cornwall,WSX,M,5,3,7,1,0,0,16
Cornwall,WW,F,0,1,0,0,0,0,1
Cornwall,WWX,F,0,0,0,0,0,13,13
Cumbria,AA,F,443,438,168,216,151,791,"2,207"
Cumbria,AA,M,419,308,59,45,26,96,953
Cumbria,AAX,F,"2,016","1,341",501,399,495,"2,545","7,297"
Cumbria,AAX,M,"2,152","1,351",127,11,9,166,"3,816"
Cumbria,AN,M,0,0,0,0,0,1,1
Cumbria,AR,F,0,1,0,0,0,0,1
Cumbria,ARX,M,1,1,0,0,0,0,2
Cumbria,AY,F,510,505,490,434,378,"1,253","3,570"
Cumbria,AY,M,162,64,12,9,7,11,265
Cumbria,AYX,F,125,100,83,65,12,62,447
Cumbria,AYX,M,53,11,3,1,0,1,69
Cumbria,BA,F,131,129,84,74,90,442,950
Cumbria,BA,M,170,80,24,30,24,101,429
Cumbria,BABX,F,0,0,0,0,0,20,20
Cumbria,BAL,F,14,5,12,4,9,29,73
Cumbria,BAL,M,11,1,1,0,2,2,17
Cumbria,BALX,F,1,0,2,17,6,20,46
Cumbria,BALX,M,1,0,2,1,4,3,11
Cumbria,BAR,F,0,0,0,0,0,2,2
Cumbria,BARX,F,0,0,0,0,0,29,29
Cumbria,BAWX,F,0,0,0,0,0,8,8
Cumbria,BAWX,M,0,0,0,0,0,1,1
Cumbria,BAX,F,"1,610","1,037",294,269,278,"1,837","5,325"
Cumbria,BAX,M,"1,547",886,113,21,21,201,"2,789"
Cumbria,BAZ,F,10,10,12,5,6,35,78
Cumbria,BAZ,M,7,12,8,3,4,14,48
Cumbria,BAZ X,F,0,0,0,0,0,6,6
Cumbria,BAZX,F,218,113,8,13,10,78,440
Cumbria,BAZX,M,226,76,5,0,0,5,312
Cumbria,BB,F,767,717,337,172,156,968,"3,117"
Cumbria,BB,M,806,575,140,70,62,276,"1,929"
Cumbria,BBX,F,"6,966","4,976","1,805","1,329","1,032","5,208","21,316"
Cumbria,BBX,M,"7,316","3,962",511,50,32,327,"12,198"
Cumbria,BF,F,"2,985","3,054","3,609","3,778","3,789","5,907","23,122"
Cumbria,BF,M,"3,011","1,813",436,63,31,37,"5,391"
Cumbria,BFX,F,274,286,355,301,246,502,"1,964"
Cumbria,BFX,M,289,122,49,9,0,2,471
Cumbria,BG,F,94,78,70,36,34,165,477
Cumbria,BG,M,87,64,30,4,4,9,198
Cumbria,BGX,F,32,29,15,9,12,14,111
Cumbria,BGX,M,44,28,15,0,0,1,88
Cumbria,BH,F,29,0,0,0,0,918,947
Cumbria,BH,M,27,0,0,0,0,15,42
Cumbria,BHX,F,22,0,0,0,0,221,243
Cumbria,BHX,M,14,0,0,0,0,12,26
Cumbria,BI,F,0,0,1,0,1,0,2
Cumbria,BI,M,1,0,0,0,0,0,1
Cumbria,BLG,F,69,45,28,19,18,153,332
Cumbria,BLG,M,47,149,25,7,9,7,244
Cumbria,BLGX,F,0,1,0,0,0,0,1
Cumbria,BLGX,M,2,0,1,0,0,0,3
Cumbria,BR,F,0,0,0,0,0,1,1
Cumbria,BRX,F,1,2,1,1,0,1,6
Cumbria,BRX,M,1,0,0,0,0,0,1
Cumbria,BS,F,17,24,40,54,17,122,274
Cumbria,BS,M,24,8,1,3,0,5,41
Cumbria,BSH,F,104,89,52,44,43,89,421
Cumbria,BSH,M,107,62,14,4,7,11,205
Cumbria,BSHO,F,0,0,0,0,0,2,2
Cumbria,BSHX,F,101,92,45,21,10,30,299
Cumbria,BSHX,M,109,79,8,0,0,2,198
Cumbria,BSX,F,39,90,66,34,19,85,333
Cumbria,BSX,M,30,21,4,1,0,6,62
Cumbria,BU,F,0,0,0,0,0,1,1
Cumbria,BU,M,0,0,0,1,0,0,1
Cumbria,BW,F,4,3,4,4,5,32,52
Cumbria,BW,M,7,9,2,0,1,2,21
Cumbria,BWB,F,0,0,2,0,0,0,2
Cumbria,BWB,M,0,2,0,0,0,0,2
Cumbria,BWBX,F,0,0,0,1,0,0,1
Cumbria,BWX,F,0,0,0,1,3,1,5
Cumbria,BX,F,0,0,0,0,0,2,2
Cumbria,CA,F,0,0,0,0,0,4,4
Cumbria,CAX,F,0,0,0,0,0,12,12
Cumbria,CB,F,0,0,1,0,0,54,55
Cumbria,CB,M,1,1,0,0,0,0,2
Cumbria,CD,F,12,12,0,0,1,29,54
Cumbria,CH,F,390,298,153,139,117,823,"1,920"
Cumbria,CH,M,360,264,78,49,39,241,"1,031"
Cumbria,CHIX,F,0,0,0,0,0,3,3
Cumbria,CHLX,M,1,0,0,0,0,0,1
Cumbria,CHX,F,"3,191","2,073",338,194,242,"2,398","8,436"
Cumbria,CHX,M,"3,355","2,179",244,18,14,440,"6,250"
Cumbria,CON,F,0,0,0,0,0,5,5
Cumbria,DE,F,0,0,0,0,0,1,1
Cumbria,DEV,F,8,4,5,1,4,10,32
Cumbria,DEV,M,1,0,0,1,0,2,4
Cumbria,DEVX,F,23,17,8,8,20,57,133
Cumbria,DEVX,M,34,18,2,0,3,1,58
Cumbria,DEX,F,70,81,39,32,34,106,362
Cumbria,DEX,M,63,38,14,5,0,21,141
Cumbria,DEXX,F,1,2,1,4,5,5,18
Cumbria,DEXX,M,2,1,0,0,0,0,3
Cumbria,DG,F,0,0,0,0,0,2,2
Cumbria,DG,M,0,0,0,0,0,1,1
Cumbria,DR,F,6,3,19,16,14,0,58
Cumbria,DR,M,5,2,0,0,0,0,7
Cumbria,DRX,F,5,0,0,3,0,0,8
Cumbria,DRX,M,2,0,0,0,0,0,2
Cumbria,DS,F,14,36,61,40,48,141,340
Cumbria,DS,M,15,6,0,1,0,5,27
Cumbria,DSHO,F,0,0,0,0,0,2,2
Cumbria,DSX,F,3,0,11,2,6,7,29
Cumbria,DV,F,0,0,0,0,0,9,9
Cumbria,DV,M,0,0,0,0,0,1,1
Cumbria,DVX,F,0,0,0,0,0,13,13
Cumbria,FE,F,1,0,0,1,0,2,4
Cumbria,FR,F,0,0,0,0,0,"20,959","20,959"
Cumbria,FR,M,0,0,0,0,0,855,855
Cumbria,FRX,F,0,0,0,0,0,883,883
Cumbria,FRX,M,0,0,0,0,0,73,73
Cumbria,GA,F,167,170,149,94,93,644,"1,317"
Cumbria,GA,M,191,272,98,7,13,37,618
Cumbria,GAS,F,0,0,0,0,0,1,1
Cumbria,GASX,F,2,0,0,0,0,10,12
Cumbria,GASX,M,1,1,0,0,0,0,2
Cumbria,GAX,F,41,58,16,13,12,68,208
Cumbria,GAX,M,47,44,19,2,2,7,121
Cumbria,GB,F,0,1,0,1,0,0,2
Cumbria,GB,M,1,1,0,0,0,0,2
Cumbria,GBX,F,4,2,1,2,0,1,10
Cumbria,GBX,M,1,0,0,0,0,0,1
Cumbria,GE,F,15,9,7,11,3,16,61
Cumbria,GE,M,17,2,0,1,1,4,25
Cumbria,GEX,F,42,57,33,10,13,82,237
Cumbria,GEX,M,56,62,13,1,1,3,136
Cumbria,GL,F,1,4,0,10,1,4,20
Cumbria,GL,M,1,1,0,0,0,0,2
Cumbria,GLX,F,5,0,0,3,0,0,8
Cumbria,GU,F,88,78,97,97,86,268,714
Cumbria,GU,M,5,0,1,0,0,1,7
Cumbria,GUX,F,3,4,5,3,0,3,18
Cumbria,GUX,M,0,1,0,0,0,0,1
Cumbria,GY,F,1,0,0,0,0,0,1
Cumbria,H,F,0,0,0,0,0,90,90
Cumbria,H,M,0,0,0,0,0,10,10
Cumbria,HE,F,91,65,29,40,24,143,392
Cumbria,HE,M,83,65,11,9,8,22,198
Cumbria,HEBL,F,0,0,0,0,0,4,4
Cumbria,HEBLX,F,0,0,0,0,0,77,77
Cumbria,HEBLX,M,0,0,0,0,0,1,1
Cumbria,HER,F,0,0,0,0,0,8,8
Cumbria,HERX,F,0,0,0,0,0,26,26
Cumbria,HERX,M,0,0,0,0,0,1,1
Cumbria,HEX,F,495,425,141,107,172,651,"1,991"
Cumbria,HEX,M,571,490,58,1,0,8,"1,128"
Cumbria,HF,F,"17,275","16,332","18,208","16,576","14,225","26,435","109,051"
Cumbria,HF,M,"9,239","4,196",887,288,83,184,"14,877"
Cumbria,HFX,F,"1,359","1,135","1,309",930,796,"1,558","7,087"
Cumbria,HFX,M,"1,013",526,83,6,5,13,"1,646"
Cumbria,HI,F,98,66,73,46,31,238,552
Cumbria,HI,M,84,103,37,4,10,27,265
Cumbria,HIX,F,2,4,2,1,0,19,28
Cumbria,HIX,M,7,3,1,0,0,0,11
Cumbria,HL,F,0,0,0,0,0,24,24
Cumbria,HL,M,0,0,0,0,0,1,1
Cumbria,HO,F,"3,791","3,512","3,500","3,287","2,852","6,372","23,314"
Cumbria,HO,M,"1,368",719,185,60,9,48,"2,389"
Cumbria,HOX,F,327,254,303,275,310,596,"2,065"
Cumbria,HOX,M,230,72,9,4,4,4,323
Cumbria,HX,F,0,0,0,0,0,251,251
Cumbria,HX,M,0,0,0,0,0,21,21
Cumbria,IM,F,1,1,2,1,1,0,6
Cumbria,IM,M,1,0,0,1,0,1,3
Cumbria,IMX,F,6,0,0,0,1,1,8
Cumbria,IMX,M,1,0,0,0,0,0,1
Cumbria,JE,F,407,421,420,345,254,845,"2,692"
Cumbria,JE,M,35,15,5,6,0,11,72
Cumbria,JEX,F,108,104,37,16,48,95,408
Cumbria,JEX,M,12,4,1,0,0,2,19
Cumbria,JY,F,50,0,0,0,0,5,55
Cumbria,JY,M,10,0,0,0,0,0,10
Cumbria,JYX,F,1,0,0,0,0,0,1
Cumbria,JYX,M,1,0,0,0,0,0,1
Cumbria,KE,F,0,0,0,0,0,5,5
Cumbria,LH,F,36,20,18,14,9,81,178
Cumbria,LH,M,22,28,9,3,1,7,70
Cumbria,LHX,F,10,34,16,2,0,34,96
Cumbria,LHX,M,13,18,1,0,0,2,34
Cumbria,LI,F,0,0,0,0,0,"1,262","1,262"
Cumbria,LI,M,0,0,0,0,0,346,346
Cumbria,LIM,F,"3,918","3,085","1,569","1,232","1,138","4,082","15,024"
Cumbria,LIM,M,"4,065","2,407",526,301,275,831,"8,405"
Cumbria,LIM X,F,0,0,0,0,0,5,5
Cumbria,LIMB,F,0,0,0,0,0,62,62
Cumbria,LIMB,M,0,0,0,0,0,2,2
Cumbria,LIMBX,F,0,0,0,0,0,"1,197","1,197"
Cumbria,LIMBX,M,0,0,0,0,0,6,6
Cumbria,LIMR,F,0,0,0,0,0,193,193
Cumbria,LIMR,M,0,0,0,0,0,39,39
Cumbria,LIMRX,F,0,0,0,0,0,371,371
Cumbria,LIMRX,M,0,0,0,0,0,7,7
Cumbria,LIMX,F,"25,184","17,956","5,798","3,984","3,995","16,614","73,531"
Cumbria,LIMX,M,"25,643","15,060","2,038",197,113,339,"43,390"
Cumbria,LIX,F,0,0,0,0,0,"4,958","4,958"
Cumbria,LIX,M,0,0,0,0,0,"1,192","1,192"
Cumbria,LM,F,0,0,0,0,0,105,105
Cumbria,LM,M,0,0,0,0,0,26,26
Cumbria,LMX,F,0,0,0,0,0,353,353
Cumbria,LMX,M,0,0,0,0,0,3,3
Cumbria,LR,F,4,0,0,0,5,6,15
Cumbria,LR,M,2,4,0,0,0,0,6
Cumbria,LRX,F,0,0,1,0,2,12,15
Cumbria,LRX,M,0,0,0,0,0,1,1
Cumbria,LU,F,5,26,4,19,0,14,68
Cumbria,LU,M,12,73,1,0,0,0,86
Cumbria,LUX,F,0,0,0,0,0,5,5
Cumbria,LUX,M,0,13,2,0,0,0,15
Cumbria,MA,F,1,0,0,0,0,0,1
Cumbria,MARX,F,6,6,1,0,0,22,35
Cumbria,MARX,M,5,4,0,0,0,4,13
Cumbria,MAX,F,0,0,0,0,0,1,1
Cumbria,MG,F,0,0,0,0,0,7,7
Cumbria,MG,M,0,1,0,0,0,2,3
Cumbria,MGX,F,0,0,1,1,1,7,10
Cumbria,MGX,M,2,2,1,0,0,0,5
Cumbria,MO,F,211,129,104,108,63,131,746
Cumbria,MO,M,182,61,16,0,2,7,268
Cumbria,MOX,F,470,228,241,116,93,123,"1,271"
Cumbria,MOX,M,396,158,11,0,1,1,567
Cumbria,MRI,F,41,34,42,24,59,133,333
Cumbria,MRI,M,50,16,4,1,2,13,86
Cumbria,MRIX,F,225,270,237,138,123,227,"1,220"
Cumbria,MRIX,M,204,172,29,0,1,11,417
Cumbria,ND,F,0,0,0,0,0,2,2
Cumbria,NO,F,18,20,23,16,12,22,111
Cumbria,NO,M,34,10,3,1,0,0,48
Cumbria,NOX,F,2,6,8,6,3,26,51
Cumbria,NOX,M,2,2,0,0,0,0,4
Cumbria,NR,F,5,0,0,0,0,0,5
Cumbria,NR,M,4,0,0,0,0,0,4
Cumbria,NRX,F,21,0,0,0,0,1,22
Cumbria,NRX,M,9,0,0,0,0,0,9
Cumbria,NS,F,0,0,0,0,0,"1,092","1,092"
Cumbria,NS,M,0,0,0,0,0,7,7
Cumbria,OB,F,0,0,0,0,0,10,10
Cumbria,OD,F,0,0,0,0,0,23,23
Cumbria,OE,F,0,0,0,0,0,3,3
Cumbria,OEX,F,0,0,0,0,0,1,1
Cumbria,OO,F,0,0,0,0,0,1,1
Cumbria,PA,F,5,1,2,2,3,10,23
Cumbria,PA,M,6,7,4,0,0,2,19
Cumbria,PAX,F,54,14,6,4,10,49,137
Cumbria,PAX,M,32,6,0,0,0,4,42
Cumbria,PI,F,0,0,0,1,2,24,27
Cumbria,PI,M,0,0,0,0,0,2,2
Cumbria,PIX,F,32,28,6,9,7,119,201
Cumbria,PIX,M,21,15,0,0,0,4,40
Cumbria,RO,F,0,0,0,0,1,2,3
Cumbria,ROX,F,1,0,0,0,0,4,5
Cumbria,ROX,M,2,0,0,0,0,2,4
Cumbria,RP,F,8,6,8,4,1,33,60
Cumbria,RP,M,9,1,0,1,0,2,13
Cumbria,RPX,F,9,5,8,4,2,2,30
Cumbria,RPX,M,10,10,3,0,0,1,24
Cumbria,RWFR,F,0,0,0,0,0,2,2
Cumbria,SA,F,86,73,43,55,40,233,530
Cumbria,SA,M,123,48,9,6,3,15,204
Cumbria,SAX,F,174,101,74,84,81,431,945
Cumbria,SAX,M,159,57,17,0,1,11,245
Cumbria,SB,F,0,0,0,0,0,1,1
Cumbria,SBX,F,0,1,1,1,0,1,4
Cumbria,SD,F,13,18,9,4,8,22,74
Cumbria,SD,M,12,13,2,3,0,5,35
Cumbria,SDX,F,60,73,34,23,4,59,253
Cumbria,SDX,M,63,58,6,0,0,1,128
Cumbria,SGX,F,1,0,0,0,0,0,1
Cumbria,SGX,M,0,0,0,0,1,0,1
Cumbria,SH,F,6,3,5,4,2,12,32
Cumbria,SH,M,3,1,5,0,0,1,10
Cumbria,SHO,F,199,141,130,102,61,319,952
Cumbria,SHO,M,151,85,20,5,2,24,287
Cumbria,SHOX,F,50,46,30,27,9,88,250
Cumbria,SHOX,M,91,50,11,0,0,8,160
Cumbria,SHX,F,1,0,0,0,0,3,4
Cumbria,SHX,M,2,0,1,0,0,0,3
Cumbria,SM,F,301,283,141,122,128,658,"1,633"
Cumbria,SM,M,297,200,53,14,12,80,656
Cumbria,SMX,F,"1,157","1,126",357,260,275,"2,299","5,474"
Cumbria,SMX,M,"1,137",874,68,14,7,198,"2,298"
Cumbria,SOBX,M,0,1,0,0,0,0,1
Cumbria,SRW,F,20,11,15,15,1,2,64
Cumbria,SRW,M,15,8,1,0,0,0,24
Cumbria,SRWX,F,194,61,56,64,63,20,458
Cumbria,SRWX,M,61,8,3,1,0,0,73
Cumbria,ST,F,15,19,11,2,0,0,47
Cumbria,ST,M,19,10,11,5,1,1,47
Cumbria,STX,F,172,73,48,3,0,0,296
Cumbria,STX,M,151,32,0,0,0,2,185
Cumbria,SU,F,0,0,1,0,0,1,2
Cumbria,SU,M,0,0,0,0,0,2,2
Cumbria,SUX,F,0,1,6,1,0,21,29
Cumbria,SUX,M,0,4,3,0,0,5,12
Cumbria,WB,F,4,6,9,10,3,19,51
Cumbria,WB,M,4,9,6,2,0,1,22
Cumbria,WBX,F,9,9,6,2,11,30,67
Cumbria,WBX,M,8,11,7,0,0,1,27
Cumbria,WG,F,10,9,6,3,5,17,50
Cumbria,WG,M,8,11,1,1,2,1,24
Cumbria,WGX,F,1,0,0,1,0,0,2
Cumbria,WP,F,0,1,2,0,0,2,5
Cumbria,WP,M,0,1,0,0,0,0,1
Cumbria,WPX,F,0,0,0,0,2,1,3
Cumbria,WS,F,9,8,7,5,4,22,55
Cumbria,WS,M,9,12,2,3,0,6,32
Cumbria,WSX,F,10,16,17,15,6,28,92
Cumbria,WSX,M,29,95,28,0,0,0,152
Derbyshire,AA,F,389,277,194,175,102,649,"1,786"
Derbyshire,AA,M,288,207,50,30,23,74,672
Derbyshire,AAX,F,"1,431","1,122",542,402,332,"1,318","5,147"
Derbyshire,AAX,M,"1,220",794,211,17,8,77,"2,327"
Derbyshire,AM,F,1,0,0,0,0,0,1
Derbyshire,AM,M,0,1,0,0,0,0,1
Derbyshire,AR,F,1,0,0,0,0,0,1
Derbyshire,ARX,F,0,0,0,1,0,1,2
Derbyshire,AU,F,0,0,0,0,1,1,2
Derbyshire,AUX,F,0,0,0,0,0,1,1
Derbyshire,AY,F,261,255,222,192,164,464,"1,558"
Derbyshire,AY,M,109,36,13,12,4,8,182
Derbyshire,AYX,F,31,13,11,10,3,25,93
Derbyshire,AYX,M,18,12,6,0,0,3,39
Derbyshire,BA,F,61,49,21,17,11,92,251
Derbyshire,BA,M,68,49,8,13,13,40,191
Derbyshire,BABX,F,0,0,0,0,0,1,1
Derbyshire,BAL,F,2,2,0,1,0,15,20
Derbyshire,BAL,M,1,0,0,0,0,0,1
Derbyshire,BALX,F,0,2,3,2,0,17,24
Derbyshire,BARX,F,0,0,0,0,0,4,4
Derbyshire,BAWX,F,0,0,0,0,0,4,4
Derbyshire,BAX,F,801,568,143,94,96,362,"2,064"
Derbyshire,BAX,M,679,431,43,7,0,28,"1,188"
Derbyshire,BAZ,F,13,4,5,0,0,0,22
Derbyshire,BAZ,M,19,5,1,1,0,0,26
Derbyshire,BAZX,F,7,13,0,0,0,41,61
Derbyshire,BAZX,M,10,4,0,0,0,0,14
Derbyshire,BB,F,277,278,136,78,58,392,"1,219"
Derbyshire,BB,M,277,169,56,21,19,103,645
Derbyshire,BBX,F,"2,381","2,010",781,467,366,"1,236","7,241"
Derbyshire,BBX,M,"2,185","1,357",218,20,9,96,"3,885"
Derbyshire,BF,F,"1,944","1,846","2,215","2,042","1,961","3,245","13,253"
Derbyshire,BF,M,"1,567",859,195,31,32,20,"2,704"
Derbyshire,BFX,F,234,185,175,245,179,257,"1,275"
Derbyshire,BFX,M,256,99,47,3,6,10,421
Derbyshire,BG,F,19,10,18,11,5,20,83
Derbyshire,BG,M,11,3,4,6,8,9,41
Derbyshire,BGX,F,4,10,1,2,2,9,28
Derbyshire,BGX,M,5,12,0,0,0,1,18
Derbyshire,BH,F,22,0,0,0,0,205,227
Derbyshire,BH,M,0,0,0,0,0,4,4
Derbyshire,BHX,F,1,0,0,0,0,14,15
Derbyshire,BHX,M,1,0,0,0,0,0,1
Derbyshire,BLG,F,0,0,0,0,0,5,5
Derbyshire,BLGX,F,0,0,0,0,0,1,1
Derbyshire,BR,F,0,0,0,1,0,0,1
Derbyshire,BRX,F,0,1,0,0,0,0,1
Derbyshire,BRX,M,1,1,0,0,0,0,2
Derbyshire,BS,F,4,22,7,6,3,30,72
Derbyshire,BS,M,7,10,1,0,0,1,19
Derbyshire,BSH,F,8,5,7,3,6,8,37
Derbyshire,BSH,M,6,6,1,0,2,3,18
Derbyshire,BSHX,F,13,4,12,10,15,14,68
Derbyshire,BSHX,M,19,2,1,0,0,0,22
Derbyshire,BSX,F,20,10,14,5,7,48,104
Derbyshire,BSX,M,43,23,4,2,0,0,72
Derbyshire,BU,F,27,33,20,31,21,68,200
Derbyshire,BU,M,25,20,28,3,0,2,78
Derbyshire,BW,F,3,5,4,3,7,25,47
Derbyshire,BW,M,10,4,2,0,2,5,23
Derbyshire,BWB,F,0,0,0,0,1,0,1
Derbyshire,BWX,F,5,3,1,0,1,5,15
Derbyshire,BWX,M,2,2,1,0,0,0,5
Derbyshire,CAX,F,0,0,0,0,0,13,13
Derbyshire,CAX,M,0,0,0,0,0,1,1
Derbyshire,CB,F,0,0,0,0,0,53,53
Derbyshire,CB,M,0,0,0,0,0,2,2
Derbyshire,CD,F,3,0,0,0,0,7,10
Derbyshire,CH,F,338,352,138,111,97,740,"1,776"
Derbyshire,CH,M,342,261,91,31,20,120,865
Derbyshire,CHIX,F,0,0,0,0,0,2,2
Derbyshire,CHIX,M,0,0,0,0,0,2,2
Derbyshire,CHLX,F,0,0,0,0,0,1,1
Derbyshire,CHX,F,"1,364","1,134",403,257,222,"1,436","4,816"
Derbyshire,CHX,M,"1,300",972,184,24,11,151,"2,642"
Derbyshire,DEV,F,0,0,6,0,0,1,7
Derbyshire,DEVX,F,9,2,3,0,3,10,27
Derbyshire,DEVX,M,7,4,1,0,0,1,13
Derbyshire,DEX,F,28,27,25,33,11,80,204
Derbyshire,DEX,M,40,35,12,3,2,5,97
Derbyshire,DEXX,F,4,6,7,1,2,1,21
Derbyshire,DEXX,M,2,0,0,0,0,0,2
Derbyshire,DS,F,28,15,18,40,35,70,206
Derbyshire,DS,M,22,11,4,2,1,2,42
Derbyshire,DSHO,F,1,0,0,0,0,0,1
Derbyshire,DSX,F,4,9,5,6,15,36,75
Derbyshire,DSX,M,4,3,1,0,0,0,8
Derbyshire,DV,F,0,0,0,0,0,16,16
Derbyshire,DVX,F,0,0,0,0,0,8,8
Derbyshire,DVX,M,0,0,0,0,0,5,5
Derbyshire,EP,F,0,0,0,0,0,1,1
Derbyshire,FR,F,0,0,0,1,0,"9,010","9,011"
Derbyshire,FR,M,0,0,0,0,0,254,254
Derbyshire,FRX,F,0,0,0,0,0,260,260
Derbyshire,FRX,M,0,0,0,0,0,31,31
Derbyshire,GA,F,7,7,6,6,5,18,49
Derbyshire,GA,M,12,8,4,0,1,4,29
Derbyshire,GASX,F,1,0,0,0,0,0,1
Derbyshire,GASX,M,3,0,0,0,0,0,3
Derbyshire,GAX,F,5,10,2,2,2,14,35
Derbyshire,GAX,M,7,11,1,0,0,7,26
Derbyshire,GB,F,0,1,0,0,0,0,1
Derbyshire,GBX,F,2,0,0,0,0,0,2
Derbyshire,GBX,M,0,1,0,0,0,0,1
Derbyshire,GE,F,0,0,0,0,0,1,1
Derbyshire,GEX,F,0,0,1,0,0,4,5
Derbyshire,GEX,M,0,3,0,0,0,6,9
Derbyshire,GL,F,3,10,2,4,3,13,35
Derbyshire,GL,M,3,3,3,1,0,0,10
Derbyshire,GLX,F,4,3,5,1,0,0,13
Derbyshire,GLX,M,0,2,1,0,0,0,3
Derbyshire,GU,F,34,30,18,22,34,91,229
Derbyshire,GU,M,20,0,1,0,0,0,21
Derbyshire,GUX,F,1,3,2,4,0,9,19
Derbyshire,H,F,0,0,0,0,0,239,239
Derbyshire,H,M,0,0,0,0,0,38,38
Derbyshire,HE,F,314,210,166,140,125,423,"1,378"
Derbyshire,HE,M,302,177,60,32,25,43,639
Derbyshire,HEBL,F,0,0,0,0,0,30,30
Derbyshire,HEBL,M,0,0,0,0,0,1,1
Derbyshire,HEBLX,F,0,0,0,0,0,127,127
Derbyshire,HEBLX,M,0,0,0,0,0,8,8
Derbyshire,HEBR,F,0,0,0,0,0,2,2
Derbyshire,HEBR,M,0,0,0,0,0,1,1
Derbyshire,HEBRX,F,0,0,0,0,0,3,3
Derbyshire,HER,F,0,0,0,0,0,27,27
Derbyshire,HER,M,0,0,0,0,0,1,1
Derbyshire,HERX,F,0,0,0,0,0,74,74
Derbyshire,HERX,M,0,0,0,0,0,2,2
Derbyshire,HEX,F,"1,528","1,390",665,435,383,"1,273","5,674"
Derbyshire,HEX,M,"1,496",958,258,19,19,27,"2,777"
Derbyshire,HF,F,"6,915","6,842","7,164","5,783","4,847","9,683","41,234"
Derbyshire,HF,M,"3,447","1,667",386,96,47,100,"5,743"
Derbyshire,HFX,F,520,611,648,547,494,747,"3,567"
Derbyshire,HFX,M,346,196,74,5,2,12,635
Derbyshire,HI,F,87,68,55,54,61,304,629
Derbyshire,HI,M,74,74,20,6,5,14,193
Derbyshire,HIX,F,24,10,6,6,4,27,77
Derbyshire,HIX,M,16,1,3,1,0,1,22
Derbyshire,HL,F,0,0,0,0,0,7,7
Derbyshire,HL,M,0,0,0,0,0,1,1
Derbyshire,HLX,F,0,0,0,0,0,1,1
Derbyshire,HO,F,"1,286",977,949,687,562,"1,000","5,461"
Derbyshire,HO,M,372,178,66,26,18,13,673
Derbyshire,HOX,F,26,63,78,83,59,197,506
Derbyshire,HOX,M,30,17,6,2,0,2,57
Derbyshire,HX,F,0,0,0,0,0,607,607
Derbyshire,HX,M,0,0,0,0,0,123,123
Derbyshire,IM,F,0,2,0,3,0,3,8
Derbyshire,IM,M,0,1,0,0,0,0,1
Derbyshire,IMX,F,0,0,0,0,1,2,3
Derbyshire,IMX,M,0,2,4,0,0,0,6
Derbyshire,JE,F,293,313,269,224,249,570,"1,918"
Derbyshire,JE,M,17,30,11,2,3,7,70
Derbyshire,JEX,F,51,47,48,64,60,23,293
Derbyshire,JEX,M,26,13,1,0,2,0,42
Derbyshire,JY,F,45,0,0,0,0,0,45
Derbyshire,JY,M,10,0,0,0,0,0,10
Derbyshire,JYX,F,2,0,0,0,0,0,2
Derbyshire,JYX,M,2,0,0,0,0,0,2
Derbyshire,KE,F,0,0,0,0,1,4,5
Derbyshire,KEX,M,0,1,0,0,0,0,1
Derbyshire,LH,F,64,33,30,26,21,86,260
Derbyshire,LH,M,48,31,8,6,4,8,105
Derbyshire,LHX,F,67,24,19,15,5,14,144
Derbyshire,LHX,M,55,30,2,1,0,0,88
Derbyshire,LI,F,0,0,0,0,0,238,238
Derbyshire,LI,M,0,0,0,0,0,80,80
Derbyshire,LIM,F,"1,173",921,471,329,299,975,"4,168"
Derbyshire,LIM,M,"1,058",691,166,72,71,174,"2,232"
Derbyshire,LIM X,F,0,0,0,0,0,2,2
Derbyshire,LIMB,F,0,0,0,0,0,12,12
Derbyshire,LIMB,M,0,0,0,0,0,2,2
Derbyshire,LIMBX,F,0,0,0,0,0,229,229
Derbyshire,LIMBX,M,0,0,0,0,0,4,4
Derbyshire,LIMR,F,0,0,0,0,0,46,46
Derbyshire,LIMR,M,0,0,0,0,0,12,12
Derbyshire,LIMRX,F,0,0,0,0,0,88,88
Derbyshire,LIMRX,M,0,0,0,0,0,3,3
Derbyshire,LIMX,F,"6,008","4,371","1,577","1,105",953,"2,503","16,517"
Derbyshire,LIMX,M,"5,938","3,177",471,47,19,117,"9,769"
Derbyshire,LIX,F,0,0,0,0,0,870,870
Derbyshire,LIX,M,0,0,0,0,0,134,134
Derbyshire,LM,F,0,0,0,0,0,10,10
Derbyshire,LM,M,0,0,0,0,0,1,1
Derbyshire,LMX,F,0,0,0,0,0,35,35
Derbyshire,LR,F,19,24,13,17,9,29,111
Derbyshire,LR,M,13,12,1,2,0,1,29
Derbyshire,LRX,F,8,10,1,4,3,2,28
Derbyshire,LRX,M,11,5,2,0,0,0,18
Derbyshire,LU,F,0,0,0,0,0,1,1
Derbyshire,MAR,F,0,0,1,0,0,1,2
Derbyshire,MARX,F,1,1,0,0,0,0,2
Derbyshire,MARX,M,1,0,0,0,0,0,1
Derbyshire,MAX,F,0,0,0,0,0,1,1
Derbyshire,MGX,F,2,1,1,0,2,3,9
Derbyshire,MGX,M,2,1,0,0,0,0,3
Derbyshire,MO,F,5,10,6,9,4,32,66
Derbyshire,MO,M,6,2,2,1,0,0,11
Derbyshire,MOX,F,71,37,91,66,18,40,323
Derbyshire,MOX,M,69,28,16,0,0,1,114
Derbyshire,MRI,F,17,5,6,5,7,10,50
Derbyshire,MRI,M,9,18,2,0,0,3,32
Derbyshire,MRIX,F,12,13,11,13,10,31,90
Derbyshire,MRIX,M,38,11,4,1,0,0,54
Derbyshire,NO,F,1,0,0,3,3,1,8
Derbyshire,NO,M,3,0,0,1,0,2,6
Derbyshire,NOX,F,14,0,0,3,0,0,17
Derbyshire,NOX,M,16,0,0,0,0,0,16
Derbyshire,NRX,F,7,0,0,0,1,0,8
Derbyshire,NRX,M,1,0,0,0,0,0,1
Derbyshire,NS,F,0,0,0,0,0,519,519
Derbyshire,NS,M,0,0,0,0,0,1,1
Derbyshire,OB,F,0,0,0,0,0,5,5
Derbyshire,OO,F,0,0,0,0,0,1,1
Derbyshire,PA,F,1,0,0,0,0,1,2
Derbyshire,PA,M,0,0,0,0,1,0,1
Derbyshire,PAX,F,17,9,1,3,4,11,45
Derbyshire,PAX,M,9,11,0,0,0,0,20
Derbyshire,PI,F,0,0,0,1,0,6,7
Derbyshire,PI,M,0,0,0,0,0,3,3
Derbyshire,PIX,F,40,24,1,7,3,32,107
Derbyshire,PIX,M,32,21,0,0,0,0,53
Derbyshire,RO,F,0,0,0,0,0,1,1
Derbyshire,RO,M,1,0,0,0,0,1,2
Derbyshire,ROX,F,15,23,1,2,0,3,44
Derbyshire,ROX,M,25,22,0,0,0,0,47
Derbyshire,RP,F,1,1,3,1,4,10,20
Derbyshire,RP,M,3,5,3,0,0,0,11
Derbyshire,RPX,F,1,0,6,3,0,2,12
Derbyshire,RPX,M,1,1,1,0,0,0,3
Derbyshire,RWFR,F,0,0,0,0,0,10,10
Derbyshire,SA,F,56,30,3,5,3,22,119
Derbyshire,SA,M,51,32,10,0,1,6,100
Derbyshire,SAX,F,79,67,28,16,22,153,365
Derbyshire,SAX,M,74,60,10,1,0,4,149
Derbyshire,SD,F,116,103,37,65,42,130,493
Derbyshire,SD,M,125,22,2,5,3,17,174
Derbyshire,SDX,F,84,53,26,19,9,73,264
Derbyshire,SDX,M,82,75,16,4,3,0,180
Derbyshire,SH,F,0,4,2,2,2,6,16
Derbyshire,SH,M,2,1,0,0,0,0,3
Derbyshire,SHO,F,131,96,115,98,115,309,864
Derbyshire,SHO,M,176,54,25,5,2,21,283
Derbyshire,SHOX,F,133,47,32,32,24,106,374
Derbyshire,SHOX,M,114,29,7,1,0,2,153
Derbyshire,SHX,F,0,0,1,0,2,5,8
Derbyshire,SHX,M,3,1,0,0,0,0,4
Derbyshire,SM,F,572,518,327,226,181,722,"2,546"
Derbyshire,SM,M,462,210,76,24,17,94,883
Derbyshire,SMX,F,"1,612","1,467",565,380,400,"1,889","6,313"
Derbyshire,SMX,M,"1,388",965,157,14,7,135,"2,666"
Derbyshire,SRW,F,13,17,1,1,0,3,35
Derbyshire,SRW,M,12,22,0,0,0,0,34
Derbyshire,SRWX,F,62,45,63,56,47,3,276
Derbyshire,SRWX,M,41,18,5,0,0,0,64
Derbyshire,ST,M,0,0,2,0,0,0,2
Derbyshire,STX,F,34,9,0,0,0,0,43
Derbyshire,STX,M,27,17,0,0,0,0,44
Derbyshire,SU,F,0,1,1,0,0,4,6
Derbyshire,SUX,F,2,3,1,1,0,6,13
Derbyshire,SUX,M,2,2,1,0,0,0,5
Derbyshire,WB,F,12,22,12,7,2,69,124
Derbyshire,WB,M,11,16,7,3,1,1,39
Derbyshire,WBX,F,21,12,4,0,4,48,89
Derbyshire,WBX,M,27,5,2,2,0,7,43
Derbyshire,WP,F,0,0,0,1,0,2,3
Derbyshire,WP,M,0,1,0,0,0,0,1
Derbyshire,WPX,F,1,2,0,0,0,1,4
Derbyshire,WPX,M,0,1,0,0,0,0,1
Derbyshire,WS,F,2,4,2,1,0,0,9
Derbyshire,WS,M,1,0,1,1,1,0,4
Derbyshire,WSX,F,28,32,14,17,2,3,96
Derbyshire,WSX,M,24,12,7,9,1,0,53
Derbyshire,WW,F,0,0,0,1,0,0,1
Derbyshire,WW,M,0,1,0,0,0,0,1
Derbyshire,WWX,F,0,3,0,2,0,0,5
Derbyshire,WWX,M,0,1,0,0,0,0,1
Devon,AA,F,931,709,379,319,243,"1,139","3,720"
Devon,AA,M,"1,065",713,155,54,42,165,"2,194"
Devon,AAX,F,"3,817","3,341","1,207",812,773,"3,012","12,962"
Devon,AAX,M,"4,589","3,553",544,42,24,147,"8,899"
Devon,AR,F,1,1,1,0,0,0,3
Devon,AR,M,1,1,0,0,0,0,2
Devon,ARX,F,1,0,0,0,0,1,2
Devon,ARX,M,1,1,0,0,0,0,2
Devon,AY,F,370,340,318,305,272,731,"2,336"
Devon,AY,M,98,29,27,8,1,3,166
Devon,AYX,F,104,87,126,132,75,108,632
Devon,AYX,M,51,19,2,1,0,4,77
Devon,BA,F,278,222,134,92,71,351,"1,148"
Devon,BA,M,284,206,89,41,28,101,749
Devon,BABX,F,0,0,0,0,0,21,21
Devon,BABX,M,0,0,0,0,0,1,1
Devon,BAL,M,0,0,1,0,0,0,1
Devon,BALX,F,0,0,0,0,0,4,4
Devon,BAR,F,0,0,0,0,0,4,4
Devon,BARX,F,0,0,0,0,0,25,25
Devon,BAW,F,0,0,0,0,0,1,1
Devon,BAWX,F,0,0,0,0,0,10,10
Devon,BAX,F,"2,614","2,311",681,325,278,"1,226","7,435"
Devon,BAX,M,"2,647","2,123",425,20,15,88,"5,318"
Devon,BAZ,F,0,0,0,0,0,1,1
Devon,BAZ,M,1,1,0,0,0,0,2
Devon,BAZ X,M,0,0,0,0,0,1,1
Devon,BAZX,F,13,25,5,0,3,13,59
Devon,BAZX,M,46,50,22,1,0,0,119
Devon,BB,F,264,264,127,46,49,305,"1,055"
Devon,BB,M,408,399,137,13,15,53,"1,025"
Devon,BBX,F,"2,883","2,644","1,008",380,259,"1,345","8,519"
Devon,BBX,M,"3,937","3,582",990,17,17,136,"8,679"
Devon,BF,F,"3,749","3,873","4,743","5,080","5,404","8,530","31,379"
Devon,BF,M,"3,339","2,458","1,023",131,54,58,"7,063"
Devon,BFX,F,668,374,402,277,294,499,"2,514"
Devon,BFX,M,391,257,119,7,2,8,784
Devon,BG,F,85,72,66,45,43,173,484
Devon,BG,M,71,39,17,1,0,11,139
Devon,BGX,F,12,8,12,11,16,24,83
Devon,BGX,M,13,7,2,2,0,0,24
Devon,BH,F,113,0,0,0,0,873,986
Devon,BH,M,23,0,0,0,0,2,25
Devon,BHX,F,17,0,0,0,0,70,87
Devon,BHX,M,7,0,0,0,0,0,7
Devon,BI,F,4,0,6,1,2,11,24
Devon,BI,M,2,4,2,1,0,2,11
Devon,BLG,F,12,8,6,1,42,180,249
Devon,BLG,M,11,1,0,0,0,0,12
Devon,BLGX,F,3,5,0,0,0,21,29
Devon,BLGX,M,1,7,0,0,0,0,8
Devon,BP,F,0,0,1,0,0,0,1
Devon,BPX,F,0,1,0,0,0,0,1
Devon,BR,F,0,0,0,0,1,1,2
Devon,BRX,F,0,1,2,0,1,0,4
Devon,BRX,M,1,3,0,0,0,0,4
Devon,BS,F,42,22,30,41,29,75,239
Devon,BS,M,10,8,12,2,0,1,33
Devon,BSH,F,13,9,6,10,5,36,79
Devon,BSH,M,11,11,12,2,2,3,41
Devon,BSHO,F,0,0,0,0,0,1,1
Devon,BSHX,F,38,25,18,16,4,15,116
Devon,BSHX,M,42,25,1,0,0,1,69
Devon,BSX,F,105,136,132,108,74,175,730
Devon,BSX,M,60,81,21,3,2,2,169
Devon,BU,F,20,11,11,5,4,38,89
Devon,BU,M,12,10,2,0,1,1,26
Devon,BW,F,21,27,18,16,16,79,177
Devon,BW,M,26,30,4,3,2,5,70
Devon,BWB,F,0,0,0,0,1,1,2
Devon,BWBX,F,0,0,0,0,2,0,2
Devon,BWX,F,48,30,9,15,9,43,154
Devon,BWX,M,42,22,4,2,0,2,72
Devon,BX,F,0,0,0,0,0,1,1
Devon,CA,F,0,0,0,0,0,8,8
Devon,CAX,F,0,0,0,0,0,8,8
Devon,CB,F,3,3,0,0,0,126,132
Devon,CB,M,6,2,0,0,0,0,8
Devon,CD,F,0,0,1,16,1,3,21
Devon,CD,M,1,1,0,0,0,0,2
Devon,CH,F,"1,216","1,104",484,333,296,"1,975","5,408"
Devon,CH,M,"1,409","1,210",400,139,108,497,"3,763"
Devon,CHI,F,1,0,0,0,0,0,1
Devon,CHIX,F,0,0,0,0,0,2,2
Devon,CHIX,M,1,0,0,0,0,0,1
Devon,CHX,F,"9,335","8,503","2,179",851,947,"6,141","27,956"
Devon,CHX,M,"10,163","10,088","2,124",112,65,674,"23,226"
Devon,DE,F,0,0,0,0,0,1,1
Devon,DEV,F,"1,438","1,227",847,734,602,"2,054","6,902"
Devon,DEV,M,"1,310","1,166",290,87,44,122,"3,019"
Devon,DEVX,F,"1,054",965,433,292,281,"1,078","4,103"
Devon,DEVX,M,"1,132",882,199,32,26,62,"2,333"
Devon,DEX,F,200,160,148,112,85,377,"1,082"
Devon,DEX,M,192,155,55,14,11,48,475
Devon,DEXX,F,19,28,16,8,2,20,93
Devon,DEXX,M,27,13,2,1,0,1,44
Devon,DG,F,0,0,0,0,0,74,74
Devon,DG,M,0,0,0,0,0,1,1
Devon,DGX,F,0,0,0,0,0,1,1
Devon,DR,F,0,0,0,2,0,3,5
Devon,DRX,F,10,0,19,1,0,0,30
Devon,DRX,M,6,6,2,0,0,0,14
Devon,DS,F,87,85,72,37,16,89,386
Devon,DS,M,6,6,3,2,1,1,19
Devon,DSHO,F,1,0,0,0,0,3,4
Devon,DSX,F,60,33,88,41,7,5,234
Devon,DSX,M,27,17,4,1,0,0,49
Devon,DV,F,0,0,0,0,0,681,681
Devon,DV,M,0,0,0,0,0,69,69
Devon,DVX,F,0,0,0,0,0,206,206
Devon,DVX,M,0,0,0,0,0,28,28
Devon,EPX,F,0,0,0,0,0,1,1
Devon,FE,F,1,1,1,0,0,0,3
Devon,FR,F,0,0,0,0,1,"31,630","31,631"
Devon,FR,M,0,0,0,0,0,417,417
Devon,FRX,F,0,0,0,0,0,652,652
Devon,FRX,M,0,0,0,0,0,101,101
Devon,GA,F,261,224,234,237,231,"1,051","2,238"
Devon,GA,M,299,189,56,9,9,50,612
Devon,GASX,F,0,2,0,0,0,0,2
Devon,GASX,M,2,0,0,0,0,0,2
Devon,GAX,F,197,115,121,94,50,564,"1,141"
Devon,GAX,M,176,130,43,0,1,6,356
Devon,GB,M,0,0,1,0,0,0,1
Devon,GBX,F,0,1,0,0,0,0,1
Devon,GBX,M,1,3,0,0,0,0,4
Devon,GE,F,39,30,14,13,14,37,147
Devon,GE,M,34,17,4,1,2,3,61
Devon,GEX,F,92,95,21,9,2,13,232
Devon,GEX,M,91,55,1,1,0,1,149
Devon,GL,F,4,1,1,1,2,6,15
Devon,GL,M,2,0,1,0,0,0,3
Devon,GLX,M,1,0,0,0,0,0,1
Devon,GU,F,287,269,187,233,233,711,"1,920"
Devon,GU,M,23,20,8,0,0,2,53
Devon,GUX,F,15,16,16,11,4,21,83
Devon,GUX,M,13,8,0,0,0,4,25
Devon,GY,F,11,0,0,0,0,1,12
Devon,GY,M,3,0,0,0,0,0,3
Devon,GYX,F,12,0,0,0,0,0,12
Devon,GYX,M,1,0,0,0,0,0,1
Devon,H,F,0,0,0,0,0,284,284
Devon,H,M,0,0,0,0,0,49,49
Devon,HE,F,340,310,203,127,133,464,"1,577"
Devon,HE,M,334,255,106,33,29,60,817
Devon,HEBL,F,0,0,0,0,0,27,27
Devon,HEBLX,F,0,0,0,0,0,285,285
Devon,HEBLX,M,0,0,0,0,0,7,7
Devon,HER,F,0,0,0,0,0,23,23
Devon,HER,M,0,0,0,0,0,2,2
Devon,HERX,F,0,0,0,0,0,129,129
Devon,HERX,M,0,0,0,0,0,3,3
Devon,HEX,F,"2,179","1,988","1,305",810,930,"3,193","10,405"
Devon,HEX,M,"2,188","2,036",448,34,13,56,"4,775"
Devon,HF,F,"22,562","21,400","21,984","19,305","15,966","30,803","132,020"
Devon,HF,M,"13,120","6,431","2,510",251,81,177,"22,570"
Devon,HFX,F,"1,181",964,983,721,626,"1,356","5,831"
Devon,HFX,M,726,449,132,5,1,5,"1,318"
Devon,HI,F,62,50,25,42,26,155,360
Devon,HI,M,46,37,16,16,4,13,132
Devon,HIX,F,1,7,7,6,8,32,61
Devon,HIX,M,2,4,0,0,0,1,7
Devon,HL,F,0,0,0,0,0,3,3
Devon,HLX,F,0,0,0,0,0,3,3
Devon,HO,F,"1,591","1,164","1,267","1,304","1,085","2,270","8,681"
Devon,HO,M,867,323,155,16,3,17,"1,381"
Devon,HOX,F,167,79,123,131,94,278,872
Devon,HOX,M,122,18,6,1,1,1,149
Devon,HX,F,0,0,0,0,0,"1,304","1,304"
Devon,HX,M,0,0,0,0,0,158,158
Devon,IM,F,4,3,0,2,3,6,18
Devon,IM,M,6,0,2,0,0,1,9
Devon,IMX,F,3,4,0,0,0,1,8
Devon,IMX,M,2,0,0,0,0,0,2
Devon,JE,F,997,945,774,802,493,"1,637","5,648"
Devon,JE,M,22,36,18,17,7,20,120
Devon,JEX,F,445,365,181,192,136,118,"1,437"
Devon,JEX,M,24,29,5,0,0,0,58
Devon,JY,F,57,0,0,0,0,5,62
Devon,JY,M,14,0,0,0,0,0,14
Devon,JYX,F,7,0,0,0,0,0,7
Devon,KE,F,1,0,0,0,0,1,2
Devon,KEX,F,0,0,1,0,0,0,1
Devon,LH,F,20,20,17,20,16,63,156
Devon,LH,M,28,18,3,2,0,2,53
Devon,LHX,F,15,12,1,6,2,3,39
Devon,LHX,M,8,11,3,0,0,0,22
Devon,LI,F,0,0,0,0,0,413,413
Devon,LI,M,0,0,0,0,0,161,161
Devon,LIM,F,"1,924","1,751",612,461,445,"1,554","6,747"
Devon,LIM,M,"2,126","1,818",485,152,121,340,"5,042"
Devon,LIM X,F,0,0,0,0,0,9,9
Devon,LIM X,M,0,0,0,0,0,1,1
Devon,LIMB,F,0,0,0,0,0,16,16
Devon,LIMB,M,0,0,0,0,0,2,2
Devon,LIMBX,F,0,0,0,0,0,330,330
Devon,LIMBX,M,0,0,0,0,0,15,15
Devon,LIMR,F,0,0,0,0,0,51,51
Devon,LIMR,M,0,0,0,0,0,5,5
Devon,LIMRX,F,0,0,0,0,0,227,227
Devon,LIMRX,M,0,0,0,0,0,3,3
Devon,LIMX,F,"12,738","11,625","3,785","1,677","1,643","6,108","37,576"
Devon,LIMX,M,"13,794","12,921","3,449",130,67,238,"30,599"
Devon,LIX,F,0,0,0,0,0,"1,932","1,932"
Devon,LIX,M,0,0,0,0,0,362,362
Devon,LM,F,0,0,0,0,0,13,13
Devon,LM,M,0,0,0,0,0,3,3
Devon,LMX,F,0,0,0,0,0,79,79
Devon,LMX,M,0,0,0,0,0,2,2
Devon,LR,F,4,5,3,1,2,6,21
Devon,LR,M,5,3,3,1,0,1,13
Devon,LRX,F,9,3,0,0,0,2,14
Devon,LRX,M,7,7,0,0,0,0,14
Devon,LU,F,0,0,0,0,0,4,4
Devon,MA,F,10,22,18,10,17,39,116
Devon,MA,M,18,12,7,0,0,4,41
Devon,MAR,F,0,0,0,0,0,4,4
Devon,MARX,F,0,0,0,0,0,4,4
Devon,MAX,F,112,80,54,34,29,212,521
Devon,MAX,M,103,98,17,2,0,4,224
Devon,MG,F,7,22,3,11,13,60,116
Devon,MG,M,10,18,2,1,0,1,32
Devon,MGX,F,10,6,6,5,19,56,102
Devon,MGX,M,8,14,3,1,1,0,27
Devon,MO,F,46,13,18,37,8,27,149
Devon,MO,M,22,24,5,1,0,5,57
Devon,MOX,F,122,118,83,41,50,48,462
Devon,MOX,M,164,96,21,0,0,0,281
Devon,MRI,F,81,63,125,68,33,227,597
Devon,MRI,M,82,82,30,0,1,16,211
Devon,MRIX,F,177,183,189,267,292,740,"1,848"
Devon,MRIX,M,185,152,55,2,4,16,414
Devon,ND,F,0,0,0,0,0,95,95
Devon,ND,M,0,0,0,0,0,13,13
Devon,NDX,F,0,0,0,0,0,35,35
Devon,NDX,M,0,0,0,0,0,16,16
Devon,NO,F,5,6,0,2,1,13,27
Devon,NO,M,2,1,0,0,0,0,3
Devon,NOX,F,28,52,5,6,1,38,130
Devon,NOX,M,16,15,4,1,0,0,36
Devon,NR,F,3,0,3,0,0,5,11
Devon,NR,M,2,0,0,0,0,0,2
Devon,NRX,F,79,0,3,0,0,4,86
Devon,NRX,M,46,0,0,0,0,0,46
Devon,NS,F,0,0,0,0,0,"1,502","1,502"
Devon,NS,M,0,0,0,0,0,7,7
Devon,OB,F,0,0,0,0,0,4,4
Devon,OD,F,1,0,0,0,0,0,1
Devon,OD,M,1,0,0,0,0,0,1
Devon,OEX,F,1,0,0,0,0,0,1
Devon,PA,F,7,5,18,7,0,15,52
Devon,PA,M,2,4,4,2,0,0,12
Devon,PAX,F,30,23,3,12,0,1,69
Devon,PAX,M,45,25,0,0,0,0,70
Devon,PI,F,7,19,7,9,8,33,83
Devon,PI,M,10,9,0,1,0,3,23
Devon,PINX,F,0,0,0,0,0,1,1
Devon,PIX,F,38,47,21,10,21,45,182
Devon,PIX,M,44,46,10,2,0,5,107
Devon,RO,F,0,0,0,0,0,2,2
Devon,ROTX,F,0,0,1,0,1,0,2
Devon,ROX,F,0,0,0,0,0,1,1
Devon,RP,F,24,17,19,5,4,35,104
Devon,RP,M,24,4,4,2,1,1,36
Devon,RPX,F,7,6,0,0,1,11,25
Devon,RPX,M,9,8,6,0,0,0,23
Devon,RWFR,F,1,0,0,0,0,29,30
Devon,SA,F,22,23,10,6,1,16,78
Devon,SA,M,16,8,6,3,1,11,45
Devon,SAX,F,121,102,99,79,51,231,683
Devon,SAX,M,138,132,26,1,1,2,300
Devon,SB,F,0,0,1,0,0,1,2
Devon,SB,M,2,1,0,0,0,0,3
Devon,SBX,F,1,0,0,0,0,0,1
Devon,SD,F,"3,007","2,590","1,768","1,446","1,308","5,253","15,372"
Devon,SD,M,"2,726","2,189",459,85,75,233,"5,767"
Devon,SDX,F,"1,620","1,374",512,366,303,"1,296","5,471"
Devon,SDX,M,"1,684","1,250",222,19,6,60,"3,241"
Devon,SG,F,0,1,0,0,0,0,1
Devon,SGX,F,0,0,1,1,0,5,7
Devon,SH,F,2,0,0,0,2,8,12
Devon,SH,M,4,3,1,1,0,2,11
Devon,SHO,F,32,28,31,31,44,204,370
Devon,SHO,M,127,77,17,1,1,5,228
Devon,SHOX,F,86,143,46,93,19,205,592
Devon,SHOX,M,175,98,11,0,0,5,289
Devon,SHX,F,2,4,7,2,3,8,26
Devon,SHX,M,3,4,0,0,0,0,7
Devon,SM,F,817,649,386,290,244,"1,428","3,814"
Devon,SM,M,948,690,205,59,53,267,"2,222"
Devon,SMX,F,"4,994","4,975","1,990","1,142","1,154","6,090","20,345"
Devon,SMX,M,"5,729","5,900","1,358",53,44,560,"13,644"
Devon,SRW,F,56,35,51,33,39,21,235
Devon,SRW,M,19,17,5,0,0,0,41
Devon,SRWX,F,338,154,117,77,69,85,840
Devon,SRWX,M,202,73,36,0,1,1,313
Devon,ST,F,1,2,0,0,0,0,3
Devon,ST,M,1,6,0,3,0,0,10
Devon,STX,F,58,32,0,0,0,0,90
Devon,STX,M,63,40,0,0,0,0,103
Devon,SU,F,6,15,14,8,5,67,115
Devon,SU,M,4,8,2,0,0,3,17
Devon,SUX,F,46,15,9,15,9,21,115
Devon,SUX,M,40,21,7,0,0,0,68
Devon,WA,F,7,1,0,0,0,0,8
Devon,WA,M,5,1,0,0,0,0,6
Devon,WB,F,127,122,98,96,96,546,"1,085"
Devon,WB,M,109,115,23,5,6,20,278
Devon,WBX,F,178,193,122,102,92,567,"1,254"
Devon,WBX,M,165,141,31,2,1,13,353
Devon,WG,F,2,4,2,0,0,6,14
Devon,WG,M,7,0,0,0,1,0,8
Devon,WGX,F,0,0,0,2,0,2,4
Devon,WP,F,19,12,2,12,5,31,81
Devon,WP,M,22,14,2,1,1,1,41
Devon,WPX,F,3,2,13,1,0,3,22
Devon,WPX,M,1,3,5,0,0,0,9
Devon,WS,F,2,3,0,2,0,4,11
Devon,WS,M,2,0,0,1,3,2,8
Devon,WSX,F,52,35,29,17,30,66,229
Devon,WSX,M,43,6,1,0,0,2,52
Devon,WWX,F,1,0,0,0,0,0,1
Dorset,AA,F,448,390,154,78,105,434,"1,609"
Dorset,AA,M,536,332,75,39,36,82,"1,100"
Dorset,AAX,F,"2,374","1,756",653,402,314,"1,107","6,606"
Dorset,AAX,M,"2,341","1,478",235,35,10,91,"4,190"
Dorset,AMX,F,0,1,0,0,0,0,1
Dorset,AR,F,0,0,1,0,0,0,1
Dorset,ARX,F,1,0,1,0,0,0,2
Dorset,AU,F,20,15,11,4,5,66,121
Dorset,AU,M,22,15,1,0,0,3,41
Dorset,AUX,F,0,4,0,0,0,5,9
Dorset,AUX,M,0,6,0,0,0,0,6
Dorset,AY,F,50,51,33,46,45,119,344
Dorset,AY,M,21,10,4,0,0,2,37
Dorset,AYX,F,30,50,58,31,38,40,247
Dorset,AYX,M,9,3,3,0,1,0,16
Dorset,BA,F,7,2,1,0,2,10,22
Dorset,BA,M,5,6,3,1,0,3,18
Dorset,BAL,F,0,0,0,0,0,1,1
Dorset,BAL,M,1,0,0,0,0,0,1
Dorset,BARX,F,0,0,0,0,0,1,1
Dorset,BAX,F,79,82,15,7,7,71,261
Dorset,BAX,M,54,47,20,1,0,6,128
Dorset,BAZ,F,0,0,0,0,0,2,2
Dorset,BAZ,M,1,0,0,1,0,1,3
Dorset,BAZX,F,19,14,6,2,0,2,43
Dorset,BAZX,M,12,10,6,0,0,3,31
Dorset,BB,F,67,83,29,10,24,115,328
Dorset,BB,M,89,63,20,2,1,48,223
Dorset,BBX,F,"1,073",791,352,152,66,453,"2,887"
Dorset,BBX,M,"1,299",983,265,10,4,67,"2,628"
Dorset,BF,F,"1,346","1,445","1,705","1,764","1,968","3,502","11,730"
Dorset,BF,M,855,521,202,24,14,21,"1,637"
Dorset,BFX,F,214,213,358,316,223,343,"1,667"
Dorset,BFX,M,133,83,31,3,1,5,256
Dorset,BG,F,7,4,0,3,0,8,22
Dorset,BG,M,4,5,1,0,0,0,10
Dorset,BG X,F,0,0,0,0,0,1,1
Dorset,BGX,F,3,5,6,2,0,2,18
Dorset,BGX,M,0,2,0,0,0,0,2
Dorset,BH,F,26,0,0,0,0,459,485
Dorset,BH,M,11,0,0,0,0,2,13
Dorset,BHX,F,1,0,0,0,0,108,109
Dorset,BI,F,0,0,0,0,0,1,1
Dorset,BLG,F,0,0,0,0,0,4,4
Dorset,BR,F,0,0,0,2,0,1,3
Dorset,BS,F,16,17,15,10,9,28,95
Dorset,BS,M,4,3,3,1,0,0,11
Dorset,BSH,F,13,14,18,16,11,31,103
Dorset,BSH,M,23,11,2,2,3,3,44
Dorset,BSHO,F,0,0,0,0,0,2,2
Dorset,BSHX,F,23,8,8,0,1,27,67
Dorset,BSHX,M,23,1,2,0,0,1,27
Dorset,BSX,F,38,21,16,23,36,62,196
Dorset,BSX,M,12,8,1,0,0,0,21
Dorset,BU,F,0,2,0,2,4,5,13
Dorset,BU,M,0,0,0,0,2,0,2
Dorset,BW,F,41,34,21,25,14,61,196
Dorset,BW,M,25,26,6,1,0,8,66
Dorset,BWX,F,35,38,8,4,4,12,101
Dorset,BWX,M,17,24,1,0,0,0,42
Dorset,CAX,M,0,0,0,0,0,1,1
Dorset,CB,F,0,1,1,0,0,2,4
Dorset,CD,F,0,0,0,1,0,0,1
Dorset,CH,F,292,214,111,89,76,412,"1,194"
Dorset,CH,M,281,209,54,20,25,80,669
Dorset,CHIX,F,2,0,0,0,0,0,2
Dorset,CHL,F,2,0,0,0,0,0,2
Dorset,CHX,F,"1,758","1,343",295,156,123,756,"4,431"
Dorset,CHX,M,"1,584","1,474",269,21,7,118,"3,473"
Dorset,DEV,F,132,94,78,73,57,178,612
Dorset,DEV,M,131,101,16,13,2,16,279
Dorset,DEVX,F,132,89,45,24,45,58,393
Dorset,DEVX,M,148,88,12,1,0,4,253
Dorset,DEX,F,70,55,64,50,35,113,387
Dorset,DEX,M,66,62,19,4,2,7,160
Dorset,DEXX,F,7,2,3,2,2,11,27
Dorset,DEXX,M,1,0,0,0,0,1,2
Dorset,DRX,F,2,2,6,1,0,0,11
Dorset,DS,F,0,4,13,10,14,36,77
Dorset,DS,M,4,3,3,0,0,1,11
Dorset,DSHO,F,0,0,0,0,0,4,4
Dorset,DSX,F,51,39,15,22,21,21,169
Dorset,DSX,M,13,21,4,0,0,0,38
Dorset,DV,F,0,0,0,0,0,13,13
Dorset,DV,M,0,0,0,0,0,1,1
Dorset,DVX,F,0,0,0,0,0,21,21
Dorset,DVX,M,0,0,0,0,0,6,6
Dorset,FEX,F,0,0,0,0,0,1,1
Dorset,FR,F,0,0,0,0,0,"14,696","14,696"
Dorset,FR,M,0,0,0,0,0,162,162
Dorset,FRX,F,0,0,0,0,0,329,329
Dorset,FRX,M,0,0,0,0,0,16,16
Dorset,GA,F,10,0,0,2,12,74,98
Dorset,GA,M,13,8,11,10,8,25,75
Dorset,GAX,F,1,1,0,0,1,8,11
Dorset,GAX,M,1,5,2,0,0,0,8
Dorset,GB,M,1,0,0,0,0,0,1
Dorset,GBX,F,1,0,1,0,0,0,2
Dorset,GE,M,0,1,0,0,0,0,1
Dorset,GL,F,1,0,1,0,0,2,4
Dorset,GL,M,0,3,0,0,0,0,3
Dorset,GLX,F,0,0,0,0,0,1,1
Dorset,GU,F,51,55,48,52,46,238,490
Dorset,GU,M,11,10,2,0,0,1,24
Dorset,GUX,F,3,1,7,1,2,9,23
Dorset,GY,F,5,0,0,0,0,0,5
Dorset,GYX,M,1,0,0,0,0,0,1
Dorset,H,F,0,0,0,0,0,158,158
Dorset,H,M,0,0,0,0,0,54,54
Dorset,HE,F,204,149,89,31,30,158,661
Dorset,HE,M,171,145,43,39,28,61,487
Dorset,HEBL,F,0,0,0,0,0,6,6
Dorset,HEBLX,F,0,0,0,0,0,164,164
Dorset,HEBLX,M,0,0,0,0,0,2,2
Dorset,HER,F,0,0,0,0,0,17,17
Dorset,HER,M,0,0,0,0,0,2,2
Dorset,HERX,F,0,0,0,0,0,58,58
Dorset,HERX,M,0,0,0,0,0,4,4
Dorset,HEX,F,"1,781","1,290",642,398,302,"1,258","5,671"
Dorset,HEX,M,"1,806","1,169",183,18,17,44,"3,237"
Dorset,HF,F,"9,808","9,521","9,981","8,837","7,542","14,408","60,097"
Dorset,HF,M,"3,352","1,579",553,63,29,55,"5,631"
Dorset,HFX,F,973,795,609,465,479,"1,179","4,500"
Dorset,HFX,M,260,105,40,13,2,2,422
Dorset,HI,F,13,7,5,8,4,24,61
Dorset,HI,M,5,5,4,1,3,8,26
Dorset,HIX,F,10,1,2,0,3,3,19
Dorset,HIX,M,9,5,0,0,0,0,14
Dorset,HL,F,0,0,0,0,0,9,9
Dorset,HO,F,"1,322","1,187","1,022",985,937,"1,684","7,137"
Dorset,HO,M,313,128,35,15,4,13,508
Dorset,HOX,F,55,50,63,51,33,220,472
Dorset,HOX,M,11,16,0,0,0,0,27
Dorset,HX,F,0,0,0,0,0,598,598
Dorset,HX,M,0,0,0,0,0,155,155
Dorset,IM,F,16,4,2,4,0,12,38
Dorset,IM,M,20,2,2,0,0,1,25
Dorset,IMX,F,0,0,0,0,0,1,1
Dorset,IMX,M,5,0,0,0,0,1,6
Dorset,JE,F,210,184,203,170,165,464,"1,396"
Dorset,JE,M,6,9,4,1,0,3,23
Dorset,JEX,F,279,271,231,208,146,119,"1,254"
Dorset,JEX,M,28,33,8,0,0,2,71
Dorset,JY,F,3,0,0,0,0,1,4
Dorset,JY,M,1,0,0,0,0,0,1
Dorset,KEX,F,0,0,2,1,1,0,4
Dorset,LH,F,71,46,43,27,23,116,326
Dorset,LH,M,88,65,2,1,0,8,164
Dorset,LHX,F,11,2,1,3,0,6,23
Dorset,LHX,M,14,0,0,0,0,0,14
Dorset,LI,F,0,0,0,0,0,51,51
Dorset,LI,M,0,0,0,0,0,10,10
Dorset,LIM,F,228,197,109,58,40,148,780
Dorset,LIM,M,250,221,67,18,19,39,614
Dorset,LIM X,F,0,0,0,0,0,1,1
Dorset,LIMB,F,0,0,0,0,0,1,1
Dorset,LIMBX,F,0,0,0,0,0,36,36
Dorset,LIMBX,M,0,0,0,0,0,2,2
Dorset,LIMR,F,0,0,0,0,0,4,4
Dorset,LIMR,M,0,0,0,0,0,1,1
Dorset,LIMRX,F,0,0,0,0,0,9,9
Dorset,LIMX,F,"1,582","1,166",355,161,133,531,"3,928"
Dorset,LIMX,M,"1,631","1,212",275,22,6,26,"3,172"
Dorset,LIX,F,0,0,0,0,0,229,229
Dorset,LIX,M,0,0,0,0,0,59,59
Dorset,LM,F,0,0,0,0,0,1,1
Dorset,LM,M,0,0,0,0,0,2,2
Dorset,LMX,F,0,0,0,0,0,11,11
Dorset,LR,F,0,0,0,0,1,0,1
Dorset,LR,M,0,1,0,0,0,0,1
Dorset,MAR,F,0,0,0,0,0,1,1
Dorset,MAX,F,0,0,0,1,1,0,2
Dorset,MG,F,0,0,0,2,1,7,10
Dorset,MG,M,0,0,0,0,0,2,2
Dorset,MGX,F,3,2,6,2,1,27,41
Dorset,MGX,M,0,4,1,0,0,1,6
Dorset,MO,F,5,12,1,2,3,7,30
Dorset,MO,M,4,4,3,0,0,1,12
Dorset,MOX,F,33,16,14,11,8,12,94
Dorset,MOX,M,20,4,1,1,0,1,27
Dorset,MRI,F,54,49,22,40,40,67,272
Dorset,MRI,M,66,30,3,3,2,2,106
Dorset,MRIX,F,118,140,150,142,147,308,"1,005"
Dorset,MRIX,M,68,66,18,6,7,4,169
Dorset,ND,F,0,0,0,0,0,22,22
Dorset,ND,M,0,0,0,0,0,1,1
Dorset,NDX,F,0,0,0,0,0,20,20
Dorset,NDX,M,0,0,0,0,0,1,1
Dorset,NO,F,10,0,0,0,0,24,34
Dorset,NO,M,14,2,0,0,0,2,18
Dorset,NOX,F,3,8,0,0,0,27,38
Dorset,NOX,M,3,6,0,0,0,0,9
Dorset,NR,F,7,0,1,0,0,0,8
Dorset,NR,M,1,0,0,0,0,0,1
Dorset,NRX,F,41,0,2,0,0,1,44
Dorset,NRX,M,8,0,0,0,0,0,8
Dorset,NS,F,0,0,0,0,0,608,608
Dorset,NS,M,0,0,0,0,0,1,1
Dorset,OEX,F,1,0,0,0,0,2,3
Dorset,OO,F,0,0,0,0,0,1,1
Dorset,PAX,F,1,0,0,0,0,0,1
Dorset,PAX,M,1,2,0,0,0,0,3
Dorset,PI,F,0,0,0,0,0,3,3
Dorset,PIX,F,0,0,3,1,0,4,8
Dorset,PIX,M,0,1,0,0,0,3,4
Dorset,RP,F,7,2,1,2,1,9,22
Dorset,RP,M,6,2,1,1,0,0,10
Dorset,RPX,F,5,2,0,1,0,1,9
Dorset,RPX,M,9,0,0,0,0,0,9
Dorset,RWFR,F,1,0,0,0,0,17,18
Dorset,RWFR,M,1,0,0,0,0,0,1
Dorset,SA,F,10,4,4,5,1,11,35
Dorset,SA,M,4,3,1,0,0,1,9
Dorset,SAX,F,33,9,7,0,2,27,78
Dorset,SAX,M,18,1,8,0,0,0,27
Dorset,SD,F,33,21,36,25,22,48,185
Dorset,SD,M,29,17,6,0,1,6,59
Dorset,SDX,F,85,126,34,41,26,78,390
Dorset,SDX,M,128,64,9,2,1,3,207
Dorset,SH,F,1,0,0,0,1,5,7
Dorset,SH,M,0,0,6,0,0,1,7
Dorset,SHO,F,21,18,5,14,34,145,237
Dorset,SHO,M,12,13,2,0,1,4,32
Dorset,SHOX,F,63,41,43,49,61,79,336
Dorset,SHOX,M,56,45,4,0,1,1,107
Dorset,SHX,F,6,0,1,0,0,0,7
Dorset,SHX,M,3,1,0,0,0,0,4
Dorset,SM,F,318,203,113,73,60,366,"1,133"
Dorset,SM,M,295,202,82,33,25,123,760
Dorset,SMX,F,"2,330","1,606",558,442,269,"1,463","6,668"
Dorset,SMX,M,"2,286","1,468",345,32,14,224,"4,369"
Dorset,SOBX,F,0,0,0,0,0,1,1
Dorset,SRW,F,8,2,3,1,3,1,18
Dorset,SRWX,F,120,81,82,78,40,15,416
Dorset,SRWX,M,78,5,0,0,0,0,83
Dorset,SU,F,7,7,32,1,2,17,66
Dorset,SU,M,11,11,2,2,0,0,26
Dorset,SUX,F,22,4,5,29,3,7,70
Dorset,SUX,M,11,10,0,0,0,0,21
Dorset,WB,F,20,3,5,9,5,24,66
Dorset,WB,M,18,2,4,1,0,0,25
Dorset,WBX,F,1,2,1,0,0,9,13
Dorset,WBX,M,2,1,0,0,0,0,3
Dorset,WP,F,18,18,18,16,8,30,108
Dorset,WP,M,17,17,6,1,1,4,46
Dorset,WPX,F,16,10,14,5,3,1,49
Dorset,WPX,M,19,9,6,0,0,0,34
Dorset,WS,M,0,0,0,1,0,0,1
Dorset,WSX,F,0,0,0,0,0,5,5
Durham,AA,F,181,117,64,74,53,314,803
Durham,AA,M,186,93,17,9,13,39,357
Durham,AAX,F,513,457,237,236,208,"1,316","2,967"
Durham,AAX,M,476,344,39,8,1,33,901
Durham,AY,F,0,0,0,2,1,12,15
Durham,AY,M,8,8,1,0,1,1,19
Durham,AYX,F,0,0,0,2,0,3,5
Durham,AYX,M,1,0,0,0,0,0,1
Durham,BA,F,43,60,26,13,16,143,301
Durham,BA,M,53,50,19,9,9,42,182
Durham,BABX,F,0,0,0,0,0,14,14
Durham,BAL,F,0,0,0,0,0,1,1
Durham,BAL,M,0,7,0,0,0,0,7
Durham,BALX,F,0,1,0,0,1,1,3
Durham,BARX,F,0,0,0,0,0,3,3
Durham,BAWX,F,0,0,0,0,0,1,1
Durham,BAX,F,982,800,178,143,133,"1,069","3,305"
Durham,BAX,M,923,781,66,6,5,87,"1,868"
Durham,BAZ,F,11,7,9,7,3,16,53
Durham,BAZ,M,7,0,1,0,4,1,13
Durham,BAZX,F,38,49,9,5,2,9,112
Durham,BAZX,M,33,54,3,1,0,0,91
Durham,BB,F,78,87,74,70,60,274,643
Durham,BB,M,55,88,31,9,12,37,232
Durham,BBX,F,"1,238","1,344",556,484,459,"1,852","5,933"
Durham,BBX,M,"1,123","1,184",178,15,9,80,"2,589"
Durham,BF,F,192,180,283,262,291,512,"1,720"
Durham,BF,M,246,254,69,19,7,6,601
Durham,BFX,F,36,20,7,18,11,24,116
Durham,BFX,M,70,42,1,0,2,1,116
Durham,BG,F,16,4,5,6,5,39,75
Durham,BG,M,18,15,3,8,1,3,48
Durham,BGX,F,3,1,1,0,0,2,7
Durham,BGX,M,0,2,0,0,0,0,2
Durham,BH,F,0,0,0,0,0,34,34
Durham,BHX,F,0,0,0,0,0,1,1
Durham,BHX,M,2,0,0,0,0,0,2
Durham,BLG,F,2,16,12,0,3,2,35
Durham,BLG,M,0,6,1,0,0,0,7
Durham,BLGX,F,1,0,0,0,0,1,2
Durham,BR,F,0,1,1,0,0,0,2
Durham,BR,M,0,0,1,0,0,0,1
Durham,BRX,F,1,2,0,0,0,0,3
Durham,BRX,M,1,0,0,0,0,0,1
Durham,BS,F,1,6,5,18,2,11,43
Durham,BS,M,1,5,0,0,0,0,6
Durham,BSH,F,24,12,23,8,15,32,114
Durham,BSH,M,25,17,0,2,2,3,49
Durham,BSHX,F,14,10,8,0,2,3,37
Durham,BSHX,M,12,14,0,0,0,0,26
Durham,BSX,F,2,2,3,2,0,9,18
Durham,BSX,M,6,6,0,0,1,0,13
Durham,BU,F,0,1,0,0,0,0,1
Durham,BU,M,1,1,0,0,0,0,2
Durham,BW,F,0,0,1,0,0,1,2
Durham,BWX,F,0,0,0,4,1,0,5
Durham,BX,F,0,0,0,0,0,1,1
Durham,CA,F,0,0,0,0,0,1,1
Durham,CB,F,0,0,0,0,0,53,53
Durham,CB,M,0,2,0,1,0,0,3
Durham,CH,F,213,275,123,98,85,536,"1,330"
Durham,CH,M,205,122,34,24,16,112,513
Durham,CHX,F,"1,421","1,374",188,92,90,"1,068","4,233"
Durham,CHX,M,"1,253","1,183",105,5,2,131,"2,679"
Durham,CON,F,0,0,0,0,0,2,2
Durham,DE,M,0,0,0,0,0,1,1
Durham,DEV,F,1,2,0,0,0,5,8
Durham,DEVX,F,0,2,1,0,0,5,8
Durham,DEVX,M,0,1,0,0,0,0,1
Durham,DEX,F,22,23,25,16,10,33,129
Durham,DEX,M,31,14,0,1,0,8,54
Durham,DEXX,F,0,0,2,0,0,0,2
Durham,DG,F,0,0,0,0,0,1,1
Durham,DS,F,6,1,0,1,3,10,21
Durham,DS,M,3,3,0,0,0,0,6
Durham,DSX,F,28,12,25,35,25,10,135
Durham,DSX,M,22,18,0,0,0,0,40
Durham,DV,F,0,0,0,0,0,5,5
Durham,DVX,F,0,0,0,0,0,4,4
Durham,EPX,F,0,0,0,4,0,0,4
Durham,FR,F,0,0,0,0,0,"1,650","1,650"
Durham,FR,M,0,0,0,0,0,106,106
Durham,FRX,F,0,0,0,0,0,106,106
Durham,FRX,M,0,0,0,0,0,6,6
Durham,GA,F,35,27,27,35,13,43,180
Durham,GA,M,34,30,14,3,1,1,83
Durham,GAS,F,0,0,0,0,0,5,5
Durham,GASX,F,0,0,0,0,0,2,2
Durham,GAX,F,3,5,5,1,1,67,82
Durham,GAX,M,6,1,4,0,0,6,17
Durham,GB,F,1,0,0,0,0,0,1
Durham,GBX,F,1,0,1,0,0,2,4
Durham,GE,M,0,2,0,0,0,0,2
Durham,GEX,F,0,1,0,0,0,1,2
Durham,GEX,M,2,8,0,0,0,0,10
Durham,GL,F,0,0,0,0,0,2,2
Durham,GLX,F,0,0,0,2,0,0,2
Durham,GU,F,0,0,0,0,0,2,2
Durham,GU,M,0,0,0,0,0,1,1
Durham,H,F,0,0,0,0,0,50,50
Durham,H,M,0,0,0,0,0,1,1
Durham,HE,F,46,52,29,21,34,87,269
Durham,HE,M,50,31,9,4,1,4,99
Durham,HEBL,F,0,0,0,0,0,1,1
Durham,HEBLX,F,0,0,0,0,0,44,44
Durham,HER,F,0,0,0,0,0,3,3
Durham,HERX,F,0,0,0,0,0,24,24
Durham,HEX,F,111,155,83,75,98,519,"1,041"
Durham,HEX,M,143,306,18,0,1,4,472
Durham,HF,F,771,776,878,762,631,"1,301","5,119"
Durham,HF,M,"1,202",906,124,19,18,27,"2,296"
Durham,HFX,F,109,107,99,88,77,179,659
Durham,HFX,M,98,48,26,1,0,1,174
Durham,HI,F,23,18,22,12,16,91,182
Durham,HI,M,25,16,11,3,3,13,71
Durham,HIX,F,0,1,0,0,1,1,3
Durham,HIX,M,0,2,2,2,0,1,7
Durham,HL,F,0,0,0,0,0,4,4
Durham,HO,F,271,231,259,175,224,394,"1,554"
Durham,HO,M,243,150,13,2,4,8,420
Durham,HOX,F,6,17,3,14,5,37,82
Durham,HOX,M,13,17,4,0,0,0,34
Durham,HX,F,0,0,0,0,0,135,135
Durham,HX,M,0,0,0,0,0,9,9
Durham,IM,F,0,0,0,0,0,1,1
Durham,JE,F,65,107,63,90,70,155,550
Durham,JE,M,12,1,0,1,0,0,14
Durham,JEX,F,0,0,0,1,1,2,4
Durham,JEX,M,0,0,1,0,0,0,1
Durham,JY,F,61,0,0,0,0,1,62
Durham,LH,F,15,16,11,8,8,30,88
Durham,LH,M,9,10,3,0,0,2,24
Durham,LHX,F,6,5,2,0,7,6,26
Durham,LHX,M,1,1,0,0,0,0,2
Durham,LI,F,0,0,0,0,0,272,272
Durham,LI,M,0,0,0,0,0,67,67
Durham,LIM,F,833,814,304,301,256,"1,090","3,598"
Durham,LIM,M,897,660,143,77,50,219,"2,046"
Durham,LIM X,F,0,0,0,0,0,5,5
Durham,LIM X,M,0,0,0,0,0,1,1
Durham,LIMB,F,0,0,0,0,0,4,4
Durham,LIMBX,F,0,0,0,0,0,356,356
Durham,LIMBX,M,0,0,0,0,0,1,1
Durham,LIMR,F,0,0,0,0,0,20,20
Durham,LIMR,M,0,0,0,0,0,15,15
Durham,LIMRX,F,0,0,0,0,0,107,107
Durham,LIMRX,M,0,0,0,0,0,2,2
Durham,LIMX,F,"6,839","6,236","1,689","1,095","1,214","5,726","22,799"
Durham,LIMX,M,"6,548","5,759",704,39,22,127,"13,199"
Durham,LIX,F,0,0,0,0,0,"1,782","1,782"
Durham,LIX,M,0,0,0,0,0,273,273
Durham,LM,F,0,0,0,0,0,32,32
Durham,LM,M,0,0,0,0,0,10,10
Durham,LMX,F,0,0,0,0,0,79,79
Durham,LMX,M,0,0,0,0,0,2,2
Durham,LR,F,0,0,0,0,0,5,5
Durham,LRX,F,0,0,0,0,0,1,1
Durham,LRX,M,0,1,0,0,0,0,1
Durham,LU,F,0,0,0,0,1,1,2
Durham,LUX,M,0,1,0,0,0,0,1
Durham,MG,F,0,0,0,0,3,10,13
Durham,MGX,F,0,1,0,1,0,3,5
Durham,MO,F,25,26,31,55,29,167,333
Durham,MO,M,25,10,1,1,0,1,38
Durham,MOX,F,63,37,7,5,1,6,119
Durham,MOX,M,73,29,9,0,0,0,111
Durham,MRI,F,2,3,0,0,0,2,7
Durham,MRI,M,14,3,1,2,0,0,20
Durham,MRIX,F,25,9,18,2,2,26,82
Durham,MRIX,M,17,11,0,0,0,0,28
Durham,NDX,F,0,0,0,0,0,1,1
Durham,NRX,F,5,0,0,0,0,0,5
Durham,NRX,M,14,1,0,0,0,0,15
Durham,NS,F,0,0,0,0,0,333,333
Durham,NS,M,0,0,0,0,0,2,2
Durham,OEX,F,0,0,0,0,0,3,3
Durham,OEX,M,1,0,0,0,0,0,1
Durham,PA,M,0,1,0,1,0,0,2
Durham,PAX,F,26,10,2,0,0,3,41
Durham,PAX,M,26,7,0,0,0,0,33
Durham,PI,F,0,0,0,0,0,7,7
Durham,PI,M,0,1,0,0,0,0,1
Durham,PIX,F,7,1,2,7,3,23,43
Durham,PIX,M,6,2,1,0,0,1,10
Durham,ROX,F,0,0,0,0,0,3,3
Durham,RP,F,0,1,0,1,1,2,5
Durham,RP,M,1,0,0,0,0,0,1
Durham,RPX,M,1,0,0,0,0,0,1
Durham,SA,F,18,14,2,4,18,37,93
Durham,SA,M,22,28,3,2,0,1,56
Durham,SAX,F,33,25,8,17,37,106,226
Durham,SAX,M,32,42,2,0,1,6,83
Durham,SB,F,0,0,0,0,0,1,1
Durham,SBX,F,0,1,0,0,0,0,1
Durham,SD,F,5,13,4,5,3,13,43
Durham,SD,M,5,7,3,0,0,1,16
Durham,SDX,F,11,22,0,1,0,15,49
Durham,SDX,M,17,5,1,0,0,0,23
Durham,SG,F,0,0,0,0,0,1,1
Durham,SGX,F,0,1,0,0,0,0,1
Durham,SH,F,0,0,0,0,1,3,4
Durham,SH,M,0,2,0,0,0,0,2
Durham,SHO,F,14,23,18,21,15,71,162
Durham,SHO,M,30,24,6,1,0,0,61
Durham,SHOX,F,2,5,10,1,5,47,70
Durham,SHOX,M,3,11,1,0,0,0,15
Durham,SHX,F,2,0,0,1,0,2,5
Durham,SHX,M,1,0,0,0,0,0,1
Durham,SM,F,99,89,64,32,37,296,617
Durham,SM,M,89,92,21,9,3,60,274
Durham,SMX,F,576,507,155,145,136,"1,143","2,662"
Durham,SMX,M,385,546,57,5,4,80,"1,077"
Durham,SRW,F,4,1,0,3,0,0,8
Durham,SRW,M,3,0,0,0,0,0,3
Durham,SRWX,F,40,18,24,20,15,17,134
Durham,SRWX,M,49,10,3,0,0,1,63
Durham,ST,F,7,2,0,0,0,0,9
Durham,ST,M,5,0,0,0,0,0,5
Durham,STX,F,1,3,0,0,0,0,4
Durham,STX,M,1,2,0,0,0,0,3
Durham,SU,F,4,6,3,5,0,5,23
Durham,SU,M,2,7,2,0,1,0,12
Durham,SUX,F,1,4,1,0,1,0,7
Durham,SUX,M,2,0,0,0,0,0,2
Durham,WB,F,0,0,0,6,0,11,17
Durham,WB,M,0,1,0,0,0,1,2
Durham,WBX,F,0,1,0,0,4,8,13
Durham,WBX,M,0,0,0,0,0,1,1
Durham,WG,F,0,1,0,0,0,0,1
Durham,WG,M,0,1,1,0,0,0,2
Durham,WPX,F,0,0,0,0,0,1,1
Durham,WS,M,0,0,1,0,0,0,1
Durham,WSX,F,2,7,4,0,0,1,14
Durham,WSX,M,0,15,2,0,0,0,17
Durham,ZE,F,0,0,0,0,0,1,1
Durham,ZE,M,0,0,0,0,0,1,1
Essex,AA,F,159,120,16,74,48,162,579
Essex,AA,M,144,99,9,7,4,13,276
Essex,AAX,F,273,223,70,55,42,264,927
Essex,AAX,M,291,242,33,0,1,15,582
Essex,AM,M,1,0,0,0,0,0,1
Essex,AR,M,0,1,0,0,0,0,1
Essex,AY,F,0,1,0,0,0,11,12
Essex,AY,M,2,6,2,5,0,0,15
Essex,AYX,F,0,0,0,0,0,1,1
Essex,BA,F,11,19,5,5,3,32,75
Essex,BA,M,20,9,1,3,1,13,47
Essex,BABX,F,0,0,0,0,0,2,2
Essex,BAX,F,170,160,60,32,9,160,591
Essex,BAX,M,180,95,18,0,0,26,319
Essex,BAZ,F,0,0,0,0,0,2,2
Essex,BAZX,F,6,4,3,1,4,1,19
Essex,BAZX,M,0,1,0,0,0,0,1
Essex,BB,F,37,30,9,8,23,33,140
Essex,BB,M,22,28,3,3,3,9,68
Essex,BBX,F,829,538,140,139,115,267,"2,028"
Essex,BBX,M,382,460,81,7,2,44,976
Essex,BF,F,32,46,46,78,77,92,371
Essex,BF,M,87,62,39,8,1,0,197
Essex,BFX,F,2,4,0,1,1,4,12
Essex,BFX,M,5,4,8,0,0,1,18
Essex,BG,F,0,0,3,0,0,4,7
Essex,BG,M,0,0,1,0,0,2,3
Essex,BGX,F,0,3,0,0,0,0,3
Essex,BGX,M,0,1,1,0,0,1,3
Essex,BH,F,0,0,0,0,0,53,53
Essex,BRX,F,1,0,0,0,0,0,1
Essex,BRX,M,0,0,1,0,0,0,1
Essex,BSH,F,13,6,6,3,3,21,52
Essex,BSH,M,8,12,0,0,0,1,21
Essex,BSHO,F,0,0,0,0,0,1,1
Essex,BSHX,F,11,13,0,4,1,1,30
Essex,BSHX,M,4,7,0,0,0,0,11
Essex,BSX,F,0,1,0,0,3,15,19
Essex,BSX,M,0,5,0,0,0,0,5
Essex,BU,F,0,0,0,0,0,4,4
Essex,BW,F,14,13,6,11,5,47,96
Essex,BW,M,29,8,5,1,0,9,52
Essex,BWX,F,10,3,5,0,0,10,28
Essex,BWX,M,4,1,0,0,0,0,5
Essex,CB,F,0,0,0,0,3,25,28
Essex,CB,M,0,3,0,0,0,0,3
Essex,CH,F,28,34,12,19,12,99,204
Essex,CH,M,22,22,7,2,7,22,82
Essex,CHI,F,0,0,0,0,1,0,1
Essex,CHX,F,427,400,57,62,23,340,"1,309"
Essex,CHX,M,204,194,14,3,2,44,461
Essex,DE,F,0,0,0,0,0,1,1
Essex,DEV,F,4,2,1,1,1,16,25
Essex,DEV,M,2,1,0,2,0,4,9
Essex,DEVX,F,15,13,0,6,0,5,39
Essex,DEVX,M,5,9,1,0,0,1,16
Essex,DEX,F,23,14,17,21,7,51,133
Essex,DEX,M,32,17,9,3,0,9,70
Essex,DEXX,F,4,0,0,0,0,0,4
Essex,DEXX,M,2,0,0,2,0,0,4
Essex,DGX,M,0,0,0,0,0,1,1
Essex,DS,M,1,0,0,0,0,0,1
Essex,DSX,M,1,1,0,0,0,0,2
Essex,DV,F,0,0,0,0,0,40,40
Essex,DV,M,0,0,0,0,0,19,19
Essex,DVX,F,0,0,0,0,0,44,44
Essex,DVX,M,0,0,0,0,0,8,8
Essex,FR,F,0,0,0,0,0,583,583
Essex,FR,M,0,0,0,0,0,62,62
Essex,FRX,F,0,0,0,0,0,66,66
Essex,FRX,M,0,0,0,0,0,39,39
Essex,GA,F,0,2,2,0,0,0,4
Essex,GA,M,0,1,0,0,3,1,5
Essex,GAX,F,1,5,2,1,0,7,16
Essex,GAX,M,2,2,0,0,0,4,8
Essex,GE,F,0,1,0,0,0,0,1
Essex,GEX,F,1,3,0,1,0,7,12
Essex,GEX,M,2,11,0,0,0,1,14
Essex,GL,F,7,5,3,1,2,24,42
Essex,GL,M,4,6,0,0,0,2,12
Essex,GLX,F,4,1,0,2,0,4,11
Essex,GLX,M,1,2,0,0,0,0,3
Essex,GU,F,0,0,2,0,0,7,9
Essex,GU,M,1,0,0,0,0,0,1
Essex,GUX,F,0,0,0,0,0,2,2
Essex,GUX,M,0,1,0,0,0,0,1
Essex,GYX,F,1,0,0,0,0,0,1
Essex,H,F,0,0,0,0,0,40,40
Essex,H,M,0,0,0,0,0,11,11
Essex,HE,F,48,51,32,16,20,85,252
Essex,HE,M,73,58,16,4,2,8,161
Essex,HEBL,F,0,0,0,0,0,6,6
Essex,HEBL,M,0,0,0,0,0,3,3
Essex,HEBLX,F,0,0,0,0,0,5,5
Essex,HER,F,0,0,0,0,0,5,5
Essex,HER,M,0,0,0,0,0,4,4
Essex,HERX,F,0,0,0,0,0,12,12
Essex,HEX,F,169,153,105,59,63,306,855
Essex,HEX,M,198,148,26,5,1,7,385
Essex,HF,F,827,850,795,647,542,"1,053","4,714"
Essex,HF,M,590,481,256,25,9,14,"1,375"
Essex,HFX,F,60,57,32,35,28,50,262
Essex,HFX,M,61,23,9,1,1,1,96
Essex,HI,F,12,17,11,11,12,82,145
Essex,HI,M,12,13,9,6,1,10,51
Essex,HIX,F,25,8,2,0,2,4,41
Essex,HIX,M,25,3,0,0,0,0,28
Essex,HL,M,0,0,0,0,0,1,1
Essex,HO,F,194,221,113,68,71,113,780
Essex,HO,M,159,65,32,16,3,3,278
Essex,HOX,F,0,0,0,1,0,4,5
Essex,HOX,M,3,0,1,0,0,1,5
Essex,HX,F,0,0,0,0,0,150,150
Essex,HX,M,0,0,0,0,0,20,20
Essex,JE,F,89,95,81,57,64,167,553
Essex,JE,M,3,2,1,0,0,3,9
Essex,JEX,F,4,0,0,1,0,2,7
Essex,JEX,M,1,2,0,0,0,0,3
Essex,JY,F,1,0,0,0,0,0,1
Essex,LH,F,31,30,21,26,15,134,257
Essex,LH,M,33,25,6,7,2,0,73
Essex,LHX,F,5,7,1,1,0,20,34
Essex,LHX,M,2,4,1,0,0,1,8
Essex,LI,F,0,0,0,0,0,40,40
Essex,LI,M,0,0,0,0,0,10,10
Essex,LIM,F,85,88,26,21,24,140,384
Essex,LIM,M,59,91,11,12,7,26,206
Essex,LIMBX,F,0,0,0,0,0,8,8
Essex,LIMRX,F,0,0,0,0,0,14,14
Essex,LIMX,F,908,755,154,108,81,404,"2,410"
Essex,LIMX,M,741,559,103,2,3,9,"1,417"
Essex,LIX,F,0,0,0,0,0,195,195
Essex,LIX,M,0,0,0,0,0,31,31
Essex,LM,F,0,0,0,0,0,1,1
Essex,LMX,F,0,0,0,0,0,2,2
Essex,LR,F,10,11,9,5,0,23,58
Essex,LR,M,10,12,1,0,1,1,25
Essex,LRX,F,6,0,0,0,0,0,6
Essex,LRX,M,4,0,0,0,0,1,5
Essex,LU,F,0,0,0,0,0,1,1
Essex,LUX,F,1,0,0,0,0,0,1
Essex,MARX,M,0,1,0,0,0,0,1
Essex,MAX,F,0,0,0,0,0,5,5
Essex,MG,F,0,1,0,0,0,6,7
Essex,MG,M,0,0,0,0,0,5,5
Essex,MGX,F,1,6,1,0,2,13,23
Essex,MGX,M,1,0,0,0,0,2,3
Essex,MO,M,1,6,0,0,0,0,7
Essex,MOX,F,0,0,1,0,0,4,5
Essex,MOX,M,9,4,2,0,0,1,16
Essex,MRI,F,0,0,0,0,0,1,1
Essex,MRIX,F,0,2,0,0,0,0,2
Essex,MRIX,M,1,9,0,0,0,0,10
Essex,NRX,M,1,0,0,0,0,0,1
Essex,NS,F,0,0,0,0,0,93,93
Essex,OB,F,0,0,0,0,0,2,2
Essex,PAX,F,0,0,0,1,0,0,1
Essex,PI,F,0,0,0,0,1,0,1
Essex,PI,M,0,0,0,1,0,0,1
Essex,PIX,F,23,16,4,5,0,41,89
Essex,PIX,M,21,12,0,0,0,4,37
Essex,RE,F,0,0,0,0,0,1,1
Essex,RO,M,0,0,0,0,0,1,1
Essex,ROTX,M,0,1,0,0,0,0,1
Essex,ROX,F,16,0,0,0,3,0,19
Essex,ROX,M,18,0,0,0,0,0,18
Essex,RP,F,27,15,18,23,16,56,155
Essex,RP,M,45,28,3,0,2,4,82
Essex,RPX,F,15,4,0,0,0,2,21
Essex,RPX,M,15,26,0,0,0,0,41
Essex,SA,F,0,0,13,7,0,0,20
Essex,SA,M,0,0,0,2,0,0,2
Essex,SAX,F,37,10,30,4,2,19,102
Essex,SAX,M,39,12,2,0,0,0,53
Essex,SBX,F,1,1,0,0,0,0,2
Essex,SD,F,30,68,33,15,23,81,250
Essex,SD,M,31,8,7,1,1,10,58
Essex,SDX,F,42,70,17,10,7,65,211
Essex,SDX,M,40,53,8,2,0,4,107
Essex,SH,F,13,7,4,6,2,19,51
Essex,SH,M,13,6,1,1,0,0,21
Essex,SHO,F,0,10,0,0,0,6,16
Essex,SHO,M,0,2,0,0,0,1,3
Essex,SHOX,F,3,15,5,3,1,3,30
Essex,SHOX,M,3,3,1,0,0,0,7
Essex,SHX,F,0,0,0,0,1,0,1
Essex,SM,F,81,64,28,18,14,155,360
Essex,SM,M,53,54,9,3,2,44,165
Essex,SMX,F,639,579,123,92,109,675,"2,217"
Essex,SMX,M,580,407,41,5,2,62,"1,097"
Essex,SRWX,F,1,0,1,3,0,0,5
Essex,STX,M,0,3,0,0,0,0,3
Essex,SU,F,3,7,1,0,2,20,33
Essex,SU,M,4,17,2,0,0,2,25
Essex,SUX,F,17,35,9,5,10,38,114
Essex,SUX,M,29,56,6,0,3,4,98
Essex,WB,F,1,1,0,0,1,12,15
Essex,WB,M,0,2,0,0,0,1,3
Essex,WBX,F,2,2,2,0,0,37,43
Essex,WBX,M,4,2,0,0,0,0,6
Essex,WG,F,0,0,1,0,0,0,1
Essex,WGX,F,0,2,0,0,0,0,2
Essex,WP,F,7,8,7,1,2,18,43
Essex,WP,M,7,4,2,1,0,1,15
Essex,WPX,F,7,4,0,0,0,5,16
Essex,WPX,M,4,2,0,0,0,0,6
Essex,ZE,F,1,0,0,1,1,1,4
Essex,ZE,M,0,0,1,0,0,0,1
Gloucestershire,AA,F,465,466,165,119,104,503,"1,822"
Gloucestershire,AA,M,500,390,51,27,28,66,"1,062"
Gloucestershire,AAX,F,"1,535","1,234",490,292,238,800,"4,589"
Gloucestershire,AAX,M,"1,597","1,122",332,28,5,56,"3,140"
Gloucestershire,AM,F,0,0,1,0,0,0,1
Gloucestershire,AMX,M,1,0,0,0,0,0,1
Gloucestershire,AR,F,0,0,0,1,0,0,1
Gloucestershire,ARX,F,0,1,0,0,0,0,1
Gloucestershire,ARX,M,0,0,1,0,0,0,1
Gloucestershire,AU,F,0,0,2,0,0,3,5
Gloucestershire,AUX,M,0,4,0,0,0,0,4
Gloucestershire,AY,F,107,82,86,76,61,240,652
Gloucestershire,AY,M,12,18,6,2,0,3,41
Gloucestershire,AYX,F,1,12,7,3,2,2,27
Gloucestershire,AYX,M,2,7,5,0,0,1,15
Gloucestershire,BA,F,31,22,8,15,19,43,138
Gloucestershire,BA,M,26,18,15,4,8,22,93
Gloucestershire,BABX,F,0,0,0,0,0,17,17
Gloucestershire,BABX,M,0,0,0,0,0,1,1
Gloucestershire,BARX,F,0,0,0,0,0,7,7
Gloucestershire,BAWX,F,0,0,0,0,0,10,10
Gloucestershire,BAX,F,463,436,165,59,33,326,"1,482"
Gloucestershire,BAX,M,448,450,97,4,3,26,"1,028"
Gloucestershire,BAZ,F,7,1,0,0,0,4,12
Gloucestershire,BAZ,M,3,1,2,0,0,2,8
Gloucestershire,BAZX,F,11,32,7,3,4,17,74
Gloucestershire,BAZX,M,21,28,7,0,0,0,56
Gloucestershire,BB,F,155,131,60,34,14,175,569
Gloucestershire,BB,M,156,156,41,11,9,31,404
Gloucestershire,BBX,F,"1,485","1,215",547,258,154,652,"4,311"
Gloucestershire,BBX,M,"1,626","1,213",397,22,1,60,"3,319"
Gloucestershire,BF,F,783,830,881,870,999,"1,724","6,087"
Gloucestershire,BF,M,933,819,356,21,11,13,"2,153"
Gloucestershire,BFX,F,98,133,110,121,101,126,689
Gloucestershire,BFX,M,136,65,29,4,1,0,235
Gloucestershire,BG,F,11,15,15,7,14,27,89
Gloucestershire,BG,M,14,13,9,5,2,4,47
Gloucestershire,BGX,F,6,5,5,2,0,1,19
Gloucestershire,BGX,M,0,9,11,2,0,2,24
Gloucestershire,BH,F,6,0,0,0,0,334,340
Gloucestershire,BH,M,4,0,0,0,0,1,5
Gloucestershire,BHX,F,13,0,0,0,0,36,49
Gloucestershire,BHX,M,21,0,0,0,0,0,21
Gloucestershire,BI,F,3,5,5,2,1,11,27
Gloucestershire,BI,M,9,3,4,0,0,0,16
Gloucestershire,BLG,F,0,0,0,0,0,2,2
Gloucestershire,BR,F,0,0,0,0,0,1,1
Gloucestershire,BRX,F,2,1,0,0,0,0,3
Gloucestershire,BRX,M,0,0,0,0,1,1,2
Gloucestershire,BS,F,23,27,24,7,4,16,101
Gloucestershire,BS,M,10,3,3,1,0,3,20
Gloucestershire,BSH,F,19,20,11,10,6,36,102
Gloucestershire,BSH,M,24,11,2,1,1,3,42
Gloucestershire,BSHO,F,0,0,0,0,0,1,1
Gloucestershire,BSHO,M,0,0,0,0,0,1,1
Gloucestershire,BSHX,F,6,5,8,6,8,16,49
Gloucestershire,BSHX,M,9,6,3,0,0,1,19
Gloucestershire,BSX,F,33,10,11,13,14,12,93
Gloucestershire,BSX,M,35,6,20,2,1,0,64
Gloucestershire,BU,F,3,1,0,4,0,0,8
Gloucestershire,BU,M,0,3,0,0,0,0,3
Gloucestershire,BW,F,25,29,11,13,16,53,147
Gloucestershire,BW,M,29,20,17,5,2,4,77
Gloucestershire,BWB,F,0,0,1,0,0,0,1
Gloucestershire,BWX,F,2,0,1,1,1,13,18
Gloucestershire,BWX,M,17,7,1,2,0,0,27
Gloucestershire,CB,F,1,0,0,0,0,3,4
Gloucestershire,CB,M,1,1,0,0,0,0,2
Gloucestershire,CD,F,0,0,0,0,0,3,3
Gloucestershire,CD,M,0,0,1,0,0,0,1
Gloucestershire,CH,F,265,197,118,53,74,421,"1,128"
Gloucestershire,CH,M,257,201,54,28,8,93,641
Gloucestershire,CHX,F,"1,381","1,633",434,160,191,"1,146","4,945"
Gloucestershire,CHX,M,"1,600","1,844",365,19,12,123,"3,963"
Gloucestershire,CON,F,0,0,0,0,0,1,1
Gloucestershire,DEV,F,31,25,9,8,19,61,153
Gloucestershire,DEV,M,20,11,2,1,0,2,36
Gloucestershire,DEVX,F,17,38,18,4,1,17,95
Gloucestershire,DEVX,M,29,39,9,0,0,3,80
Gloucestershire,DEX,F,108,92,59,67,39,193,558
Gloucestershire,DEX,M,107,112,31,9,11,13,283
Gloucestershire,DEXX,F,10,3,7,1,0,3,24
Gloucestershire,DEXX,M,4,8,3,0,0,0,15
Gloucestershire,DRX,M,3,0,0,0,0,0,3
Gloucestershire,DS,F,28,9,3,18,19,39,116
Gloucestershire,DS,M,32,9,3,1,0,0,45
Gloucestershire,DSHO,F,4,0,0,0,0,2,6
Gloucestershire,DSHO,M,1,0,0,0,0,0,1
Gloucestershire,DSX,F,10,20,0,0,0,3,33
Gloucestershire,DSX,M,13,37,1,0,0,0,51
Gloucestershire,DV,F,0,0,0,0,0,43,43
Gloucestershire,DV,M,0,0,0,0,0,5,5
Gloucestershire,DVX,F,0,0,0,0,0,20,20
Gloucestershire,DVX,M,0,0,0,0,0,4,4
Gloucestershire,FR,F,0,0,0,0,0,"5,983","5,983"
Gloucestershire,FR,M,0,0,0,0,0,127,127
Gloucestershire,FRX,F,0,0,0,0,0,73,73
Gloucestershire,FRX,M,0,0,0,0,0,5,5
Gloucestershire,GA,F,0,0,0,0,0,4,4
Gloucestershire,GA,M,0,22,0,0,0,0,22
Gloucestershire,GAS,F,0,0,0,0,0,1,1
Gloucestershire,GAX,F,1,0,0,0,0,8,9
Gloucestershire,GAX,M,1,0,0,0,0,0,1
Gloucestershire,GB,F,1,0,0,0,0,0,1
Gloucestershire,GE,F,0,13,0,1,0,1,15
Gloucestershire,GE,M,0,0,0,0,0,4,4
Gloucestershire,GEX,F,49,42,24,1,1,8,125
Gloucestershire,GEX,M,41,70,28,0,0,5,144
Gloucestershire,GL,F,55,40,52,36,33,147,363
Gloucestershire,GL,M,52,59,19,10,0,6,146
Gloucestershire,GLX,F,10,17,5,1,7,7,47
Gloucestershire,GLX,M,19,14,1,0,0,1,35
Gloucestershire,GU,F,34,36,31,42,27,127,297
Gloucestershire,GU,M,2,2,1,0,0,1,6
Gloucestershire,GUX,F,13,4,1,0,0,3,21
Gloucestershire,GUX,M,0,1,0,0,0,0,1
Gloucestershire,GY,F,1,0,0,0,0,1,2
Gloucestershire,H,F,0,0,0,0,0,98,98
Gloucestershire,H,M,0,0,0,0,0,22,22
Gloucestershire,HE,F,194,186,112,79,80,206,857
Gloucestershire,HE,M,214,220,59,25,34,40,592
Gloucestershire,HEBL,F,0,0,0,0,0,5,5
Gloucestershire,HEBLX,F,0,0,0,0,0,109,109
Gloucestershire,HEBLX,M,0,0,0,0,0,7,7
Gloucestershire,HEBR,F,0,0,0,0,0,1,1
Gloucestershire,HER,F,0,0,0,0,0,12,12
Gloucestershire,HERX,F,0,0,0,0,0,43,43
Gloucestershire,HERX,M,0,0,0,0,0,2,2
Gloucestershire,HEX,F,"1,166","1,138",519,251,195,835,"4,104"
Gloucestershire,HEX,M,"1,422","1,471",445,34,17,22,"3,411"
Gloucestershire,HF,F,"4,221","3,832","4,519","4,037","3,161","5,536","25,306"
Gloucestershire,HF,M,"1,960","1,467",650,62,10,24,"4,173"
Gloucestershire,HFX,F,175,120,167,122,116,309,"1,009"
Gloucestershire,HFX,M,141,68,32,1,0,3,245
Gloucestershire,HI,F,12,21,15,5,9,64,126
Gloucestershire,HI,M,18,15,2,2,5,11,53
Gloucestershire,HIX,F,2,7,4,0,0,2,15
Gloucestershire,HIX,M,1,1,0,0,0,0,2
Gloucestershire,HLX,M,0,0,0,0,0,1,1
Gloucestershire,HO,F,838,794,663,713,529,740,"4,277"
Gloucestershire,HO,M,258,91,48,10,7,18,432
Gloucestershire,HOX,F,2,5,11,33,36,42,129
Gloucestershire,HOX,M,6,6,3,0,0,1,16
Gloucestershire,HX,F,0,0,0,0,0,530,530
Gloucestershire,HX,M,0,0,0,0,0,51,51
Gloucestershire,IM,F,0,2,0,1,1,5,9
Gloucestershire,IM,M,0,1,0,2,0,0,3
Gloucestershire,JE,F,171,200,180,173,235,408,"1,367"
Gloucestershire,JE,M,5,2,2,0,0,3,12
Gloucestershire,JEX,F,21,28,24,12,7,9,101
Gloucestershire,JEX,M,11,5,0,0,0,0,16
Gloucestershire,JY,F,25,0,0,0,0,2,27
Gloucestershire,JY,M,7,0,0,0,0,0,7
Gloucestershire,JYX,F,2,0,0,0,0,0,2
Gloucestershire,KE,F,0,1,0,0,1,3,5
Gloucestershire,KE,M,1,0,0,0,0,0,1
Gloucestershire,KEX,F,1,0,0,0,1,0,2
Gloucestershire,KEX,M,0,1,0,0,0,0,1
Gloucestershire,LH,F,16,10,12,13,10,30,91
Gloucestershire,LH,M,19,12,3,0,1,6,41
Gloucestershire,LHX,F,1,3,0,3,1,9,17
Gloucestershire,LHX,M,4,2,0,0,0,1,7
Gloucestershire,LI,F,0,0,0,0,0,69,69
Gloucestershire,LI,M,0,0,0,0,0,13,13
Gloucestershire,LIM,F,286,309,130,58,62,217,"1,062"
Gloucestershire,LIM,M,298,333,101,25,13,56,826
Gloucestershire,LIM X,F,0,0,0,0,0,1,1
Gloucestershire,LIM X,M,0,0,0,0,0,1,1
Gloucestershire,LIMB,F,0,0,0,0,0,6,6
Gloucestershire,LIMBX,F,0,0,0,0,0,35,35
Gloucestershire,LIMR,F,0,0,0,0,0,7,7
Gloucestershire,LIMR,M,0,0,0,0,0,1,1
Gloucestershire,LIMRX,F,0,0,0,0,0,29,29
Gloucestershire,LIMX,F,"2,119","2,461",897,312,266,"1,012","7,067"
Gloucestershire,LIMX,M,"2,230","2,800",721,21,10,44,"5,826"
Gloucestershire,LIX,F,0,0,0,0,0,322,322
Gloucestershire,LIX,M,0,0,0,0,0,53,53
Gloucestershire,LMX,F,0,0,0,0,0,4,4
Gloucestershire,LRX,F,0,0,0,0,0,1,1
Gloucestershire,MA,F,0,1,1,0,0,1,3
Gloucestershire,MAX,F,0,1,3,0,0,1,5
Gloucestershire,MAX,M,0,0,0,1,0,0,1
Gloucestershire,MG,F,9,12,8,5,4,11,49
Gloucestershire,MG,M,3,6,3,1,0,2,15
Gloucestershire,MGX,F,18,18,4,9,4,7,60
Gloucestershire,MGX,M,21,20,2,0,0,1,44
Gloucestershire,MO,F,2,2,3,0,8,15,30
Gloucestershire,MO,M,1,4,2,0,0,0,7
Gloucestershire,MOX,F,27,12,3,11,4,51,108
Gloucestershire,MOX,M,33,9,1,0,0,0,43
Gloucestershire,MRI,F,20,7,27,11,17,18,100
Gloucestershire,MRI,M,17,36,9,1,1,1,65
Gloucestershire,MRIX,F,6,8,5,4,3,60,86
Gloucestershire,MRIX,M,23,37,16,2,0,0,78
Gloucestershire,ND,F,0,0,0,0,0,6,6
Gloucestershire,NO,F,1,4,3,4,1,4,17
Gloucestershire,NO,M,2,6,1,0,0,0,9
Gloucestershire,NOX,F,0,1,0,0,0,6,7
Gloucestershire,NOX,M,4,0,0,0,0,0,4
Gloucestershire,NR,M,1,0,0,0,0,0,1
Gloucestershire,NRX,F,22,0,0,0,0,0,22
Gloucestershire,NRX,M,11,0,0,0,0,0,11
Gloucestershire,NS,F,0,0,0,0,0,302,302
Gloucestershire,PAX,F,0,1,0,0,0,0,1
Gloucestershire,PI,F,22,13,11,11,6,48,111
Gloucestershire,PI,M,33,13,1,0,0,4,51
Gloucestershire,PIX,F,66,64,10,0,13,5,158
Gloucestershire,PIX,M,64,51,10,1,0,9,135
Gloucestershire,RP,F,13,15,7,4,3,34,76
Gloucestershire,RP,M,21,24,1,3,0,1,50
Gloucestershire,RPX,F,3,1,0,1,0,6,11
Gloucestershire,RPX,M,2,0,4,0,0,0,6
Gloucestershire,SA,F,13,10,5,1,4,36,69
Gloucestershire,SA,M,15,31,1,3,3,4,57
Gloucestershire,SAX,F,62,71,14,2,3,39,191
Gloucestershire,SAX,M,58,83,19,0,0,1,161
Gloucestershire,SD,F,170,192,99,56,71,272,860
Gloucestershire,SD,M,153,115,37,9,5,20,339
Gloucestershire,SDX,F,170,100,36,21,14,65,406
Gloucestershire,SDX,M,163,145,14,0,2,2,326
Gloucestershire,SH,F,0,0,1,0,1,6,8
Gloucestershire,SH,M,0,2,0,0,0,2,4
Gloucestershire,SHO,F,14,11,11,13,12,39,100
Gloucestershire,SHO,M,27,65,7,2,0,2,103
Gloucestershire,SHOX,F,11,13,3,4,7,39,77
Gloucestershire,SHOX,M,25,14,7,0,0,0,46
Gloucestershire,SHX,F,1,2,0,1,0,5,9
Gloucestershire,SHX,M,2,4,0,1,0,0,7
Gloucestershire,SM,F,198,244,95,80,60,431,"1,108"
Gloucestershire,SM,M,269,220,58,24,14,61,646
Gloucestershire,SMX,F,"1,834","1,824",742,361,316,"1,648","6,725"
Gloucestershire,SMX,M,"2,046","1,897",594,32,36,108,"4,713"
Gloucestershire,SRW,M,1,0,0,0,0,0,1
Gloucestershire,SRWX,F,9,0,0,3,0,2,14
Gloucestershire,SRWX,M,6,5,3,0,0,0,14
Gloucestershire,STX,F,3,0,0,0,0,0,3
Gloucestershire,STX,M,2,0,0,0,0,0,2
Gloucestershire,SU,F,2,2,2,4,6,12,28
Gloucestershire,SU,M,1,1,2,0,1,1,6
Gloucestershire,SUX,F,23,20,14,6,10,41,114
Gloucestershire,SUX,M,28,27,8,2,0,0,65
Gloucestershire,WB,F,15,16,6,20,8,52,117
Gloucestershire,WB,M,17,32,4,2,0,4,59
Gloucestershire,WBX,F,22,31,11,7,1,26,98
Gloucestershire,WBX,M,28,22,13,2,0,5,70
Gloucestershire,WP,F,7,4,3,3,4,9,30
Gloucestershire,WP,M,4,1,1,0,0,7,13
Gloucestershire,WPX,F,0,0,1,0,0,0,1
Gloucestershire,WPX,M,0,0,1,0,0,0,1
Gloucestershire,WS,F,0,0,1,0,0,1,2
Gloucestershire,WSX,F,0,0,0,0,0,3,3
Gloucestershire,WSX,M,0,1,0,0,0,0,1
Gloucestershire,WWX,F,0,3,10,5,1,4,23
Gloucestershire,WWX,M,5,3,4,8,1,0,21
Hampshire,AA,F,461,366,215,185,128,467,"1,822"
Hampshire,AA,M,528,365,114,37,20,60,"1,124"
Hampshire,AAX,F,"2,124","1,674",572,381,230,"1,117","6,098"
Hampshire,AAX,M,"2,330","1,565",255,22,5,61,"4,238"
Hampshire,AN,F,0,0,0,0,0,7,7
Hampshire,AR,M,1,0,0,0,0,0,1
Hampshire,ARX,F,2,0,0,0,0,2,4
Hampshire,AU,F,0,0,0,1,0,1,2
Hampshire,AY,F,33,77,36,42,47,271,506
Hampshire,AY,M,27,29,8,0,1,5,70
Hampshire,AYX,F,0,1,0,3,6,8,18
Hampshire,AYX,M,0,1,3,0,0,0,4
Hampshire,BA,F,16,17,4,4,6,43,90
Hampshire,BA,M,10,13,7,0,3,14,47
Hampshire,BABX,M,0,0,0,0,0,1,1
Hampshire,BAL,F,0,1,0,0,0,2,3
Hampshire,BALX,F,0,7,0,0,0,0,7
Hampshire,BALX,M,0,5,0,0,0,0,5
Hampshire,BARX,F,0,0,0,0,0,1,1
Hampshire,BAWX,F,0,0,0,0,0,1,1
Hampshire,BAX,F,143,149,47,10,14,119,482
Hampshire,BAX,M,137,102,26,2,0,14,281
Hampshire,BAZ,M,0,0,1,0,0,0,1
Hampshire,BAZ X,F,0,0,0,0,0,1,1
Hampshire,BAZX,F,0,0,1,0,0,0,1
Hampshire,BAZX,M,4,0,0,0,0,0,4
Hampshire,BB,F,32,26,18,2,4,40,122
Hampshire,BB,M,51,27,10,0,3,25,116
Hampshire,BBX,F,474,439,156,56,42,185,"1,352"
Hampshire,BBX,M,713,601,182,3,2,40,"1,541"
Hampshire,BF,F,517,397,429,313,400,680,"2,736"
Hampshire,BF,M,302,380,128,5,3,5,823
Hampshire,BFX,F,83,80,39,22,53,102,379
Hampshire,BFX,M,61,20,6,0,0,4,91
Hampshire,BG,F,39,15,17,9,10,49,139
Hampshire,BG,M,20,17,17,3,0,6,63
Hampshire,BG X,F,0,0,0,0,0,1,1
Hampshire,BG X,M,0,0,0,0,0,2,2
Hampshire,BGX,F,7,3,1,7,2,10,30
Hampshire,BGX,M,4,0,3,0,0,1,8
Hampshire,BH,F,0,0,0,0,0,149,149
Hampshire,BHX,F,1,0,0,0,0,25,26
Hampshire,BLG,F,1,0,0,0,6,3,10
Hampshire,BLG,M,0,0,0,0,0,1,1
Hampshire,BLGX,F,1,0,0,0,0,1,2
Hampshire,BPX,F,1,0,0,0,0,0,1
Hampshire,BR,F,0,0,0,0,0,4,4
Hampshire,BS,F,4,3,0,0,0,5,12
Hampshire,BS,M,1,3,1,0,1,1,7
Hampshire,BSH,F,61,67,17,31,26,60,262
Hampshire,BSH,M,67,38,3,1,0,3,112
Hampshire,BSHO,F,0,0,0,0,0,2,2
Hampshire,BSHX,F,9,1,1,2,0,13,26
Hampshire,BSHX,M,10,8,0,1,0,2,21
Hampshire,BSX,F,44,55,39,28,28,43,237
Hampshire,BSX,M,18,13,4,0,0,1,36
Hampshire,BU,F,106,16,34,58,63,229,506
Hampshire,BU,M,60,40,25,2,0,6,133
Hampshire,BW,F,13,13,12,8,7,43,96
Hampshire,BW,M,18,12,9,1,0,3,43
Hampshire,BWX,F,11,5,6,3,3,8,36
Hampshire,BWX,M,16,7,2,0,0,0,25
Hampshire,CA,F,0,0,0,0,0,1,1
Hampshire,CAX,F,0,0,0,0,0,4,4
Hampshire,CB,F,0,2,0,1,0,5,8
Hampshire,CD,F,1,0,0,0,0,0,1
Hampshire,CH,F,151,138,53,49,62,337,790
Hampshire,CH,M,138,103,26,26,11,66,370
Hampshire,CHIX,F,0,0,0,0,0,1,1
Hampshire,CHX,F,694,597,207,154,200,"1,119","2,971"
Hampshire,CHX,M,705,534,113,7,2,123,"1,484"
Hampshire,DEV,F,9,10,3,3,7,26,58
Hampshire,DEV,M,9,15,3,2,0,1,30
Hampshire,DEVX,F,18,15,15,6,1,15,70
Hampshire,DEVX,M,20,24,8,0,0,0,52
Hampshire,DEX,F,73,73,47,35,25,156,409
Hampshire,DEX,M,66,59,27,6,13,32,203
Hampshire,DEXX,F,5,7,4,2,1,9,28
Hampshire,DEXX,M,5,3,2,0,0,1,11
Hampshire,DG,M,0,0,0,0,0,1,1
Hampshire,DS,F,28,22,6,3,2,29,90
Hampshire,DS,M,11,15,0,1,1,1,29
Hampshire,DSHO,F,13,0,0,0,0,1,14
Hampshire,DSHO,M,3,0,0,0,0,1,4
Hampshire,DSX,F,2,1,0,2,2,3,10
Hampshire,DSX,M,4,3,2,0,0,0,9
Hampshire,DV,F,0,0,0,0,0,31,31
Hampshire,DV,M,0,0,0,0,0,4,4
Hampshire,DVX,F,0,0,0,0,0,12,12
Hampshire,DVX,M,0,0,0,0,0,2,2
Hampshire,FR,F,0,0,0,0,0,"3,776","3,776"
Hampshire,FR,M,0,0,0,0,0,125,125
Hampshire,FRX,F,0,0,0,0,0,121,121
Hampshire,FRX,M,0,0,0,0,0,20,20
Hampshire,GA,F,6,6,19,11,4,25,71
Hampshire,GA,M,9,14,11,0,1,0,35
Hampshire,GAX,F,26,28,9,1,2,24,90
Hampshire,GAX,M,20,16,2,0,0,1,39
Hampshire,GEX,F,0,1,0,0,0,0,1
Hampshire,GL,F,1,0,1,2,0,12,16
Hampshire,GL,M,2,1,0,0,1,1,5
Hampshire,GLX,F,0,1,0,1,0,2,4
Hampshire,GLX,M,0,3,0,0,0,0,3
Hampshire,GU,F,25,35,23,26,18,133,260
Hampshire,GU,M,2,6,1,1,1,3,14
Hampshire,GUX,F,0,0,0,1,1,12,14
Hampshire,GUX,M,0,1,0,0,0,0,1
Hampshire,GY,F,2,0,0,0,0,0,2
Hampshire,H,F,0,0,0,0,0,103,103
Hampshire,H,M,0,0,0,0,0,21,21
Hampshire,HE,F,194,203,73,93,61,250,874
Hampshire,HE,M,217,145,48,6,11,22,449
Hampshire,HEBL,F,0,0,0,0,0,5,5
Hampshire,HEBLX,F,0,0,0,0,0,49,49
Hampshire,HEBLX,M,0,0,0,0,0,2,2
Hampshire,HER,F,0,0,0,0,0,10,10
Hampshire,HER,M,0,0,0,0,0,4,4
Hampshire,HERX,F,0,0,0,0,0,42,42
Hampshire,HERX,M,0,0,0,0,0,3,3
Hampshire,HEX,F,811,799,429,295,169,760,"3,263"
Hampshire,HEX,M,861,780,141,9,2,13,"1,806"
Hampshire,HF,F,"2,777","2,537","2,655","2,523","2,316","5,058","17,866"
Hampshire,HF,M,"1,535",902,232,38,10,14,"2,731"
Hampshire,HFX,F,133,169,221,180,177,239,"1,119"
Hampshire,HFX,M,150,111,16,2,1,5,285
Hampshire,HI,F,36,30,17,21,14,87,205
Hampshire,HI,M,33,27,9,4,6,19,98
Hampshire,HIX,F,1,5,5,0,1,8,20
Hampshire,HIX,M,0,8,2,0,1,2,13
Hampshire,HL,F,0,0,0,0,0,3,3
Hampshire,HLX,F,0,0,0,0,0,1,1
Hampshire,HO,F,128,165,171,193,136,494,"1,287"
Hampshire,HO,M,64,110,10,4,1,1,190
Hampshire,HOX,F,50,41,38,23,18,85,255
Hampshire,HOX,M,29,32,3,0,0,1,65
Hampshire,HX,F,0,0,0,0,0,447,447
Hampshire,HX,M,0,0,0,0,0,66,66
Hampshire,IM,F,14,7,6,4,7,20,58
Hampshire,IM,M,12,8,4,1,0,3,28
Hampshire,IMX,F,1,0,0,0,1,2,4
Hampshire,IMX,M,5,2,0,0,0,1,8
Hampshire,JE,F,249,274,304,296,251,667,"2,041"
Hampshire,JE,M,23,10,6,2,8,7,56
Hampshire,JEX,F,55,97,42,120,103,53,470
Hampshire,JEX,M,5,16,3,2,1,7,34
Hampshire,JY,F,100,0,0,0,0,1,101
Hampshire,KE,F,4,3,0,0,1,7,15
Hampshire,KE,M,1,2,4,2,0,1,10
Hampshire,LH,F,18,22,23,9,6,45,123
Hampshire,LH,M,15,9,8,2,0,8,42
Hampshire,LHX,F,2,2,0,0,2,13,19
Hampshire,LHX,M,2,3,0,0,0,0,5
Hampshire,LI,F,0,0,0,0,0,29,29
Hampshire,LI,M,0,0,0,0,0,12,12
Hampshire,LIM,F,98,114,42,39,31,179,503
Hampshire,LIM,M,131,101,18,5,6,28,289
Hampshire,LIM X,F,0,0,0,0,0,1,1
Hampshire,LIM X,M,0,0,0,0,0,2,2
Hampshire,LIMB,F,0,0,0,0,0,1,1
Hampshire,LIMBX,F,0,0,0,0,0,13,13
Hampshire,LIMBX,M,0,0,0,0,0,1,1
Hampshire,LIMR,F,0,0,0,0,0,3,3
Hampshire,LIMR,M,0,0,0,0,0,1,1
Hampshire,LIMRX,F,0,0,0,0,0,32,32
Hampshire,LIMRX,M,0,0,0,0,0,2,2
Hampshire,LIMX,F,841,526,214,121,107,540,"2,349"
Hampshire,LIMX,M,820,552,147,4,5,15,"1,543"
Hampshire,LIX,F,0,0,0,0,0,221,221
Hampshire,LIX,M,0,0,0,0,0,39,39
Hampshire,LM,F,0,0,0,0,0,2,2
Hampshire,LMX,F,0,0,0,0,0,7,7
Hampshire,LMX,M,0,0,0,0,0,1,1
Hampshire,LR,F,0,0,2,4,4,10,20
Hampshire,LR,M,4,0,1,0,0,0,5
Hampshire,LRX,F,0,2,0,0,0,0,2
Hampshire,LRX,M,0,3,0,0,0,0,3
Hampshire,MG,F,0,0,0,3,0,7,10
Hampshire,MG,M,1,2,0,0,0,2,5
Hampshire,MGX,F,0,2,2,0,0,12,16
Hampshire,MGX,M,0,2,0,0,0,1,3
Hampshire,MO,M,2,9,0,0,0,0,11
Hampshire,MOX,F,34,4,4,4,0,8,54
Hampshire,MOX,M,47,11,0,0,0,0,58
Hampshire,MRI,F,0,0,0,1,0,7,8
Hampshire,MRI,M,0,7,4,0,0,0,11
Hampshire,MRIX,F,0,4,0,0,4,52,60
Hampshire,MRIX,M,2,7,2,0,0,1,12
Hampshire,ND,F,0,0,0,0,0,7,7
Hampshire,ND,M,0,0,0,0,0,1,1
Hampshire,NDX,F,0,0,0,0,0,1,1
Hampshire,NO,F,0,0,0,1,0,0,1
Hampshire,NOX,F,0,0,0,0,0,1,1
Hampshire,NRX,F,2,0,0,0,0,0,2
Hampshire,NRX,M,1,0,0,0,0,0,1
Hampshire,NS,F,0,0,0,0,0,343,343
Hampshire,NS,M,0,0,0,0,0,1,1
Hampshire,OEX,F,0,0,0,0,0,3,3
Hampshire,OEX,M,0,1,0,0,0,0,1
Hampshire,OO,F,0,0,0,0,0,1,1
Hampshire,PAX,F,0,1,0,0,0,2,3
Hampshire,PI,F,0,0,0,0,0,2,2
Hampshire,PI,M,0,1,0,0,0,1,2
Hampshire,PIX,F,11,12,1,2,1,11,38
Hampshire,PIX,M,8,0,0,0,0,3,11
Hampshire,RO,M,0,0,0,0,0,2,2
Hampshire,ROX,F,4,0,0,0,7,22,33
Hampshire,ROX,M,9,0,0,0,0,0,9
Hampshire,RP,F,5,4,4,1,3,10,27
Hampshire,RP,M,3,2,2,0,0,0,7
Hampshire,RWFR,F,0,0,0,0,0,6,6
Hampshire,RWFR,M,0,0,0,0,0,1,1
Hampshire,SA,F,0,0,0,0,0,32,32
Hampshire,SA,M,0,0,0,0,1,1,2
Hampshire,SAX,F,26,20,17,4,0,111,178
Hampshire,SAX,M,21,17,6,0,0,0,44
Hampshire,SB,F,0,1,0,0,0,0,1
Hampshire,SBX,F,0,2,0,1,0,0,3
Hampshire,SBX,M,0,2,0,0,0,0,2
Hampshire,SD,F,94,89,37,26,21,185,452
Hampshire,SD,M,98,88,21,3,2,7,219
Hampshire,SDX,F,40,59,13,15,26,41,194
Hampshire,SDX,M,31,38,14,0,0,0,83
Hampshire,SH,F,7,6,3,6,4,15,41
Hampshire,SH,M,7,6,1,4,2,0,20
Hampshire,SHO,F,1,3,2,19,9,76,110
Hampshire,SHO,M,0,4,1,1,0,5,11
Hampshire,SHOX,F,23,12,4,10,1,83,133
Hampshire,SHOX,M,13,9,2,1,0,5,30
Hampshire,SHX,F,1,1,1,0,1,7,11
Hampshire,SHX,M,0,2,1,1,0,1,5
Hampshire,SM,F,231,141,41,59,43,407,922
Hampshire,SM,M,214,146,28,20,17,51,476
Hampshire,SMX,F,"1,332","1,027",316,209,176,"1,631","4,691"
Hampshire,SMX,M,"1,469",982,149,7,7,119,"2,733"
Hampshire,SOB,F,0,0,0,0,0,1,1
Hampshire,SRW,F,4,0,0,1,0,1,6
Hampshire,SRW,M,2,1,0,0,0,0,3
Hampshire,SRWX,F,64,0,2,18,8,0,92
Hampshire,SRWX,M,24,2,2,0,0,0,28
Hampshire,ST,F,5,0,0,0,0,0,5
Hampshire,ST,M,14,27,1,0,0,0,42
Hampshire,STX,F,51,58,21,0,0,0,130
Hampshire,STX,M,62,1,0,0,0,0,63
Hampshire,SU,F,18,17,8,12,11,87,153
Hampshire,SU,M,23,20,4,0,2,2,51
Hampshire,SUX,F,22,27,10,15,9,64,147
Hampshire,SUX,M,27,31,5,1,0,2,66
Hampshire,WB,F,4,6,1,2,1,7,21
Hampshire,WB,M,3,5,1,0,0,1,10
Hampshire,WBX,F,3,3,3,1,1,4,15
Hampshire,WBX,M,3,6,9,0,0,0,18
Hampshire,WG,F,0,1,0,0,1,1,3
Hampshire,WP,F,15,11,7,11,4,31,79
Hampshire,WP,M,15,6,2,0,1,1,25
Hampshire,WPX,F,2,2,1,2,1,1,9
Hampshire,WPX,M,0,2,0,0,0,0,2
Hampshire,WS,F,0,0,1,0,0,0,1
Hampshire,WSX,F,0,0,0,0,0,4,4
Hampshire,ZE,F,0,0,0,0,0,2,2
Hampshire,ZE,M,0,0,0,1,0,1,2
Isle of Wight,AA,F,88,59,23,16,19,135,340
Isle of Wight,AA,M,96,40,8,5,4,11,164
Isle of Wight,AAX,F,287,206,77,86,26,148,830
Isle of Wight,AAX,M,263,127,17,1,0,20,428
Isle of Wight,AN,F,0,0,0,0,0,3,3
Isle of Wight,ARX,F,0,0,0,0,1,0,1
Isle of Wight,AY,F,0,0,1,1,0,38,40
Isle of Wight,AY,M,0,0,0,0,1,0,1
Isle of Wight,AYX,F,0,0,0,0,0,3,3
Isle of Wight,BA,F,2,4,4,8,6,11,35
Isle of Wight,BA,M,4,3,1,0,0,4,12
Isle of Wight,BABX,F,0,0,0,0,0,1,1
Isle of Wight,BAX,F,78,78,10,1,0,31,198
Isle of Wight,BAX,M,66,51,10,0,0,2,129
Isle of Wight,BAZ,F,0,0,0,0,0,1,1
Isle of Wight,BAZX,F,0,0,0,0,0,2,2
Isle of Wight,BB,F,24,16,5,2,3,8,58
Isle of Wight,BB,M,35,8,1,0,0,3,47
Isle of Wight,BBX,F,178,142,37,22,18,51,448
Isle of Wight,BBX,M,217,162,8,0,0,4,391
Isle of Wight,BF,F,52,48,64,50,70,153,437
Isle of Wight,BF,M,37,44,7,0,0,1,89
Isle of Wight,BFX,F,8,7,7,8,6,5,41
Isle of Wight,BFX,M,15,15,1,0,0,0,31
Isle of Wight,BG,F,3,0,3,1,1,4,12
Isle of Wight,BG,M,1,0,0,0,0,0,1
Isle of Wight,BGX,F,0,0,0,1,0,1,2
Isle of Wight,BH,F,0,0,0,0,0,4,4
Isle of Wight,BS,F,0,3,11,2,0,6,22
Isle of Wight,BS,M,0,2,0,0,0,0,2
Isle of Wight,BSH,F,27,26,23,23,21,27,147
Isle of Wight,BSH,M,10,4,2,1,1,0,18
Isle of Wight,BSHX,F,0,1,0,0,0,11,12
Isle of Wight,BSHX,M,1,0,0,0,0,0,1
Isle of Wight,BSX,F,1,3,0,2,1,9,16
Isle of Wight,BSX,M,2,4,0,0,0,0,6
Isle of Wight,BU,F,0,0,0,0,0,3,3
Isle of Wight,BW,F,0,2,0,1,1,8,12
Isle of Wight,BW,M,0,0,0,0,0,1,1
Isle of Wight,BWX,F,0,0,0,0,1,1,2
Isle of Wight,BWX,M,0,0,0,0,1,0,1
Isle of Wight,CAX,F,0,0,0,0,0,4,4
Isle of Wight,CH,F,9,5,4,2,0,32,52
Isle of Wight,CH,M,5,10,8,0,1,11,35
Isle of Wight,CHIX,F,0,0,0,0,0,1,1
Isle of Wight,CHX,F,96,50,20,27,8,132,333
Isle of Wight,CHX,M,95,93,34,3,0,14,239
Isle of Wight,DEV,F,0,0,0,0,0,1,1
Isle of Wight,DEV,M,0,2,0,0,0,0,2
Isle of Wight,DEVX,M,2,3,0,0,0,0,5
Isle of Wight,DEX,F,10,8,8,1,4,14,45
Isle of Wight,DEX,M,9,7,2,2,0,0,20
Isle of Wight,DS,F,0,3,2,1,1,1,8
Isle of Wight,DS,M,1,0,0,0,0,0,1
Isle of Wight,DSX,F,17,1,2,5,0,3,28
Isle of Wight,DV,F,0,0,0,0,0,1,1
Isle of Wight,FR,F,0,0,0,0,0,752,752
Isle of Wight,FR,M,0,0,0,0,0,13,13
Isle of Wight,FRX,F,0,0,0,0,0,27,27
Isle of Wight,FRX,M,0,0,0,0,0,4,4
Isle of Wight,GA,F,11,3,0,3,1,34,52
Isle of Wight,GA,M,14,1,0,0,2,2,19
Isle of Wight,GAX,F,0,0,0,0,0,1,1
Isle of Wight,GL,M,0,0,0,0,0,1,1
Isle of Wight,GU,F,38,42,41,46,27,112,306
Isle of Wight,GU,M,4,0,0,0,0,2,6
Isle of Wight,GUX,F,2,4,0,0,0,5,11
Isle of Wight,GUX,M,0,0,0,0,0,1,1
Isle of Wight,GY,F,2,0,0,0,0,0,2
Isle of Wight,H,F,0,0,0,0,0,17,17
Isle of Wight,H,M,0,0,0,0,0,2,2
Isle of Wight,HE,F,81,51,14,12,20,65,243
Isle of Wight,HE,M,86,36,15,5,2,4,148
Isle of Wight,HEBLX,F,0,0,0,0,0,64,64
Isle of Wight,HER,F,0,0,0,0,0,5,5
Isle of Wight,HERX,F,0,0,0,0,0,8,8
Isle of Wight,HEX,F,105,59,24,17,25,207,437
Isle of Wight,HEX,M,101,55,15,0,1,1,173
Isle of Wight,HF,F,511,438,608,524,433,723,"3,237"
Isle of Wight,HF,M,169,300,68,17,2,6,562
Isle of Wight,HFX,F,4,4,6,2,7,42,65
Isle of Wight,HFX,M,2,5,0,0,0,0,7
Isle of Wight,HI,F,29,29,4,13,15,71,161
Isle of Wight,HI,M,18,3,2,3,2,6,34
Isle of Wight,HIX,F,0,1,0,0,0,0,1
Isle of Wight,HIX,M,2,0,0,0,0,0,2
Isle of Wight,HL,F,0,0,0,0,0,2,2
Isle of Wight,HO,F,95,3,4,2,1,43,148
Isle of Wight,HO,M,5,0,1,0,0,0,6
Isle of Wight,HX,F,0,0,0,0,0,75,75
Isle of Wight,HX,M,0,0,0,0,0,15,15
Isle of Wight,IM,F,1,4,4,0,1,10,20
Isle of Wight,IM,M,5,2,17,4,1,1,30
Isle of Wight,IMX,F,0,1,2,0,0,0,3
Isle of Wight,IMX,M,0,2,0,0,0,0,2
Isle of Wight,JE,F,92,104,88,83,71,209,647
Isle of Wight,JE,M,0,1,0,1,0,2,4
Isle of Wight,JEX,F,10,12,14,15,9,23,83
Isle of Wight,JY,F,15,0,0,0,0,1,16
Isle of Wight,LH,F,0,0,0,0,0,1,1
Isle of Wight,LI,F,0,0,0,0,0,9,9
Isle of Wight,LI,M,0,0,0,0,0,2,2
Isle of Wight,LIM,F,14,6,2,2,2,8,34
Isle of Wight,LIM,M,15,7,3,0,1,1,27
Isle of Wight,LIMBX,F,0,0,0,0,0,2,2
Isle of Wight,LIMRX,F,0,0,0,0,0,1,1
Isle of Wight,LIMX,F,57,61,9,8,2,30,167
Isle of Wight,LIMX,M,80,129,17,1,0,7,234
Isle of Wight,LIX,F,0,0,0,0,0,26,26
Isle of Wight,LIX,M,0,0,0,0,0,11,11
Isle of Wight,LR,F,3,0,1,2,4,0,10
Isle of Wight,LR,M,1,0,0,0,0,0,1
Isle of Wight,MG,F,0,0,0,0,0,7,7
Isle of Wight,MGX,F,1,0,0,0,0,5,6
Isle of Wight,MGX,M,1,0,0,0,0,0,1
Isle of Wight,MO,F,0,0,7,8,1,46,62
Isle of Wight,MO,M,5,0,0,0,0,3,8
Isle of Wight,MOX,F,0,0,0,6,0,1,7
Isle of Wight,MOX,M,0,0,0,0,0,1,1
Isle of Wight,MRI,F,7,6,2,5,3,16,39
Isle of Wight,MRI,M,4,0,0,0,0,0,4
Isle of Wight,MRIX,F,0,0,0,1,2,6,9
Isle of Wight,MRIX,M,1,13,1,0,0,3,18
Isle of Wight,NR,M,1,0,0,0,0,0,1
Isle of Wight,NRX,F,2,0,0,0,0,0,2
Isle of Wight,NRX,M,3,0,0,0,0,0,3
Isle of Wight,NS,F,0,0,0,0,0,17,17
Isle of Wight,PI,F,0,0,1,0,0,0,1
Isle of Wight,PIX,F,2,0,0,0,0,2,4
Isle of Wight,PIX,M,3,0,0,0,0,3,6
Isle of Wight,RP,F,2,4,6,1,2,1,16
Isle of Wight,RP,M,2,7,2,0,0,2,13
Isle of Wight,RWFR,F,1,0,0,0,0,0,1
Isle of Wight,SA,F,0,0,1,2,1,11,15
Isle of Wight,SA,M,1,0,2,1,0,4,8
Isle of Wight,SAX,F,25,4,6,3,0,9,47
Isle of Wight,SAX,M,24,3,4,0,0,1,32
Isle of Wight,SD,F,2,2,2,0,0,1,7
Isle of Wight,SD,M,2,0,2,1,0,0,5
Isle of Wight,SDX,F,1,0,0,0,0,0,1
Isle of Wight,SDX,M,1,2,2,0,0,0,5
Isle of Wight,SH,F,0,0,0,0,0,1,1
Isle of Wight,SHO,F,6,2,4,8,21,79,120
Isle of Wight,SHO,M,1,0,0,0,1,7,9
Isle of Wight,SHOX,F,7,16,10,2,3,30,68
Isle of Wight,SHOX,M,6,4,0,0,0,3,13
Isle of Wight,SHX,F,0,0,0,0,0,1,1
Isle of Wight,SHX,M,0,0,0,0,0,1,1
Isle of Wight,SM,F,55,51,32,32,21,100,291
Isle of Wight,SM,M,85,34,7,7,2,12,147
Isle of Wight,SMX,F,294,143,35,51,40,283,846
Isle of Wight,SMX,M,298,193,38,5,1,12,547
Isle of Wight,SRWX,F,5,0,1,0,1,0,7
Isle of Wight,SRWX,M,17,1,0,0,0,0,18
Isle of Wight,SU,F,1,0,1,0,0,1,3
Isle of Wight,SU,M,1,0,0,0,0,0,1
Isle of Wight,SUX,F,0,0,0,0,0,3,3
Isle of Wight,SUX,M,1,0,0,0,0,0,1
Isle of Wight,WB,F,0,0,0,0,0,3,3
Isle of Wight,WG,F,1,0,0,0,0,0,1
Isle of Wight,WP,F,2,2,1,0,0,8,13
Isle of Wight,WP,M,3,1,3,5,0,1,13
Isle of Wight,WPX,F,1,0,0,0,0,0,1
Hereford & Worcester,AA,F,255,255,120,100,71,479,"1,280"
Hereford & Worcester,AA,M,283,282,54,24,20,52,715
Hereford & Worcester,AAX,F,"1,207",799,278,179,231,915,"3,609"
Hereford & Worcester,AAX,M,"1,072",753,116,12,7,34,"1,994"
Hereford & Worcester,AN,F,0,0,0,0,0,2,2
Hereford & Worcester,AN,M,0,1,0,0,0,1,2
Hereford & Worcester,AR,F,0,0,0,1,0,0,1
Hereford & Worcester,ARX,M,1,1,0,0,0,0,2
Hereford & Worcester,AY,F,63,53,83,49,78,216,542
Hereford & Worcester,AY,M,38,6,11,2,0,2,59
Hereford & Worcester,AYX,F,5,5,4,1,3,2,20
Hereford & Worcester,AYX,M,8,2,1,0,0,0,11
Hereford & Worcester,BA,F,179,144,57,62,42,196,680
Hereford & Worcester,BA,M,157,123,39,23,16,56,414
Hereford & Worcester,BABX,F,0,0,0,0,0,9,9
Hereford & Worcester,BABX,M,0,0,0,0,0,1,1
Hereford & Worcester,BAL,F,0,0,0,1,0,7,8
Hereford & Worcester,BALX,F,0,0,13,22,18,9,62
Hereford & Worcester,BALX,M,0,1,13,0,0,0,14
Hereford & Worcester,BAR,M,0,0,0,0,0,1,1
Hereford & Worcester,BARX,F,0,0,0,0,0,12,12
Hereford & Worcester,BAWX,F,0,0,0,0,0,1,1
Hereford & Worcester,BAWX,M,0,0,0,0,0,1,1
Hereford & Worcester,BAX,F,"1,352","1,577",368,200,178,953,"4,628"
Hereford & Worcester,BAX,M,"1,503","1,198",199,16,6,81,"3,003"
Hereford & Worcester,BAZ,F,2,7,3,0,0,12,24
Hereford & Worcester,BAZ,M,3,3,0,0,1,1,8
Hereford & Worcester,BAZX,F,29,21,1,2,0,3,56
Hereford & Worcester,BAZX,M,22,10,0,0,0,0,32
Hereford & Worcester,BB,F,160,199,118,86,72,337,972
Hereford & Worcester,BB,M,250,195,59,11,9,52,576
Hereford & Worcester,BBX,F,"1,854","2,228",946,677,536,"1,750","7,991"
Hereford & Worcester,BBX,M,"2,364","1,937",526,20,13,62,"4,922"
Hereford & Worcester,BF,F,837,830,922,990,914,"1,588","6,081"
Hereford & Worcester,BF,M,881,723,209,49,19,27,"1,908"
Hereford & Worcester,BFX,F,59,66,77,70,71,118,461
Hereford & Worcester,BFX,M,114,43,17,2,3,2,181
Hereford & Worcester,BG,F,17,4,4,1,1,16,43
Hereford & Worcester,BG,M,7,2,4,0,1,3,17
Hereford & Worcester,BGX,F,6,0,3,8,5,2,24
Hereford & Worcester,BGX,M,2,6,1,0,0,0,9
Hereford & Worcester,BH,F,18,0,0,0,0,153,171
Hereford & Worcester,BH,M,1,0,0,0,0,1,2
Hereford & Worcester,BHX,F,1,0,0,0,0,36,37
Hereford & Worcester,BI,F,0,1,0,0,0,0,1
Hereford & Worcester,BI,M,0,1,0,0,0,0,1
Hereford & Worcester,BLG,F,0,0,5,0,0,4,9
Hereford & Worcester,BRX,F,2,0,1,0,0,0,3
Hereford & Worcester,BS,F,18,21,12,3,12,17,83
Hereford & Worcester,BS,M,18,13,6,1,2,0,40
Hereford & Worcester,BSH,F,39,36,20,22,12,29,158
Hereford & Worcester,BSH,M,38,40,11,1,1,4,95
Hereford & Worcester,BSHX,F,18,35,8,4,7,35,107
Hereford & Worcester,BSHX,M,24,17,0,0,0,0,41
Hereford & Worcester,BSX,F,82,67,27,16,24,39,255
Hereford & Worcester,BSX,M,60,19,9,0,1,0,89
Hereford & Worcester,BW,F,0,5,5,2,1,14,27
Hereford & Worcester,BW,M,3,1,0,0,0,1,5
Hereford & Worcester,BWBX,M,0,1,0,0,0,0,1
Hereford & Worcester,BWX,F,26,32,14,7,5,12,96
Hereford & Worcester,BWX,M,35,35,8,2,0,0,80
Hereford & Worcester,BX,M,0,0,0,0,0,1,1
Hereford & Worcester,CA,F,0,0,0,0,0,1,1
Hereford & Worcester,CAX,F,0,0,0,0,0,2,2
Hereford & Worcester,CB,F,1,7,0,0,0,82,90
Hereford & Worcester,CB,M,0,5,0,0,0,0,5
Hereford & Worcester,CH,F,396,485,166,106,104,744,"2,001"
Hereford & Worcester,CH,M,430,448,89,55,37,234,"1,293"
Hereford & Worcester,CHI,F,0,0,1,0,0,2,3
Hereford & Worcester,CHIX,F,0,0,0,0,0,2,2
Hereford & Worcester,CHL,F,2,0,0,0,0,0,2
Hereford & Worcester,CHL,M,1,0,0,0,0,0,1
Hereford & Worcester,CHX,F,"3,968","5,480",975,358,381,"2,604","13,766"
Hereford & Worcester,CHX,M,"4,204","4,373",761,49,19,276,"9,682"
Hereford & Worcester,DE,F,0,0,0,0,0,2,2
Hereford & Worcester,DEV,F,33,25,13,14,4,33,122
Hereford & Worcester,DEV,M,22,21,2,0,3,1,49
Hereford & Worcester,DEVX,F,24,29,9,6,4,31,103
Hereford & Worcester,DEVX,M,9,19,8,0,0,0,36
Hereford & Worcester,DEX,F,129,89,87,62,42,207,616
Hereford & Worcester,DEX,M,126,104,46,13,6,18,313
Hereford & Worcester,DEXX,F,1,3,0,0,1,6,11
Hereford & Worcester,DEXX,M,4,2,2,0,0,0,8
Hereford & Worcester,DRX,F,17,16,15,6,3,0,57
Hereford & Worcester,DRX,M,2,7,0,0,0,0,9
Hereford & Worcester,DS,F,20,21,26,10,9,24,110
Hereford & Worcester,DS,M,9,0,0,0,0,1,10
Hereford & Worcester,DSHO,F,0,0,0,0,0,1,1
Hereford & Worcester,DSX,F,17,4,3,2,1,4,31
Hereford & Worcester,DSX,M,15,3,1,0,0,0,19
Hereford & Worcester,DV,F,0,0,0,0,0,43,43
Hereford & Worcester,DV,M,0,0,0,0,0,2,2
Hereford & Worcester,DVX,F,0,0,0,0,0,42,42
Hereford & Worcester,DVX,M,0,0,0,0,0,9,9
Hereford & Worcester,DZE,M,0,0,0,0,0,1,1
Hereford & Worcester,FR,F,0,0,0,0,0,"6,147","6,147"
Hereford & Worcester,FR,M,0,0,0,0,0,173,173
Hereford & Worcester,FRX,F,0,0,0,0,0,130,130
Hereford & Worcester,FRX,M,0,0,0,0,0,12,12
Hereford & Worcester,GA,F,0,8,8,0,0,1,17
Hereford & Worcester,GA,M,0,0,0,0,0,2,2
Hereford & Worcester,GAX,F,0,2,1,0,0,12,15
Hereford & Worcester,GAX,M,1,2,0,0,0,0,3
Hereford & Worcester,GB,M,1,1,0,0,0,0,2
Hereford & Worcester,GBX,F,2,1,0,0,0,2,5
Hereford & Worcester,GBX,M,1,0,1,0,0,0,2
Hereford & Worcester,GE,F,0,0,0,0,0,1,1
Hereford & Worcester,GE,M,0,9,1,0,0,0,10
Hereford & Worcester,GEX,F,2,17,3,2,0,8,32
Hereford & Worcester,GEX,M,3,18,0,0,0,0,21
Hereford & Worcester,GL,F,8,6,10,5,6,19,54
Hereford & Worcester,GL,M,5,8,3,0,0,1,17
Hereford & Worcester,GLX,F,0,0,0,0,0,2,2
Hereford & Worcester,GLX,M,3,0,0,0,0,0,3
Hereford & Worcester,GU,F,57,57,54,55,51,162,436
Hereford & Worcester,GU,M,21,21,5,0,1,2,50
Hereford & Worcester,GUX,F,0,0,0,0,3,3,6
Hereford & Worcester,GUX,M,0,1,0,0,0,0,1
Hereford & Worcester,H,F,0,0,0,0,0,406,406
Hereford & Worcester,H,M,0,0,0,0,0,69,69
Hereford & Worcester,HE,F,972,795,536,379,363,"1,054","4,099"
Hereford & Worcester,HE,M,"1,045",774,168,56,45,85,"2,173"
Hereford & Worcester,HEBL,F,0,0,0,0,0,13,13
Hereford & Worcester,HEBLX,F,0,0,0,0,0,224,224
Hereford & Worcester,HEBLX,M,0,0,0,0,0,1,1
Hereford & Worcester,HEBR,F,0,0,0,0,0,2,2
Hereford & Worcester,HER,F,0,0,0,0,0,52,52
Hereford & Worcester,HER,M,0,0,0,0,0,5,5
Hereford & Worcester,HERX,F,0,0,0,0,0,83,83
Hereford & Worcester,HERX,M,0,0,0,0,0,3,3
Hereford & Worcester,HEX,F,"1,902","1,594",726,560,505,"2,129","7,416"
Hereford & Worcester,HEX,M,"2,243","1,723",274,14,13,46,"4,313"
Hereford & Worcester,HF,F,"3,232","3,518","3,612","3,476","3,083","5,812","22,733"
Hereford & Worcester,HF,M,"2,293","1,442",570,62,43,61,"4,471"
Hereford & Worcester,HFX,F,101,51,92,85,103,168,600
Hereford & Worcester,HFX,M,80,87,46,12,2,1,228
Hereford & Worcester,HI,F,46,31,23,23,20,105,248
Hereford & Worcester,HI,M,36,25,17,2,1,17,98
Hereford & Worcester,HIX,F,1,4,0,8,4,11,28
Hereford & Worcester,HIX,M,1,6,1,1,1,0,10
Hereford & Worcester,HL,F,0,0,0,0,0,7,7
Hereford & Worcester,HLX,F,0,0,0,0,0,1,1
Hereford & Worcester,HO,F,988,890,902,705,457,892,"4,834"
Hereford & Worcester,HO,M,256,167,50,14,6,9,502
Hereford & Worcester,HOX,F,17,60,39,44,55,93,308
Hereford & Worcester,HOX,M,10,28,17,5,1,4,65
Hereford & Worcester,HX,F,0,0,0,0,0,914,914
Hereford & Worcester,HX,M,0,0,0,0,0,70,70
Hereford & Worcester,IM,F,0,0,0,0,1,5,6
Hereford & Worcester,IMX,F,0,1,0,0,0,1,2
Hereford & Worcester,IMX,M,0,2,0,0,0,0,2
Hereford & Worcester,JE,F,457,549,399,375,291,816,"2,887"
Hereford & Worcester,JE,M,26,16,27,11,3,3,86
Hereford & Worcester,JEX,F,48,82,65,33,28,15,271
Hereford & Worcester,JEX,M,3,2,0,1,0,0,6
Hereford & Worcester,JY,F,102,0,0,0,0,12,114
Hereford & Worcester,JY,M,1,0,0,0,0,0,1
Hereford & Worcester,KE,F,2,2,0,1,1,2,8
Hereford & Worcester,KE,M,1,0,0,0,0,0,1
Hereford & Worcester,KEX,F,0,0,0,0,0,1,1
Hereford & Worcester,LH,F,46,30,25,22,22,110,255
Hereford & Worcester,LH,M,42,54,23,7,0,7,133
Hereford & Worcester,LHX,F,5,3,1,5,3,23,40
Hereford & Worcester,LHX,M,6,7,0,0,0,0,13
Hereford & Worcester,LI,F,0,0,0,0,0,209,209
Hereford & Worcester,LI,M,0,0,0,0,0,59,59
Hereford & Worcester,LIM,F,"1,087","1,264",402,233,253,933,"4,172"
Hereford & Worcester,LIM,M,"1,059","1,135",357,64,42,199,"2,856"
Hereford & Worcester,LIM X,F,0,0,0,0,0,4,4
Hereford & Worcester,LIM X,M,0,0,0,0,0,1,1
Hereford & Worcester,LIMB,F,0,0,0,0,0,20,20
Hereford & Worcester,LIMBX,F,0,0,0,0,0,186,186
Hereford & Worcester,LIMBX,M,0,0,0,0,0,3,3
Hereford & Worcester,LIMR,F,0,0,0,0,0,26,26
Hereford & Worcester,LIMR,M,0,0,0,0,0,7,7
Hereford & Worcester,LIMRX,F,0,0,0,0,0,151,151
Hereford & Worcester,LIMRX,M,0,0,0,0,0,2,2
Hereford & Worcester,LIMX,F,"6,505","7,954","2,051",987,982,"3,733","22,212"
Hereford & Worcester,LIMX,M,"6,694","6,576","1,327",53,37,136,"14,823"
Hereford & Worcester,LIX,F,0,0,0,0,0,939,939
Hereford & Worcester,LIX,M,0,0,0,0,0,110,110
Hereford & Worcester,LM,F,0,0,0,0,0,7,7
Hereford & Worcester,LM,M,0,0,0,0,0,1,1
Hereford & Worcester,LMX,F,0,0,0,0,0,15,15
Hereford & Worcester,LR,F,0,0,0,0,0,1,1
Hereford & Worcester,LR,M,0,0,1,0,0,0,1
Hereford & Worcester,LRX,F,2,4,8,0,2,3,19
Hereford & Worcester,LRX,M,11,2,1,0,0,0,14
Hereford & Worcester,MA,M,0,0,0,0,0,3,3
Hereford & Worcester,MARX,F,0,1,0,0,0,0,1
Hereford & Worcester,MAX,F,14,0,0,0,0,5,19
Hereford & Worcester,MAX,M,22,8,0,0,0,0,30
Hereford & Worcester,MG,F,18,41,28,18,7,20,132
Hereford & Worcester,MG,M,15,13,0,1,0,1,30
Hereford & Worcester,MGX,F,5,3,2,0,1,6,17
Hereford & Worcester,MGX,M,5,6,4,0,0,0,15
Hereford & Worcester,MO,F,8,10,12,25,34,22,111
Hereford & Worcester,MO,M,3,2,6,0,4,1,16
Hereford & Worcester,MOX,F,58,28,50,13,19,23,191
Hereford & Worcester,MOX,M,68,33,1,0,0,0,102
Hereford & Worcester,MRI,F,24,43,38,59,30,94,288
Hereford & Worcester,MRI,M,40,19,5,0,2,5,71
Hereford & Worcester,MRIX,F,60,50,21,43,55,126,355
Hereford & Worcester,MRIX,M,104,48,11,2,0,3,168
Hereford & Worcester,NO,F,0,0,0,0,0,1,1
Hereford & Worcester,NOX,F,10,13,6,3,0,0,32
Hereford & Worcester,NOX,M,14,1,0,0,0,0,15
Hereford & Worcester,NR,M,2,0,0,0,0,0,2
Hereford & Worcester,NRX,F,23,0,0,0,0,0,23
Hereford & Worcester,NRX,M,5,1,0,0,0,0,6
Hereford & Worcester,NS,F,0,0,0,0,0,489,489
Hereford & Worcester,NS,M,0,0,0,0,0,1,1
Hereford & Worcester,OEX,F,1,0,0,0,0,0,1
Hereford & Worcester,PA,F,10,1,1,1,0,4,17
Hereford & Worcester,PA,M,11,2,2,1,0,0,16
Hereford & Worcester,PAX,F,16,3,2,1,1,17,40
Hereford & Worcester,PAX,M,13,3,2,0,0,3,21
Hereford & Worcester,PI,F,1,0,1,0,1,6,9
Hereford & Worcester,PI,M,5,0,1,0,0,2,8
Hereford & Worcester,PIX,F,47,53,21,2,6,25,154
Hereford & Worcester,PIX,M,38,42,18,1,0,1,100
Hereford & Worcester,ROX,F,11,0,0,0,0,3,14
Hereford & Worcester,ROX,M,6,0,0,0,0,0,6
Hereford & Worcester,RP,F,34,22,30,18,9,79,192
Hereford & Worcester,RP,M,32,7,5,1,0,4,49
Hereford & Worcester,RPX,F,14,15,5,10,5,5,54
Hereford & Worcester,RPX,M,8,11,0,1,0,0,20
Hereford & Worcester,RWFR,F,1,0,0,0,0,2,3
Hereford & Worcester,RWFR,M,1,0,0,0,0,0,1
Hereford & Worcester,SA,F,3,8,7,5,2,24,49
Hereford & Worcester,SA,M,10,13,5,2,1,0,31
Hereford & Worcester,SAX,F,87,87,57,38,35,171,475
Hereford & Worcester,SAX,M,112,101,7,0,0,2,222
Hereford & Worcester,SBX,F,0,0,1,0,1,0,2
Hereford & Worcester,SD,F,84,79,60,68,47,178,516
Hereford & Worcester,SD,M,96,48,15,6,2,10,177
Hereford & Worcester,SDX,F,87,109,45,24,23,86,374
Hereford & Worcester,SDX,M,94,104,11,1,1,1,212
Hereford & Worcester,SG,F,0,0,0,0,0,1,1
Hereford & Worcester,SH,F,1,3,1,0,0,3,8
Hereford & Worcester,SH,M,0,2,0,0,0,0,2
Hereford & Worcester,SHO,F,18,12,5,11,19,109,174
Hereford & Worcester,SHO,M,36,16,2,1,0,2,57
Hereford & Worcester,SHOX,F,28,7,11,7,11,77,141
Hereford & Worcester,SHOX,M,55,10,0,0,1,2,68
Hereford & Worcester,SHX,F,2,0,0,0,0,2,4
Hereford & Worcester,SHX,M,1,0,0,0,0,0,1
Hereford & Worcester,SM,F,435,301,159,122,84,540,"1,641"
Hereford & Worcester,SM,M,499,247,53,30,26,74,929
Hereford & Worcester,SMX,F,"1,998","2,086",662,502,487,"2,464","8,199"
Hereford & Worcester,SMX,M,"2,201","1,526",285,18,10,143,"4,183"
Hereford & Worcester,SRW,M,3,1,0,0,0,0,4
Hereford & Worcester,SRWX,F,0,2,1,1,1,0,5
Hereford & Worcester,SRWX,M,11,0,0,0,0,0,11
Hereford & Worcester,STX,F,1,0,0,0,0,0,1
Hereford & Worcester,SU,F,0,0,1,0,1,22,24
Hereford & Worcester,SU,M,0,1,1,0,0,1,3
Hereford & Worcester,SUX,F,0,7,3,0,1,6,17
Hereford & Worcester,SUX,M,0,2,2,0,0,1,5
Hereford & Worcester,WB,F,58,55,33,15,20,166,347
Hereford & Worcester,WB,M,59,106,36,2,2,7,212
Hereford & Worcester,WBX,F,42,44,10,6,13,74,189
Hereford & Worcester,WBX,M,31,35,7,3,0,2,78
Hereford & Worcester,WP,F,9,5,4,3,0,11,32
Hereford & Worcester,WP,M,6,7,4,2,1,0,20
Hereford & Worcester,WPX,F,0,1,0,0,1,1,3
Hereford & Worcester,WPX,M,0,2,0,0,2,0,4
Hereford & Worcester,WS,F,0,0,0,0,0,1,1
Hereford & Worcester,WSX,F,0,1,0,0,0,0,1
Hereford & Worcester,WSX,M,0,3,0,0,0,0,3
Hereford & Worcester,WW,F,0,0,0,0,0,2,2
Hereford & Worcester,WW,M,0,1,0,0,0,0,1
Hereford & Worcester,ZE,F,0,0,0,0,0,1,1
Hertfordshire,AA,F,42,40,12,16,14,42,166
Hertfordshire,AA,M,43,43,5,6,2,11,110
Hertfordshire,AAX,F,224,190,31,38,34,72,589
Hertfordshire,AAX,M,279,295,15,0,1,5,595
Hertfordshire,AUX,F,0,0,4,0,0,7,11
Hertfordshire,AY,F,25,24,36,43,16,88,232
Hertfordshire,AY,M,16,14,1,0,0,0,31
Hertfordshire,AYX,F,9,6,1,0,1,4,21
Hertfordshire,AYX,M,13,3,0,0,0,0,16
Hertfordshire,BA,F,19,5,11,3,3,39,80
Hertfordshire,BA,M,23,4,1,2,0,3,33
Hertfordshire,BARX,F,0,0,0,0,0,1,1
Hertfordshire,BARX,M,0,0,0,0,0,1,1
Hertfordshire,BAWX,F,0,0,0,0,0,1,1
Hertfordshire,BAX,F,41,36,7,9,7,83,183
Hertfordshire,BAX,M,31,82,10,1,3,14,141
Hertfordshire,BAZX,F,1,0,0,0,0,0,1
Hertfordshire,BAZX,M,0,0,0,0,0,1,1
Hertfordshire,BB,F,19,8,3,5,0,30,65
Hertfordshire,BB,M,7,7,1,3,4,24,46
Hertfordshire,BBX,F,357,306,67,54,74,221,"1,079"
Hertfordshire,BBX,M,228,142,15,0,1,18,404
Hertfordshire,BF,F,12,6,13,9,25,67,132
Hertfordshire,BF,M,6,8,12,0,0,0,26
Hertfordshire,BFX,F,0,1,0,0,1,1,3
Hertfordshire,BFX,M,0,1,1,0,0,1,3
Hertfordshire,BG,F,5,11,9,5,7,24,61
Hertfordshire,BG,M,9,3,4,0,1,4,21
Hertfordshire,BGX,F,5,3,2,0,0,1,11
Hertfordshire,BGX,M,5,0,0,0,0,0,5
Hertfordshire,BHX,F,0,0,0,0,0,3,3
Hertfordshire,BS,F,0,0,0,0,0,1,1
Hertfordshire,BS,M,0,0,0,0,0,1,1
Hertfordshire,BSH,F,15,5,3,0,9,14,46
Hertfordshire,BSH,M,0,6,1,1,0,1,9
Hertfordshire,BSHX,F,27,23,17,20,10,0,97
Hertfordshire,BSHX,M,21,11,0,0,0,0,32
Hertfordshire,BSX,M,1,0,0,0,0,0,1
Hertfordshire,BU,M,0,1,1,0,0,0,2
Hertfordshire,BW,F,0,1,2,1,3,10,17
Hertfordshire,BW,M,1,11,1,0,0,1,14
Hertfordshire,BWX,F,0,1,0,1,1,1,4
Hertfordshire,BX,M,0,0,0,0,0,1,1
Hertfordshire,CB,F,6,3,0,0,0,23,32
Hertfordshire,CB,M,3,2,0,1,0,0,6
Hertfordshire,CD,F,0,0,0,0,0,1,1
Hertfordshire,CH,F,57,37,24,9,19,74,220
Hertfordshire,CH,M,54,9,2,3,3,9,80
Hertfordshire,CHX,F,183,179,72,17,52,316,819
Hertfordshire,CHX,M,154,102,19,2,0,22,299
Hertfordshire,DE,F,0,0,0,0,0,1,1
Hertfordshire,DEV,F,0,0,8,1,0,4,13
Hertfordshire,DEVX,F,4,5,4,0,0,1,14
Hertfordshire,DEVX,M,4,2,0,0,0,0,6
Hertfordshire,DEX,F,37,25,13,16,12,42,145
Hertfordshire,DEX,M,38,42,4,3,0,4,91
Hertfordshire,DS,F,0,1,0,0,1,1,3
Hertfordshire,DS,M,0,1,1,0,0,0,2
Hertfordshire,DSX,F,0,0,0,0,0,1,1
Hertfordshire,DSX,M,0,9,0,0,0,1,10
Hertfordshire,DV,F,0,0,0,0,0,2,2
Hertfordshire,DV,M,0,0,0,0,0,2,2
Hertfordshire,DVX,F,0,0,0,0,0,1,1
Hertfordshire,FR,F,0,0,0,0,0,392,392
Hertfordshire,FR,M,0,0,0,0,0,20,20
Hertfordshire,FRX,F,0,0,0,0,0,23,23
Hertfordshire,FRX,M,0,0,0,0,0,6,6
Hertfordshire,GA,F,2,1,0,0,2,9,14
Hertfordshire,GA,M,2,0,0,3,0,0,5
Hertfordshire,GAX,F,16,20,0,0,0,9,45
Hertfordshire,GAX,M,11,4,0,0,0,2,17
Hertfordshire,GBX,M,1,0,0,0,0,0,1
Hertfordshire,GE,F,0,0,3,0,0,0,3
Hertfordshire,GE,M,2,0,0,0,1,0,3
Hertfordshire,GEX,F,12,2,4,0,1,6,25
Hertfordshire,GEX,M,9,5,0,0,0,2,16
Hertfordshire,GL,F,0,0,0,0,0,1,1
Hertfordshire,GU,F,0,0,0,1,0,3,4
Hertfordshire,H,F,0,0,0,0,0,19,19
Hertfordshire,H,M,0,0,0,0,0,1,1
Hertfordshire,HE,F,14,48,8,5,5,42,122
Hertfordshire,HE,M,27,16,6,2,0,3,54
Hertfordshire,HEBL,F,0,0,0,0,0,3,3
Hertfordshire,HEBLX,F,0,0,0,0,0,9,9
Hertfordshire,HER,F,0,0,0,0,0,1,1
Hertfordshire,HERX,F,0,0,0,0,0,4,4
Hertfordshire,HEX,F,59,51,31,30,8,206,385
Hertfordshire,HEX,M,63,78,15,1,9,5,171
Hertfordshire,HF,F,208,178,210,201,176,416,"1,389"
Hertfordshire,HF,M,94,109,22,3,0,4,232
Hertfordshire,HFX,F,0,5,2,1,1,3,12
Hertfordshire,HFX,M,6,9,0,0,0,0,15
Hertfordshire,HI,F,4,6,2,1,4,34,51
Hertfordshire,HI,M,8,10,1,3,0,10,32
Hertfordshire,HIX,F,0,0,0,0,1,2,3
Hertfordshire,HIX,M,0,0,0,0,0,1,1
Hertfordshire,HO,F,45,43,34,61,29,41,253
Hertfordshire,HO,M,23,2,0,0,0,1,26
Hertfordshire,HOX,F,0,1,0,0,0,2,3
Hertfordshire,HX,F,0,0,0,0,0,77,77
Hertfordshire,HX,M,0,0,0,0,0,7,7
Hertfordshire,IM,F,0,0,0,0,0,1,1
Hertfordshire,JE,F,79,64,46,32,49,103,373
Hertfordshire,JE,M,11,9,0,0,0,0,20
Hertfordshire,JEX,F,0,1,0,0,0,5,6
Hertfordshire,JEX,M,0,0,0,0,0,1,1
Hertfordshire,JY,F,0,0,0,0,0,2,2
Hertfordshire,KE,F,0,0,3,0,0,0,3
Hertfordshire,LH,F,8,8,4,4,7,27,58
Hertfordshire,LH,M,10,19,6,0,0,2,37
Hertfordshire,LHX,F,7,1,2,0,0,0,10
Hertfordshire,LHX,M,12,3,2,0,0,0,17
Hertfordshire,LI,F,0,0,0,0,0,19,19
Hertfordshire,LI,M,0,0,0,0,0,14,14
Hertfordshire,LIM,F,18,59,5,6,11,68,167
Hertfordshire,LIM,M,30,42,4,7,1,22,106
Hertfordshire,LIMBX,F,0,0,0,0,0,18,18
Hertfordshire,LIMR,F,0,0,0,0,0,1,1
Hertfordshire,LIMR,M,0,0,0,0,0,1,1
Hertfordshire,LIMRX,F,0,0,0,0,0,6,6
Hertfordshire,LIMRX,M,0,0,0,0,0,1,1
Hertfordshire,LIMX,F,325,276,59,69,49,221,999
Hertfordshire,LIMX,M,365,240,21,2,1,5,634
Hertfordshire,LIX,F,0,0,0,0,0,75,75
Hertfordshire,LIX,M,0,0,0,0,0,28,28
Hertfordshire,LM,F,0,0,0,0,0,2,2
Hertfordshire,LMX,F,0,0,0,0,0,7,7
Hertfordshire,MG,F,2,2,0,4,0,6,14
Hertfordshire,MG,M,0,0,0,0,0,1,1
Hertfordshire,MGX,F,6,0,1,3,5,4,19
Hertfordshire,MGX,M,5,1,0,0,0,0,6
Hertfordshire,MRI,F,1,1,0,1,1,1,5
Hertfordshire,MRI,M,1,1,0,1,0,1,4
Hertfordshire,MRIX,F,1,0,0,0,1,6,8
Hertfordshire,MRIX,M,2,0,0,0,2,3,7
Hertfordshire,NOX,F,0,0,0,0,0,1,1
Hertfordshire,NOX,M,0,4,0,0,0,0,4
Hertfordshire,NS,F,0,0,0,0,0,54,54
Hertfordshire,NS,M,0,0,0,0,0,1,1
Hertfordshire,PI,F,4,3,2,3,2,20,34
Hertfordshire,PI,M,5,0,6,1,2,6,20
Hertfordshire,PIX,F,112,74,38,29,31,148,432
Hertfordshire,PIX,M,83,55,2,0,0,7,147
Hertfordshire,ROX,M,0,3,0,0,0,0,3
Hertfordshire,RP,F,0,0,1,2,0,1,4
Hertfordshire,RP,M,0,0,0,0,0,1,1
Hertfordshire,RPX,F,0,1,0,0,0,0,1
Hertfordshire,RPX,M,2,0,0,0,0,0,2
Hertfordshire,SA,F,2,0,0,0,0,2,4
Hertfordshire,SA,M,0,1,0,0,0,0,1
Hertfordshire,SAX,F,1,0,0,2,0,5,8
Hertfordshire,SD,F,19,10,8,30,10,26,103
Hertfordshire,SD,M,22,10,2,3,0,2,39
Hertfordshire,SDX,F,31,27,6,8,2,13,87
Hertfordshire,SDX,M,28,12,0,0,0,0,40
Hertfordshire,SH,F,3,2,1,0,0,3,9
Hertfordshire,SH,M,0,7,0,0,0,0,7
Hertfordshire,SHO,F,2,0,0,1,0,4,7
Hertfordshire,SHO,M,0,0,3,0,0,0,3
Hertfordshire,SHOX,F,1,0,0,0,3,1,5
Hertfordshire,SHOX,M,2,1,0,0,0,0,3
Hertfordshire,SM,F,116,77,25,37,24,168,447
Hertfordshire,SM,M,105,27,5,4,10,24,175
Hertfordshire,SMX,F,271,315,94,61,82,443,"1,266"
Hertfordshire,SMX,M,285,236,13,1,3,30,568
Hertfordshire,ST,M,0,0,0,1,0,0,1
Hertfordshire,STX,F,4,0,0,0,0,0,4
Hertfordshire,STX,M,9,0,0,0,0,0,9
Hertfordshire,SU,F,0,4,0,0,0,8,12
Hertfordshire,SU,M,0,9,0,0,0,6,15
Hertfordshire,SUX,F,3,9,3,0,0,3,18
Hertfordshire,SUX,M,3,24,1,0,0,0,28
Hertfordshire,WB,F,0,0,0,0,0,1,1
Hertfordshire,WBX,F,0,1,0,0,0,3,4
Hertfordshire,WBX,M,0,1,0,0,0,0,1
Hertfordshire,WP,F,0,0,0,0,0,2,2
Hertfordshire,WPX,F,0,0,0,0,0,3,3
Kent,AA,F,141,121,87,51,52,222,674
Kent,AA,M,144,90,32,8,7,31,312
Kent,AAX,F,719,561,155,133,189,656,"2,413"
Kent,AAX,M,658,431,63,3,12,41,"1,208"
Kent,AR,M,1,0,0,0,0,0,1
Kent,AUX,F,0,0,0,1,0,0,1
Kent,AY,F,59,65,43,51,37,177,432
Kent,AY,M,38,29,12,6,0,3,88
Kent,AYX,F,13,2,0,0,1,1,17
Kent,AYX,M,11,0,0,0,0,0,11
Kent,BA,F,22,21,11,3,9,50,116
Kent,BA,M,28,14,2,3,6,23,76
Kent,BABX,F,0,0,0,0,0,4,4
Kent,BABX,M,0,0,0,0,0,1,1
Kent,BAL,F,1,0,2,1,0,2,6
Kent,BAL,M,1,2,1,0,0,0,4
Kent,BALX,M,0,1,0,0,0,0,1
Kent,BARX,F,0,0,0,0,0,1,1
Kent,BAX,F,343,175,81,36,36,316,987
Kent,BAX,M,307,146,17,5,4,27,506
Kent,BAZ,F,0,1,0,0,0,0,1
Kent,BAZ X,F,0,0,0,0,0,1,1
Kent,BAZ X,M,0,0,0,0,0,1,1
Kent,BAZX,F,3,1,0,1,3,3,11
Kent,BAZX,M,1,0,0,1,0,4,6
Kent,BB,F,52,25,21,11,8,57,174
Kent,BB,M,65,21,6,10,4,18,124
Kent,BBX,F,534,434,206,97,76,307,"1,654"
Kent,BBX,M,536,351,50,4,1,34,976
Kent,BF,F,367,289,293,257,231,425,"1,862"
Kent,BF,M,215,138,51,8,3,16,431
Kent,BFX,F,10,17,10,24,12,16,89
Kent,BFX,M,39,10,4,0,0,0,53
Kent,BG,F,0,0,1,0,1,2,4
Kent,BGX,F,0,0,0,0,0,1,1
Kent,BH,F,0,0,0,0,0,58,58
Kent,BH,M,0,0,0,0,0,2,2
Kent,BHX,M,2,0,0,0,0,0,2
Kent,BI,F,2,3,0,0,5,0,10
Kent,BI,M,1,2,0,0,0,0,3
Kent,BLG,F,0,0,0,0,0,6,6
Kent,BR,F,1,0,0,0,0,0,1
Kent,BRX,F,1,0,0,0,0,0,1
Kent,BS,F,0,1,0,0,0,3,4
Kent,BSH,F,6,8,3,5,5,6,33
Kent,BSH,M,6,2,1,1,0,0,10
Kent,BSHX,F,57,2,5,4,2,7,77
Kent,BSHX,M,48,5,1,0,0,0,54
Kent,BSX,F,4,5,0,1,0,1,11
Kent,BSX,M,3,1,0,0,0,0,4
Kent,BU,F,4,1,0,0,3,4,12
Kent,BU,M,4,3,0,0,0,2,9
Kent,BW,F,12,11,9,7,3,29,71
Kent,BW,M,10,8,3,1,0,2,24
Kent,BWX,F,1,1,1,0,0,10,13
Kent,BX,F,0,0,0,0,0,2,2
Kent,CAX,F,0,0,0,0,0,4,4
Kent,CB,F,6,4,3,0,0,166,179
Kent,CB,M,16,3,0,0,1,0,20
Kent,CH,F,168,88,101,45,63,390,855
Kent,CH,M,143,49,17,17,22,49,297
Kent,CHX,F,"1,153",697,204,182,111,991,"3,338"
Kent,CHX,M,"1,124",425,28,4,4,88,"1,673"
Kent,DE,F,0,0,0,0,0,4,4
Kent,DEV,F,1,0,2,1,6,18,28
Kent,DEV,M,1,1,1,0,0,0,3
Kent,DEVX,F,0,7,0,4,0,6,17
Kent,DEVX,M,2,0,0,0,0,0,2
Kent,DEX,F,70,59,46,44,34,183,436
Kent,DEX,M,65,66,19,6,1,13,170
Kent,DEXX,F,0,4,1,2,2,3,12
Kent,DEXX,M,3,1,0,0,0,0,4
Kent,DR,F,0,0,0,0,0,1,1
Kent,DS,F,0,0,0,0,0,3,3
Kent,DS,M,0,0,3,0,0,0,3
Kent,DSHO,F,0,0,0,0,0,1,1
Kent,DV,F,0,0,0,0,0,29,29
Kent,DV,M,0,0,0,0,0,3,3
Kent,DVX,F,0,0,0,0,0,24,24
Kent,DVX,M,0,0,0,0,0,2,2
Kent,DZE,F,0,0,0,0,0,3,3
Kent,FR,F,0,0,0,0,0,"1,853","1,853"
Kent,FR,M,0,0,0,0,0,65,65
Kent,FRX,F,0,0,0,0,0,53,53
Kent,FRX,M,0,0,0,0,0,13,13
Kent,GA,F,0,0,0,0,0,2,2
Kent,GASX,F,0,0,0,0,0,1,1
Kent,GAX,F,0,0,3,0,0,12,15
Kent,GBX,F,0,1,0,0,0,0,1
Kent,GEX,F,0,2,0,0,0,13,15
Kent,GEX,M,5,1,0,0,0,1,7
Kent,GL,F,1,0,0,0,3,3,7
Kent,GL,M,1,0,0,0,0,0,1
Kent,GLX,F,0,0,1,0,0,0,1
Kent,GU,F,29,27,20,26,18,78,198
Kent,GU,M,2,5,2,0,0,0,9
Kent,GUX,F,1,0,1,0,0,0,2
Kent,GY,F,1,0,0,0,0,0,1
Kent,GYX,M,0,0,0,0,0,1,1
Kent,H,F,0,0,0,0,0,47,47
Kent,H,M,0,0,0,0,0,14,14
Kent,HE,F,79,73,46,65,42,111,416
Kent,HE,M,72,55,9,7,12,19,174
Kent,HEBL,F,0,0,0,0,0,2,2
Kent,HEBLX,F,0,0,0,0,0,101,101
Kent,HEBLX,M,0,0,0,0,0,1,1
Kent,HER,F,0,0,0,0,0,1,1
Kent,HERX,F,0,0,0,0,0,22,22
Kent,HEX,F,210,259,111,155,119,686,"1,540"
Kent,HEX,M,193,168,45,4,5,11,426
Kent,HF,F,"1,478","1,528","1,461","1,362","1,149","2,751","9,729"
Kent,HF,M,604,337,152,46,16,24,"1,179"
Kent,HFX,F,147,129,115,99,120,125,735
Kent,HFX,M,53,29,3,7,1,3,96
Kent,HI,F,25,24,13,16,8,97,183
Kent,HI,M,12,23,1,2,1,13,52
Kent,HIX,F,4,1,0,1,2,3,11
Kent,HIX,M,1,0,0,0,0,0,1
Kent,HL,M,0,0,0,0,0,1,1
Kent,HO,F,299,351,321,245,208,344,"1,768"
Kent,HO,M,77,32,18,6,0,2,135
Kent,HOX,F,20,17,2,3,8,13,63
Kent,HOX,M,9,4,0,1,0,0,14
Kent,HX,F,0,0,0,0,0,268,268
Kent,HX,M,0,0,0,0,0,28,28
Kent,JE,F,207,202,257,158,134,310,"1,268"
Kent,JE,M,8,6,3,2,0,4,23
Kent,JEX,F,2,4,3,1,0,21,31
Kent,JEX,M,1,4,1,0,1,1,8
Kent,JY,F,34,0,0,0,0,0,34
Kent,LH,F,17,13,8,5,4,24,71
Kent,LH,M,7,10,0,0,0,3,20
Kent,LHX,F,4,2,0,0,0,2,8
Kent,LHX,M,1,0,1,0,0,0,2
Kent,LI,F,0,0,0,0,0,40,40
Kent,LI,M,0,0,0,0,0,6,6
Kent,LIM,F,124,104,56,42,26,130,482
Kent,LIM,M,115,81,19,29,17,38,299
Kent,LIM X,F,0,0,0,0,0,1,1
Kent,LIMBX,F,0,0,0,0,0,12,12
Kent,LIMR,F,0,0,0,0,0,17,17
Kent,LIMR,M,0,0,0,0,0,1,1
Kent,LIMRX,F,0,0,0,0,0,9,9
Kent,LIMX,F,"1,256",736,212,145,154,803,"3,306"
Kent,LIMX,M,"1,320",764,42,4,4,26,"2,160"
Kent,LIX,F,0,0,0,0,0,172,172
Kent,LIX,M,0,0,0,0,0,22,22
Kent,LM,F,0,0,0,0,0,1,1
Kent,LMX,F,0,0,0,0,0,20,20
Kent,LR,F,6,0,6,9,1,6,28
Kent,LR,M,6,3,1,0,1,2,13
Kent,LRX,F,33,3,0,1,0,12,49
Kent,LRX,M,24,0,0,0,0,0,24
Kent,LU,F,0,0,0,0,0,2,2
Kent,LUX,F,0,0,0,0,0,8,8
Kent,MG,F,0,0,0,0,0,4,4
Kent,MG,M,0,0,0,0,0,2,2
Kent,MGX,F,26,5,4,1,0,9,45
Kent,MGX,M,24,15,0,0,0,0,39
Kent,MO,F,0,2,2,1,0,3,8
Kent,MO,M,0,1,0,0,0,0,1
Kent,MOX,F,14,9,19,11,16,24,93
Kent,MOX,M,21,9,2,0,0,1,33
Kent,MRI,F,0,0,0,0,0,1,1
Kent,MRIX,F,0,0,0,0,0,4,4
Kent,NO,F,1,0,1,0,4,0,6
Kent,NO,M,2,0,0,0,0,0,2
Kent,NOX,F,3,0,0,0,0,0,3
Kent,NOX,M,2,1,0,0,0,0,3
Kent,NRX,F,11,0,0,0,0,0,11
Kent,NRX,M,3,0,0,0,0,0,3
Kent,NS,F,0,0,0,0,0,197,197
Kent,NS,M,0,0,0,0,0,3,3
Kent,PAX,F,0,0,0,0,0,1,1
Kent,PI,F,0,0,1,0,2,4,7
Kent,PI,M,0,0,1,0,0,0,1
Kent,PIX,F,2,2,0,0,3,8,15
Kent,PIX,M,0,4,1,0,0,1,6
Kent,RO,F,0,2,0,2,0,11,15
Kent,RO,M,0,0,0,0,0,1,1
Kent,ROTX,F,1,1,0,0,0,0,2
Kent,ROTX,M,4,0,0,0,0,0,4
Kent,ROX,F,17,13,6,11,6,13,66
Kent,ROX,M,14,9,0,0,0,6,29
Kent,RP,F,6,4,0,0,0,9,19
Kent,RP,M,1,3,0,1,0,0,5
Kent,RPX,F,0,3,0,0,0,0,3
Kent,RWFR,M,1,0,0,0,0,0,1
Kent,SA,F,1,1,3,1,1,21,28
Kent,SA,M,0,0,2,0,0,0,2
Kent,SAX,F,159,119,56,3,13,120,470
Kent,SAX,M,148,89,3,0,0,5,245
Kent,SD,F,39,55,37,49,24,159,363
Kent,SD,M,40,38,9,0,2,6,95
Kent,SDX,F,82,35,36,44,28,82,307
Kent,SDX,M,64,26,1,2,0,1,94
Kent,SH,F,1,2,4,2,0,3,12
Kent,SH,M,5,1,0,3,0,1,10
Kent,SHO,F,1,5,1,1,2,14,24
Kent,SHO,M,1,0,0,1,1,1,4
Kent,SHOX,F,6,5,2,7,4,10,34
Kent,SHOX,M,4,3,1,0,0,2,10
Kent,SHX,F,0,0,1,0,0,2,3
Kent,SHX,M,1,1,0,0,0,0,2
Kent,SM,F,116,78,59,73,49,372,747
Kent,SM,M,125,76,16,15,16,52,300
Kent,SMX,F,"1,108",855,345,244,289,"1,395","4,236"
Kent,SMX,M,995,605,122,6,8,125,"1,861"
Kent,SOB,F,0,0,0,0,0,2,2
Kent,SOBX,F,0,0,0,0,1,5,6
Kent,SRW,F,0,2,0,0,0,0,2
Kent,SRW,M,0,1,0,0,0,0,1
Kent,SRWX,F,23,20,25,20,9,0,97
Kent,SRWX,M,27,5,0,0,0,0,32
Kent,ST,M,0,3,1,0,0,0,4
Kent,STX,F,38,0,0,0,0,0,38
Kent,STX,M,21,0,1,0,0,0,22
Kent,SU,F,416,418,242,156,143,978,"2,353"
Kent,SU,M,400,357,68,21,11,81,938
Kent,SUX,F,390,225,108,109,109,543,"1,484"
Kent,SUX,M,397,190,16,2,4,33,642
Kent,WB,F,0,0,0,0,1,7,8
Kent,WBX,F,0,0,0,0,1,7,8
Kent,WP,F,3,1,4,2,1,10,21
Kent,WP,M,1,3,0,1,0,2,7
Kent,WPX,F,1,0,0,0,0,2,3
Kent,WPX,M,2,0,0,0,0,0,2
Kent,WSX,F,0,0,0,0,0,2,2
Kent,ZE,M,0,0,0,1,1,0,2
Lancashire,AA,F,456,340,125,97,61,512,"1,591"
Lancashire,AA,M,451,281,51,22,17,68,890
Lancashire,AAX,F,"1,577","1,238",380,234,204,"1,133","4,766"
Lancashire,AAX,M,"1,602","1,023",154,41,12,124,"2,956"
Lancashire,AR,F,1,2,0,0,0,0,3
Lancashire,ARX,F,2,0,0,0,0,0,2
Lancashire,ARX,M,1,1,0,0,0,0,2
Lancashire,AY,F,151,113,156,138,133,391,"1,082"
Lancashire,AY,M,24,4,2,1,1,3,35
Lancashire,AYX,F,23,21,28,19,19,20,130
Lancashire,AYX,M,6,0,2,1,0,4,13
Lancashire,BA,F,54,78,35,19,21,91,298
Lancashire,BA,M,45,64,17,12,13,46,197
Lancashire,BABX,F,0,0,0,0,0,11,11
Lancashire,BABX,M,0,0,0,0,0,1,1
Lancashire,BAL,F,27,18,11,13,7,56,132
Lancashire,BAL,M,16,19,0,0,0,0,35
Lancashire,BALX,F,0,3,2,1,1,3,10
Lancashire,BALX,M,4,2,0,0,0,1,7
Lancashire,BARX,F,0,0,0,0,0,10,10
Lancashire,BARX,M,0,0,0,0,0,1,1
Lancashire,BAWX,F,0,0,0,0,0,4,4
Lancashire,BAX,F,791,597,152,77,92,606,"2,315"
Lancashire,BAX,M,768,354,77,8,4,106,"1,317"
Lancashire,BAZ,F,12,14,5,15,2,20,68
Lancashire,BAZ,M,13,9,0,1,5,5,33
Lancashire,BAZX,F,95,55,9,0,1,2,162
Lancashire,BAZX,M,88,22,2,0,0,0,112
Lancashire,BB,F,419,328,147,110,88,557,"1,649"
Lancashire,BB,M,414,223,68,34,15,168,922
Lancashire,BBX,F,"3,448","2,650",858,583,514,"1,884","9,937"
Lancashire,BBX,M,"3,217","1,905",263,34,30,349,"5,798"
Lancashire,BF,F,"1,697","1,722","2,211","2,155","2,257","3,196","13,238"
Lancashire,BF,M,"1,200",843,354,67,40,46,"2,550"
Lancashire,BFX,F,137,168,122,131,120,199,877
Lancashire,BFX,M,112,44,17,2,4,2,181
Lancashire,BG,F,25,31,18,6,7,31,118
Lancashire,BG,M,25,20,6,1,0,6,58
Lancashire,BGX,F,6,7,4,5,7,15,44
Lancashire,BGX,M,7,8,0,0,0,0,15
Lancashire,BH,F,27,0,0,0,0,388,415
Lancashire,BH,M,8,0,0,0,0,1,9
Lancashire,BHX,F,1,0,0,0,0,128,129
Lancashire,BHX,M,1,0,0,0,0,0,1
Lancashire,BI,M,1,0,0,0,0,0,1
Lancashire,BLG,F,2,8,3,15,9,25,62
Lancashire,BLG,M,0,1,7,0,0,0,8
Lancashire,BP,F,0,0,0,1,0,0,1
Lancashire,BRX,F,1,2,1,1,0,1,6
Lancashire,BRX,M,1,1,0,0,0,1,3
Lancashire,BS,F,56,56,53,36,19,77,297
Lancashire,BS,M,27,13,0,3,0,6,49
Lancashire,BSH,F,22,28,18,14,9,23,114
Lancashire,BSH,M,28,15,3,4,2,1,53
Lancashire,BSHO,F,0,0,0,0,0,1,1
Lancashire,BSHX,F,60,24,11,5,7,21,128
Lancashire,BSHX,M,48,14,3,0,0,0,65
Lancashire,BSX,F,98,90,84,64,52,81,469
Lancashire,BSX,M,29,31,14,3,0,2,79
Lancashire,BW,F,18,23,28,6,9,29,113
Lancashire,BW,M,15,6,2,3,0,0,26
Lancashire,BWX,F,2,1,1,0,0,4,8
Lancashire,BWX,M,1,2,0,0,1,0,4
Lancashire,CAX,F,0,0,0,0,0,2,2
Lancashire,CB,F,0,1,0,0,0,16,17
Lancashire,CD,F,0,1,0,0,0,8,9
Lancashire,CH,F,130,154,73,69,50,380,856
Lancashire,CH,M,129,82,25,19,20,89,364
Lancashire,CHI,M,0,0,0,0,1,0,1
Lancashire,CHIX,F,20,14,0,0,0,1,35
Lancashire,CHIX,M,27,18,0,0,0,1,46
Lancashire,CHL,M,0,1,0,0,0,0,1
Lancashire,CHX,F,842,864,177,118,114,717,"2,832"
Lancashire,CHX,M,767,522,96,10,4,202,"1,601"
Lancashire,DEV,F,0,1,0,0,1,10,12
Lancashire,DEV,M,1,3,0,0,0,0,4
Lancashire,DEVX,F,1,3,2,1,5,22,34
Lancashire,DEVX,M,1,16,1,1,0,1,20
Lancashire,DEX,F,13,16,24,7,4,42,106
Lancashire,DEX,M,25,11,12,1,1,3,53
Lancashire,DEXX,F,3,1,2,1,2,4,13
Lancashire,DEXX,M,2,1,0,0,0,0,3
Lancashire,DGX,F,0,0,0,0,0,2,2
Lancashire,DR,F,0,1,0,1,1,0,3
Lancashire,DRX,M,2,0,0,0,0,0,2
Lancashire,DS,F,20,12,9,4,3,23,71
Lancashire,DS,M,7,3,1,0,0,1,12
Lancashire,DSHO,F,0,0,0,0,0,1,1
Lancashire,DSX,F,12,23,23,5,2,1,66
Lancashire,DSX,M,2,4,1,0,0,0,7
Lancashire,DV,F,0,0,0,0,0,10,10
Lancashire,DVX,F,0,0,0,0,0,4,4
Lancashire,EPX,F,0,0,1,1,0,1,3
Lancashire,FR,F,0,0,0,0,0,"14,024","14,024"
Lancashire,FR,M,0,0,0,0,0,545,545
Lancashire,FRX,F,0,0,0,0,0,450,450
Lancashire,FRX,M,0,0,0,0,0,108,108
Lancashire,GA,F,10,2,11,4,0,42,69
Lancashire,GA,M,10,5,0,0,0,2,17
Lancashire,GAS,F,0,0,13,0,0,10,23
Lancashire,GAS,M,0,0,0,0,0,3,3
Lancashire,GASX,F,8,33,6,11,0,29,87
Lancashire,GASX,M,12,30,1,0,0,0,43
Lancashire,GAX,F,7,15,6,0,1,22,51
Lancashire,GAX,M,5,7,2,0,0,2,16
Lancashire,GB,F,0,0,0,0,0,1,1
Lancashire,GBX,F,2,1,0,0,0,1,4
Lancashire,GBX,M,3,1,0,0,0,0,4
Lancashire,GE,F,8,5,6,4,3,19,45
Lancashire,GE,M,2,2,0,0,1,2,7
Lancashire,GEX,F,37,12,1,0,4,24,78
Lancashire,GEX,M,35,10,0,0,0,2,47
Lancashire,GL,F,1,1,0,0,1,3,6
Lancashire,GL,M,2,0,0,0,0,0,2
Lancashire,GLX,M,2,0,0,0,0,0,2
Lancashire,GU,F,1,0,0,0,0,1,2
Lancashire,GUX,F,0,0,1,3,2,1,7
Lancashire,H,F,0,0,0,0,0,106,106
Lancashire,H,M,0,0,0,0,0,17,17
Lancashire,HE,F,121,108,55,45,26,106,461
Lancashire,HE,M,136,76,33,17,13,10,285
Lancashire,HEBL,F,0,0,0,0,0,4,4
Lancashire,HEBLX,F,0,0,0,0,0,36,36
Lancashire,HER,F,0,0,0,0,0,17,17
Lancashire,HERX,F,0,0,0,0,0,20,20
Lancashire,HERX,M,0,0,0,0,0,1,1
Lancashire,HEX,F,696,621,227,83,88,287,"2,002"
Lancashire,HEX,M,659,573,97,13,2,24,"1,368"
Lancashire,HF,F,"13,209","12,755","13,557","11,726","10,040","17,552","78,839"
Lancashire,HF,M,"4,666","2,308",808,164,65,144,"8,155"
Lancashire,HFX,F,747,686,654,641,608,"1,053","4,389"
Lancashire,HFX,M,361,146,33,11,5,10,566
Lancashire,HI,F,56,62,40,33,22,158,371
Lancashire,HI,M,48,47,32,14,3,15,159
Lancashire,HIX,F,8,7,3,3,0,25,46
Lancashire,HIX,M,10,4,1,0,0,0,15
Lancashire,HL,F,0,0,0,0,0,10,10
Lancashire,HLX,F,0,0,0,0,0,1,1
Lancashire,HO,F,"1,965","1,832","1,847","1,827","1,625","2,683","11,779"
Lancashire,HO,M,537,219,112,36,24,67,995
Lancashire,HOX,F,81,118,266,233,128,303,"1,129"
Lancashire,HOX,M,33,4,4,0,1,1,43
Lancashire,HX,F,0,0,0,0,0,195,195
Lancashire,HX,M,0,0,0,0,0,68,68
Lancashire,IM,F,0,0,1,2,0,0,3
Lancashire,IM,M,1,0,1,0,0,0,2
Lancashire,IMX,M,1,0,0,0,0,0,1
Lancashire,JE,F,175,142,170,121,102,227,937
Lancashire,JE,M,18,7,3,2,1,2,33
Lancashire,JEX,F,51,34,63,83,29,24,284
Lancashire,JEX,M,5,4,2,0,0,1,12
Lancashire,JY,F,7,0,0,0,0,0,7
Lancashire,JY,M,2,0,0,0,0,0,2
Lancashire,KE,F,0,0,0,0,1,0,1
Lancashire,LH,F,14,11,9,10,7,21,72
Lancashire,LH,M,8,2,1,0,0,1,12
Lancashire,LHX,F,6,12,9,0,2,7,36
Lancashire,LHX,M,2,19,2,0,0,0,23
Lancashire,LI,F,0,0,0,0,0,263,263
Lancashire,LI,M,0,0,0,0,0,109,109
Lancashire,LIM,F,"1,201","1,007",477,291,267,851,"4,094"
Lancashire,LIM,M,"1,138",642,171,86,69,189,"2,295"
Lancashire,LIM X,F,0,0,0,0,0,1,1
Lancashire,LIMB,F,0,0,0,0,0,20,20
Lancashire,LIMBX,F,0,0,0,0,0,96,96
Lancashire,LIMBX,M,0,0,0,0,0,5,5
Lancashire,LIMR,F,0,0,0,0,0,25,25
Lancashire,LIMR,M,0,0,0,0,0,6,6
Lancashire,LIMRX,F,0,0,0,0,0,60,60
Lancashire,LIMRX,M,0,0,0,0,0,7,7
Lancashire,LIMX,F,"5,511","4,835","1,416",885,854,"2,806","16,307"
Lancashire,LIMX,M,"5,179","3,419",717,75,60,163,"9,613"
Lancashire,LIX,F,0,0,0,0,0,"1,098","1,098"
Lancashire,LIX,M,0,0,0,0,0,414,414
Lancashire,LM,F,0,0,0,0,0,23,23
Lancashire,LM,M,0,0,0,0,0,3,3
Lancashire,LMX,F,0,0,0,0,0,48,48
Lancashire,LR,F,5,20,18,1,17,10,71
Lancashire,LR,M,10,5,1,0,0,1,17
Lancashire,LRX,F,21,0,1,0,0,1,23
Lancashire,LRX,M,15,0,0,0,0,0,15
Lancashire,LU,F,12,0,2,0,0,14,28
Lancashire,LUX,F,0,0,0,0,0,15,15
Lancashire,MA,F,0,0,0,1,0,0,1
Lancashire,MAR,F,0,0,0,0,0,1,1
Lancashire,MAR,M,0,0,0,0,0,1,1
Lancashire,MARX,F,0,0,0,0,0,3,3
Lancashire,MARX,M,0,0,0,0,0,1,1
Lancashire,MG,F,12,7,15,10,10,50,104
Lancashire,MG,M,16,3,0,0,0,3,22
Lancashire,MGX,F,1,7,0,0,0,12,20
Lancashire,MGX,M,0,5,1,0,0,0,6
Lancashire,MO,F,6,6,10,12,2,9,45
Lancashire,MO,M,5,5,2,0,0,0,12
Lancashire,MOX,F,183,145,33,31,8,5,405
Lancashire,MOX,M,168,122,1,0,0,0,291
Lancashire,MRI,F,32,37,31,23,25,119,267
Lancashire,MRI,M,29,21,4,2,1,10,67
Lancashire,MRIX,F,11,11,13,28,50,124,237
Lancashire,MRIX,M,18,4,1,0,0,6,29
Lancashire,ND,F,0,0,0,0,0,5,5
Lancashire,NDX,F,0,0,0,0,0,2,2
Lancashire,NO,F,0,0,5,1,0,0,6
Lancashire,NOX,F,0,0,0,8,0,1,9
Lancashire,NR,F,5,0,0,0,0,0,5
Lancashire,NR,M,3,0,0,0,0,0,3
Lancashire,NRX,F,60,0,0,0,1,1,62
Lancashire,NRX,M,24,0,0,0,0,0,24
Lancashire,NS,F,0,0,0,0,0,831,831
Lancashire,NS,M,0,0,0,0,0,2,2
Lancashire,OB,F,0,0,0,0,0,1,1
Lancashire,OO,F,0,0,0,0,0,2,2
Lancashire,PA,F,3,0,7,0,0,5,15
Lancashire,PA,M,1,2,0,1,0,2,6
Lancashire,PAX,F,33,22,2,1,0,2,60
Lancashire,PAX,M,27,27,0,0,0,1,55
Lancashire,PI,F,4,2,4,4,0,21,35
Lancashire,PI,M,3,3,0,2,0,12,20
Lancashire,PIX,F,28,33,14,15,4,43,137
Lancashire,PIX,M,20,18,2,4,0,21,65
Lancashire,ROT,F,0,0,0,0,0,7,7
Lancashire,ROTX,F,0,0,0,0,0,3,3
Lancashire,RP,F,28,31,2,2,17,29,109
Lancashire,RP,M,27,8,0,1,1,1,38
Lancashire,RPX,F,9,2,1,1,2,3,18
Lancashire,RPX,M,7,8,0,1,0,1,17
Lancashire,RWFR,F,0,0,0,0,0,6,6
Lancashire,RWFR,M,1,0,0,0,0,0,1
Lancashire,SA,F,35,35,17,13,28,90,218
Lancashire,SA,M,29,18,3,3,1,33,87
Lancashire,SAX,F,27,69,23,61,17,160,357
Lancashire,SAX,M,29,103,19,18,1,21,191
Lancashire,SBX,F,0,0,0,0,1,0,1
Lancashire,SBX,M,1,0,0,0,0,0,1
Lancashire,SD,F,53,54,8,22,5,30,172
Lancashire,SD,M,47,39,3,0,1,2,92
Lancashire,SDX,F,20,23,18,5,6,22,94
Lancashire,SDX,M,20,24,1,0,0,1,46
Lancashire,SG,M,1,0,0,0,0,0,1
Lancashire,SH,F,0,1,0,0,0,0,1
Lancashire,SH,M,2,0,0,0,1,0,3
Lancashire,SHO,F,29,25,19,16,8,70,167
Lancashire,SHO,M,34,38,5,3,0,3,83
Lancashire,SHOX,F,20,28,9,16,13,34,120
Lancashire,SHOX,M,25,29,2,0,0,4,60
Lancashire,SHX,F,0,1,0,0,0,6,7
Lancashire,SM,F,190,168,51,69,42,318,838
Lancashire,SM,M,150,115,32,15,17,96,425
Lancashire,SMX,F,"1,196",805,218,161,170,918,"3,468"
Lancashire,SMX,M,"1,142",612,90,10,10,194,"2,058"
Lancashire,SRW,F,14,2,9,9,0,0,34
Lancashire,SRW,M,12,3,0,0,0,0,15
Lancashire,SRWX,F,111,26,1,1,2,2,143
Lancashire,SRWX,M,90,36,1,0,0,0,127
Lancashire,STX,F,21,5,1,3,0,0,30
Lancashire,STX,M,11,12,0,0,0,0,23
Lancashire,SUX,F,0,0,5,3,2,3,13
Lancashire,SUX,M,0,0,0,0,0,1,1
Lancashire,WAX,F,0,3,0,0,0,0,3
Lancashire,WB,F,22,15,0,1,1,61,100
Lancashire,WB,M,5,5,0,0,0,6,16
Lancashire,WBX,F,32,34,17,2,7,70,162
Lancashire,WBX,M,28,21,4,1,0,3,57
Lancashire,WG,F,0,3,0,0,3,2,8
Lancashire,WG,M,0,1,0,0,0,1,2
Lancashire,WGX,M,0,0,0,0,0,1,1
Lancashire,WP,F,5,4,7,2,1,15,34
Lancashire,WP,M,5,3,0,0,0,2,10
Lancashire,WPX,F,1,0,0,0,0,0,1
Lancashire,WPX,M,0,1,0,0,0,0,1
Lancashire,WS,F,0,0,2,0,0,0,2
Lancashire,WS,M,0,1,0,0,1,0,2
Lancashire,WSX,F,3,0,1,4,6,14,28
Lancashire,WSX,M,1,12,2,0,1,0,16
Lancashire,ZE,M,0,0,0,1,0,0,1
Leicestershire,AA,F,95,97,39,29,36,175,471
Leicestershire,AA,M,130,207,39,16,9,46,447
Leicestershire,AAX,F,"1,000",718,327,150,105,540,"2,840"
Leicestershire,AAX,M,"1,047","1,128",216,4,8,58,"2,461"
Leicestershire,AR,F,0,0,0,0,0,1,1
Leicestershire,ARX,F,2,0,0,0,0,0,2
Leicestershire,AY,F,61,44,43,46,63,97,354
Leicestershire,AY,M,24,8,3,2,0,3,40
Leicestershire,AYX,F,3,5,6,7,3,3,27
Leicestershire,AYX,M,4,2,0,0,0,0,6
Leicestershire,BA,F,59,48,48,42,21,151,369
Leicestershire,BA,M,44,48,29,8,8,45,182
Leicestershire,BAB,M,0,0,0,0,0,1,1
Leicestershire,BABX,F,0,0,0,0,0,17,17
Leicestershire,BAL,F,0,1,1,1,2,6,11
Leicestershire,BAL,M,0,1,2,0,0,1,4
Leicestershire,BALX,F,12,0,4,0,1,2,19
Leicestershire,BALX,M,15,1,2,0,0,0,18
Leicestershire,BAR,F,0,0,0,0,0,1,1
Leicestershire,BARX,F,0,0,0,0,0,22,22
Leicestershire,BAW,F,0,0,0,0,0,1,1
Leicestershire,BAW,M,0,0,0,0,0,1,1
Leicestershire,BAWX,F,0,0,0,0,0,2,2
Leicestershire,BAX,F,818,874,300,164,116,576,"2,848"
Leicestershire,BAX,M,776,723,153,12,4,53,"1,721"
Leicestershire,BAZ,F,26,36,37,16,15,55,185
Leicestershire,BAZ,M,33,14,6,4,2,10,69
Leicestershire,BAZ X,F,0,0,0,0,0,3,3
Leicestershire,BAZX,F,129,98,46,39,35,76,423
Leicestershire,BAZX,M,128,79,6,0,1,1,215
Leicestershire,BB,F,72,98,61,17,10,148,406
Leicestershire,BB,M,103,113,29,5,9,33,292
Leicestershire,BBX,F,"1,116","1,066",321,134,109,454,"3,200"
Leicestershire,BBX,M,"1,275","1,052",315,12,3,48,"2,705"
Leicestershire,BEL,F,0,0,0,0,0,12,12
Leicestershire,BF,F,617,677,755,706,766,"1,540","5,061"
Leicestershire,BF,M,757,564,174,28,12,21,"1,556"
Leicestershire,BFX,F,56,11,12,10,27,55,171
Leicestershire,BFX,M,111,41,19,2,4,1,178
Leicestershire,BG,F,5,3,2,6,2,4,22
Leicestershire,BG,M,2,3,1,0,0,4,10
Leicestershire,BGX,F,1,0,0,1,0,1,3
Leicestershire,BGX,M,1,5,0,0,0,0,6
Leicestershire,BH,F,8,0,0,0,0,202,210
Leicestershire,BH,M,2,0,0,0,0,19,21
Leicestershire,BHX,F,0,0,0,0,0,32,32
Leicestershire,BI,F,0,12,12,0,0,26,50
Leicestershire,BI,M,0,8,8,0,1,5,22
Leicestershire,BLG,F,0,0,1,0,0,0,1
Leicestershire,BLG,M,0,0,0,0,0,1,1
Leicestershire,BLGX,M,0,0,1,0,0,0,1
Leicestershire,BRX,F,2,0,0,1,0,1,4
Leicestershire,BRX,M,0,1,0,0,0,0,1
Leicestershire,BS,F,11,2,10,8,3,21,55
Leicestershire,BS,M,6,4,3,0,0,0,13
Leicestershire,BSH,F,51,37,11,1,2,13,115
Leicestershire,BSH,M,78,81,4,0,2,2,167
Leicestershire,BSHX,F,9,7,7,5,4,8,40
Leicestershire,BSHX,M,15,15,10,0,0,1,41
Leicestershire,BSX,F,46,26,4,37,12,73,198
Leicestershire,BSX,M,49,26,1,0,0,1,77
Leicestershire,BW,F,20,13,11,7,4,37,92
Leicestershire,BW,M,14,12,1,2,1,7,37
Leicestershire,BWB,M,0,0,1,0,0,0,1
Leicestershire,BWX,F,10,9,4,0,6,18,47
Leicestershire,BWX,M,8,6,0,0,0,0,14
Leicestershire,CAX,M,0,0,0,0,0,1,1
Leicestershire,CB,F,6,2,1,3,3,12,27
Leicestershire,CB,M,0,1,3,0,2,1,7
Leicestershire,CD,F,0,0,0,0,1,3,4
Leicestershire,CH,F,260,271,138,108,109,794,"1,680"
Leicestershire,CH,M,229,262,96,17,16,90,710
Leicestershire,CHI,F,0,0,0,0,0,1,1
Leicestershire,CHIX,F,0,0,0,0,0,1,1
Leicestershire,CHIX,M,1,0,0,0,0,0,1
Leicestershire,CHL,F,1,0,0,0,0,0,1
Leicestershire,CHL,M,1,0,0,0,0,0,1
Leicestershire,CHX,F,942,"1,481",395,160,145,"1,284","4,407"
Leicestershire,CHX,M,"1,088","1,756",419,29,26,113,"3,431"
Leicestershire,CON,F,0,0,0,0,0,4,4
Leicestershire,CON,M,0,0,0,0,0,2,2
Leicestershire,DE,F,0,0,0,0,0,1,1
Leicestershire,DEV,F,3,3,11,1,1,15,34
Leicestershire,DEV,M,3,1,0,0,0,1,5
Leicestershire,DEVX,F,16,6,1,8,6,17,54
Leicestershire,DEVX,M,19,17,2,0,0,1,39
Leicestershire,DEX,F,103,86,68,45,44,157,503
Leicestershire,DEX,M,98,67,17,5,2,16,205
Leicestershire,DEXX,F,1,7,2,1,2,4,17
Leicestershire,DEXX,M,3,7,1,0,0,0,11
Leicestershire,DS,F,1,1,5,2,1,3,13
Leicestershire,DS,M,9,0,0,0,0,0,9
Leicestershire,DSHO,M,1,0,0,0,0,0,1
Leicestershire,DSX,F,1,0,0,1,1,5,8
Leicestershire,DSX,M,3,1,0,0,0,0,4
Leicestershire,DV,F,0,0,0,0,0,51,51
Leicestershire,DV,M,0,0,0,0,0,1,1
Leicestershire,DVX,F,0,0,0,0,0,18,18
Leicestershire,DVX,M,0,0,0,0,0,2,2
Leicestershire,FR,F,0,0,0,0,0,"5,132","5,132"
Leicestershire,FR,M,0,0,0,0,0,349,349
Leicestershire,FRX,F,0,0,0,0,0,129,129
Leicestershire,FRX,M,0,0,0,0,0,16,16
Leicestershire,GA,F,0,0,1,0,0,2,3
Leicestershire,GA,M,0,1,0,0,0,0,1
Leicestershire,GASX,M,1,0,0,0,0,0,1
Leicestershire,GAX,F,0,2,0,2,0,3,7
Leicestershire,GAX,M,2,6,1,0,0,0,9
Leicestershire,GBX,F,0,0,0,1,0,0,1
Leicestershire,GBX,M,0,1,0,0,0,0,1
Leicestershire,GE,F,0,0,0,2,1,14,17
Leicestershire,GE,M,0,1,0,0,0,4,5
Leicestershire,GEX,F,1,1,0,1,3,41,47
Leicestershire,GEX,M,1,2,0,0,0,2,5
Leicestershire,GL,F,1,1,2,0,1,7,12
Leicestershire,GL,M,2,0,1,0,0,0,3
Leicestershire,GLX,F,0,1,2,0,0,0,3
Leicestershire,GLX,M,1,1,0,0,0,0,2
Leicestershire,GU,F,12,10,8,2,8,27,67
Leicestershire,GU,M,9,5,2,0,0,0,16
Leicestershire,GY,M,3,0,0,0,0,0,3
Leicestershire,H,F,0,0,0,0,0,78,78
Leicestershire,H,M,0,0,0,0,0,21,21
Leicestershire,HE,F,127,144,81,49,48,185,634
Leicestershire,HE,M,116,196,53,14,10,15,404
Leicestershire,HEBL,F,0,0,0,0,0,7,7
Leicestershire,HEBLX,F,0,0,0,0,0,34,34
Leicestershire,HEBR,F,0,0,0,0,0,1,1
Leicestershire,HER,F,0,0,0,0,0,13,13
Leicestershire,HER,M,0,0,0,0,0,1,1
Leicestershire,HERX,F,0,0,0,0,0,10,10
Leicestershire,HERX,M,0,0,0,0,0,3,3
Leicestershire,HEX,F,515,514,250,137,107,503,"2,026"
Leicestershire,HEX,M,490,494,139,47,3,18,"1,191"
Leicestershire,HF,F,"3,725","3,468","3,735","3,385","2,753","5,454","22,520"
Leicestershire,HF,M,"2,367","1,465",535,51,25,73,"4,516"
Leicestershire,HFX,F,128,116,139,138,106,208,835
Leicestershire,HFX,M,165,66,7,1,1,5,245
Leicestershire,HI,F,10,9,8,5,9,41,82
Leicestershire,HI,M,13,4,4,3,3,7,34
Leicestershire,HIX,F,5,4,0,4,1,3,17
Leicestershire,HIX,M,4,2,6,1,0,0,13
Leicestershire,HL,F,0,0,0,0,0,3,3
Leicestershire,HO,F,605,736,831,764,594,991,"4,521"
Leicestershire,HO,M,267,153,52,15,6,14,507
Leicestershire,HOX,F,55,69,42,23,18,116,323
Leicestershire,HOX,M,52,45,0,0,0,1,98
Leicestershire,HX,F,0,0,0,0,0,232,232
Leicestershire,HX,M,0,0,0,0,0,37,37
Leicestershire,IM,F,0,0,0,0,1,0,1
Leicestershire,IM,M,1,0,0,0,0,0,1
Leicestershire,JE,F,75,85,68,80,46,260,614
Leicestershire,JE,M,3,3,4,0,0,2,12
Leicestershire,JEX,F,49,42,55,24,11,2,183
Leicestershire,JEX,M,13,15,5,0,0,0,33
Leicestershire,JY,F,32,0,0,0,0,1,33
Leicestershire,JY,M,1,0,0,0,0,0,1
Leicestershire,JYX,F,1,0,0,0,0,0,1
Leicestershire,KE,M,0,0,2,0,0,0,2
Leicestershire,LH,F,126,123,103,70,67,197,686
Leicestershire,LH,M,135,110,26,7,3,12,293
Leicestershire,LHX,F,45,42,13,13,23,18,154
Leicestershire,LHX,M,35,42,2,2,1,1,83
Leicestershire,LI,F,0,0,0,0,0,173,173
Leicestershire,LI,M,0,0,0,0,0,55,55
Leicestershire,LIM,F,608,618,216,108,146,463,"2,159"
Leicestershire,LIM,M,629,618,140,45,26,90,"1,548"
Leicestershire,LIM X,F,0,0,0,0,0,1,1
Leicestershire,LIMB,F,0,0,0,0,0,7,7
Leicestershire,LIMB,M,0,0,0,0,0,1,1
Leicestershire,LIMBX,F,0,0,0,0,0,69,69
Leicestershire,LIMBX,M,0,0,0,0,0,7,7
Leicestershire,LIMR,F,0,0,0,0,0,14,14
Leicestershire,LIMR,M,0,0,0,0,0,4,4
Leicestershire,LIMRX,F,0,0,0,0,0,71,71
Leicestershire,LIMRX,M,0,0,0,0,0,5,5
Leicestershire,LIMX,F,"3,140","3,068",848,403,485,"1,208","9,152"
Leicestershire,LIMX,M,"3,295","3,498",639,38,21,61,"7,552"
Leicestershire,LIX,F,0,0,0,0,0,507,507
Leicestershire,LIX,M,0,0,0,0,0,114,114
Leicestershire,LM,F,0,0,0,0,0,12,12
Leicestershire,LM,M,0,0,0,0,0,2,2
Leicestershire,LMX,F,0,0,0,0,0,16,16
Leicestershire,LMX,M,0,0,0,0,0,1,1
Leicestershire,LR,F,23,22,9,6,15,39,114
Leicestershire,LR,M,28,18,4,1,1,4,56
Leicestershire,LRX,F,35,65,33,10,9,7,159
Leicestershire,LRX,M,36,26,7,2,0,0,71
Leicestershire,LUX,F,0,2,0,0,0,0,2
Leicestershire,LUX,M,0,5,0,0,0,0,5
Leicestershire,MA,F,0,0,0,0,0,3,3
Leicestershire,MAR,M,0,0,0,0,0,1,1
Leicestershire,MARX,F,2,0,0,0,0,0,2
Leicestershire,MAX,F,1,2,0,0,0,6,9
Leicestershire,MAX,M,1,0,0,0,0,0,1
Leicestershire,MG,F,4,4,2,0,2,9,21
Leicestershire,MG,M,4,5,2,0,1,0,12
Leicestershire,MGX,F,2,5,0,0,0,3,10
Leicestershire,MGX,M,1,7,1,0,0,0,9
Leicestershire,MO,F,18,28,32,27,16,49,170
Leicestershire,MO,M,12,7,11,0,0,2,32
Leicestershire,MOX,F,88,51,91,51,29,73,383
Leicestershire,MOX,M,64,24,10,0,0,0,98
Leicestershire,MRI,F,46,50,26,32,21,71,246
Leicestershire,MRI,M,49,59,14,1,0,4,127
Leicestershire,MRIX,F,15,23,24,6,5,60,133
Leicestershire,MRIX,M,13,4,2,0,0,0,19
Leicestershire,ND,F,0,0,0,0,0,2,2
Leicestershire,NO,F,4,1,3,0,0,0,8
Leicestershire,NO,M,0,0,0,0,0,1,1
Leicestershire,NOX,F,0,1,0,0,0,3,4
Leicestershire,NOX,M,0,2,0,0,0,0,2
Leicestershire,NRX,F,11,0,0,0,0,0,11
Leicestershire,NRX,M,12,0,0,0,0,0,12
Leicestershire,NS,F,0,0,0,0,0,424,424
Leicestershire,NS,M,0,0,0,0,0,1,1
Leicestershire,OB,F,0,0,0,0,0,6,6
Leicestershire,OEX,F,0,1,0,0,0,1,2
Leicestershire,PA,M,0,0,1,0,0,0,1
Leicestershire,PAX,F,0,1,0,0,0,1,2
Leicestershire,PAX,M,1,0,0,0,0,0,1
Leicestershire,PI,F,2,0,1,2,1,10,16
Leicestershire,PI,M,0,3,1,1,0,4,9
Leicestershire,PIX,F,90,50,21,8,3,11,183
Leicestershire,PIX,M,80,46,18,3,0,4,151
Leicestershire,RO,F,0,0,0,0,0,3,3
Leicestershire,ROX,F,1,6,0,0,1,10,18
Leicestershire,ROX,M,0,0,0,0,0,3,3
Leicestershire,RP,F,26,21,6,7,9,56,125
Leicestershire,RP,M,30,11,0,1,0,1,43
Leicestershire,RPX,F,3,10,0,0,0,4,17
Leicestershire,RPX,M,2,14,0,0,0,0,16
Leicestershire,RWFR,F,0,0,0,0,0,4,4
Leicestershire,SA,F,13,20,6,4,4,54,101
Leicestershire,SA,M,13,19,11,1,0,6,50
Leicestershire,SAX,F,209,254,51,26,24,146,710
Leicestershire,SAX,M,192,173,30,2,0,15,412
Leicestershire,SBX,F,0,1,0,0,0,0,1
Leicestershire,SBX,M,1,1,0,0,0,0,2
Leicestershire,SD,F,261,200,121,123,82,320,"1,107"
Leicestershire,SD,M,239,142,29,13,6,21,450
Leicestershire,SDX,F,189,171,84,46,35,104,629
Leicestershire,SDX,M,208,115,18,0,0,2,343
Leicestershire,SGX,M,0,1,0,0,0,0,1
Leicestershire,SH,F,9,3,6,0,8,5,31
Leicestershire,SH,M,6,5,1,1,0,0,13
Leicestershire,SHO,F,5,6,3,3,2,51,70
Leicestershire,SHO,M,8,20,2,0,0,3,33
Leicestershire,SHOX,F,4,11,14,2,1,9,41
Leicestershire,SHOX,M,5,17,3,0,0,0,25
Leicestershire,SHX,F,1,1,1,0,0,2,5
Leicestershire,SHX,M,1,3,0,0,0,0,4
Leicestershire,SM,F,239,197,97,88,66,365,"1,052"
Leicestershire,SM,M,245,322,97,9,17,87,777
Leicestershire,SMX,F,"1,510","1,436",540,381,295,"1,891","6,053"
Leicestershire,SMX,M,"1,905","1,648",467,30,9,142,"4,201"
Leicestershire,SRW,F,2,0,0,1,0,0,3
Leicestershire,SRW,M,0,1,1,0,0,0,2
Leicestershire,SRWX,F,18,4,2,4,7,0,35
Leicestershire,SRWX,M,33,6,0,0,0,0,39
Leicestershire,ST,M,0,0,1,0,0,0,1
Leicestershire,STX,F,16,0,0,0,0,1,17
Leicestershire,STX,M,14,3,0,0,0,0,17
Leicestershire,SU,F,0,0,1,0,2,7,10
Leicestershire,SU,M,7,6,0,0,0,0,13
Leicestershire,SUX,F,4,7,6,3,0,8,28
Leicestershire,SUX,M,0,10,4,0,0,0,14
Leicestershire,TB,M,0,0,0,0,0,1,1
Leicestershire,TBX,F,1,0,0,9,6,10,26
Leicestershire,TBX,M,1,1,0,0,0,0,2
Leicestershire,WB,F,9,7,0,0,1,10,27
Leicestershire,WB,M,5,17,0,0,0,0,22
Leicestershire,WBX,F,4,10,1,0,0,14,29
Leicestershire,WBX,M,2,24,1,0,0,2,29
Leicestershire,WG,F,0,0,0,1,0,0,1
Leicestershire,WG,M,1,0,0,0,0,0,1
Leicestershire,WP,F,10,6,1,9,6,25,57
Leicestershire,WP,M,11,10,2,1,0,0,24
Leicestershire,WPX,F,0,0,0,1,4,7,12
Leicestershire,WSX,M,0,0,0,0,6,0,6
Leicestershire,ZE,M,0,0,0,0,0,1,1
Lincolnshire,AA,F,184,191,60,59,59,315,868
Lincolnshire,AA,M,195,357,51,12,5,28,648
Lincolnshire,AAX,F,625,554,165,173,111,570,"2,198"
Lincolnshire,AAX,M,743,"1,230",271,7,2,19,"2,272"
Lincolnshire,AR,M,0,2,0,0,0,0,2
Lincolnshire,ARX,F,0,0,0,1,0,0,1
Lincolnshire,AY,F,3,7,5,1,2,7,25
Lincolnshire,AY,M,4,8,2,0,0,0,14
Lincolnshire,AYX,F,5,0,0,1,0,1,7
Lincolnshire,AYX,M,3,3,0,0,0,0,6
Lincolnshire,BA,F,221,149,76,55,58,316,875
Lincolnshire,BA,M,185,62,9,13,17,53,339
Lincolnshire,BABX,F,0,0,0,0,0,8,8
Lincolnshire,BAL,F,0,0,0,1,1,2,4
Lincolnshire,BARX,F,0,0,0,0,0,8,8
Lincolnshire,BARX,M,0,0,0,0,0,1,1
Lincolnshire,BAWX,F,0,0,0,0,0,3,3
Lincolnshire,BAX,F,794,648,233,120,158,889,"2,842"
Lincolnshire,BAX,M,860,518,79,5,3,64,"1,529"
Lincolnshire,BAZ,F,10,0,2,0,0,1,13
Lincolnshire,BAZ,M,4,2,0,0,1,1,8
Lincolnshire,BAZ X,F,0,0,0,0,0,1,1
Lincolnshire,BAZX,F,45,24,2,12,23,42,148
Lincolnshire,BAZX,M,44,22,0,0,1,0,67
Lincolnshire,BB,F,143,85,34,42,40,188,532
Lincolnshire,BB,M,136,95,41,13,19,73,377
Lincolnshire,BBX,F,"1,546","1,272",334,303,182,721,"4,358"
Lincolnshire,BBX,M,"1,680","1,089",176,14,4,77,"3,040"
Lincolnshire,BF,F,221,288,379,307,273,497,"1,965"
Lincolnshire,BF,M,481,478,162,9,6,14,"1,150"
Lincolnshire,BFX,F,73,63,59,55,61,79,390
Lincolnshire,BFX,M,100,57,7,2,0,0,166
Lincolnshire,BG,F,7,13,3,0,0,18,41
Lincolnshire,BG,M,4,1,1,1,0,0,7
Lincolnshire,BGX,F,0,3,2,0,0,3,8
Lincolnshire,BGX,M,1,0,0,0,0,0,1
Lincolnshire,BH,F,4,0,0,0,0,48,52
Lincolnshire,BH,M,6,0,0,0,0,0,6
Lincolnshire,BHX,F,3,0,0,0,0,2,5
Lincolnshire,BHX,M,3,0,0,0,0,0,3
Lincolnshire,BI,M,1,0,0,0,0,0,1
Lincolnshire,BLG,F,10,0,0,9,0,4,23
Lincolnshire,BRX,F,0,1,0,0,0,0,1
Lincolnshire,BRX,M,0,1,0,0,0,0,1
Lincolnshire,BS,F,0,0,2,1,0,4,7
Lincolnshire,BS,M,5,0,1,0,0,0,6
Lincolnshire,BSH,F,1,5,4,7,1,13,31
Lincolnshire,BSH,M,7,5,1,0,2,0,15
Lincolnshire,BSHO,F,0,0,0,0,0,1,1
Lincolnshire,BSHX,F,14,9,2,1,1,10,37
Lincolnshire,BSHX,M,26,8,1,0,0,0,35
Lincolnshire,BSX,F,13,2,9,4,0,5,33
Lincolnshire,BSX,M,30,10,2,0,0,0,42
Lincolnshire,BU,F,0,0,0,0,0,5,5
Lincolnshire,BW,F,15,12,11,12,8,23,81
Lincolnshire,BW,M,16,13,4,0,1,0,34
Lincolnshire,BWX,F,16,4,0,0,1,10,31
Lincolnshire,BWX,M,19,10,2,0,0,0,31
Lincolnshire,BX,F,0,0,0,0,0,1,1
Lincolnshire,CAX,F,0,0,0,0,0,2,2
Lincolnshire,CB,F,1,0,0,0,1,20,22
Lincolnshire,CB,M,0,0,1,0,0,0,1
Lincolnshire,CH,F,252,228,104,63,70,607,"1,324"
Lincolnshire,CH,M,276,175,38,10,21,66,586
Lincolnshire,CHX,F,"1,475","1,197",263,193,241,"1,788","5,157"
Lincolnshire,CHX,M,"1,225","1,081",160,8,13,114,"2,601"
Lincolnshire,CON,F,0,0,0,0,0,2,2
Lincolnshire,DE,F,0,0,0,0,0,2,2
Lincolnshire,DEV,F,0,0,0,1,1,10,12
Lincolnshire,DEV,M,0,0,1,0,0,0,1
Lincolnshire,DEVX,F,7,8,5,4,1,17,42
Lincolnshire,DEVX,M,5,9,1,0,0,0,15
Lincolnshire,DEX,F,51,56,40,42,21,119,329
Lincolnshire,DEX,M,45,52,9,4,4,12,126
Lincolnshire,DEXX,F,9,4,6,0,8,6,33
Lincolnshire,DEXX,M,7,7,1,0,0,0,15
Lincolnshire,DRX,M,1,0,0,0,0,0,1
Lincolnshire,DS,F,0,1,0,0,1,2,4
Lincolnshire,DS,M,1,1,1,0,0,0,3
Lincolnshire,DSX,F,0,0,0,0,0,2,2
Lincolnshire,DSX,M,2,2,0,0,0,0,4
Lincolnshire,DV,F,0,0,0,0,0,15,15
Lincolnshire,DV,M,0,0,0,0,0,1,1
Lincolnshire,DVX,F,0,0,0,0,0,42,42
Lincolnshire,DVX,M,0,0,0,0,0,4,4
Lincolnshire,FR,F,0,0,0,0,0,"1,529","1,529"
Lincolnshire,FR,M,0,0,0,0,0,159,159
Lincolnshire,FRX,F,0,0,0,0,0,76,76
Lincolnshire,FRX,M,0,0,0,0,0,14,14
Lincolnshire,GA,F,2,1,0,0,0,0,3
Lincolnshire,GA,M,1,1,1,0,0,0,3
Lincolnshire,GASX,F,0,0,0,0,0,1,1
Lincolnshire,GASX,M,0,2,0,0,0,0,2
Lincolnshire,GAX,F,0,3,1,2,0,1,7
Lincolnshire,GAX,M,2,0,0,1,0,0,3
Lincolnshire,GB,F,1,0,0,0,0,0,1
Lincolnshire,GBX,M,0,1,0,0,0,0,1
Lincolnshire,GE,F,0,1,0,0,0,1,2
Lincolnshire,GE,M,0,3,0,0,0,0,3
Lincolnshire,GEX,F,0,1,0,0,0,1,2
Lincolnshire,GEX,M,0,2,0,0,0,0,2
Lincolnshire,GL,F,0,0,0,1,0,1,2
Lincolnshire,GL,M,0,1,0,0,0,0,1
Lincolnshire,GLX,F,0,1,0,0,0,0,1
Lincolnshire,GU,F,0,0,0,1,0,9,10
Lincolnshire,GUX,F,0,0,0,0,1,1,2
Lincolnshire,H,F,0,0,0,0,0,34,34
Lincolnshire,H,M,0,0,0,0,0,5,5
Lincolnshire,HE,F,30,19,24,24,32,58,187
Lincolnshire,HE,M,19,55,22,7,3,4,110
Lincolnshire,HEBL,F,0,0,0,0,0,4,4
Lincolnshire,HEBLX,F,0,0,0,0,0,40,40
Lincolnshire,HEBLX,M,0,0,0,0,0,1,1
Lincolnshire,HER,F,0,0,0,0,0,14,14
Lincolnshire,HERX,F,0,0,0,0,0,15,15
Lincolnshire,HEX,F,297,297,137,147,117,619,"1,614"
Lincolnshire,HEX,M,424,511,121,2,3,7,"1,068"
Lincolnshire,HF,F,"1,228","1,287","1,283","1,066",855,"1,550","7,269"
Lincolnshire,HF,M,"1,674","1,801",366,46,32,42,"3,961"
Lincolnshire,HFX,F,13,10,25,29,22,49,148
Lincolnshire,HFX,M,50,83,23,4,0,4,164
Lincolnshire,HI,F,16,22,4,6,15,69,132
Lincolnshire,HI,M,20,15,6,3,0,17,61
Lincolnshire,HIX,F,2,3,1,1,0,4,11
Lincolnshire,HIX,M,10,7,3,0,0,1,21
Lincolnshire,HL,F,0,0,0,0,0,6,6
Lincolnshire,HO,F,346,265,289,235,199,401,"1,735"
Lincolnshire,HO,M,295,223,22,8,1,14,563
Lincolnshire,HOX,F,3,2,0,2,0,1,8
Lincolnshire,HOX,M,18,18,5,0,0,0,41
Lincolnshire,HX,F,0,0,0,0,0,221,221
Lincolnshire,HX,M,0,0,0,0,0,22,22
Lincolnshire,IM,F,2,1,0,1,1,4,9
Lincolnshire,IM,M,7,1,0,0,0,1,9
Lincolnshire,IMX,F,0,1,2,0,0,0,3
Lincolnshire,IMX,M,0,2,0,0,0,0,2
Lincolnshire,JE,F,28,34,24,22,22,72,202
Lincolnshire,JE,M,28,0,16,1,0,4,49
Lincolnshire,JEX,F,18,6,3,0,0,2,29
Lincolnshire,JEX,M,13,3,27,0,0,0,43
Lincolnshire,JY,F,4,0,0,0,0,0,4
Lincolnshire,KE,F,0,0,0,0,0,1,1
Lincolnshire,LH,F,44,23,14,28,14,87,210
Lincolnshire,LH,M,53,29,6,4,3,7,102
Lincolnshire,LHX,F,40,39,10,5,4,18,116
Lincolnshire,LHX,M,34,34,5,0,0,0,73
Lincolnshire,LI,F,0,0,0,0,0,206,206
Lincolnshire,LI,M,0,0,0,0,0,49,49
Lincolnshire,LIM,F,673,536,214,183,164,628,"2,398"
Lincolnshire,LIM,M,696,488,110,45,43,101,"1,483"
Lincolnshire,LIMB,F,0,0,0,0,0,10,10
Lincolnshire,LIMB,M,0,0,0,0,0,1,1
Lincolnshire,LIMBX,F,0,0,0,0,0,50,50
Lincolnshire,LIMR,F,0,0,0,0,0,56,56
Lincolnshire,LIMR,M,0,0,0,0,0,8,8
Lincolnshire,LIMRX,F,0,0,0,0,0,54,54
Lincolnshire,LIMRX,M,0,0,0,0,0,3,3
Lincolnshire,LIMX,F,"3,410","3,126",904,470,418,"1,536","9,864"
Lincolnshire,LIMX,M,"3,641","3,572",583,23,16,59,"7,894"
Lincolnshire,LIX,F,0,0,0,0,0,485,485
Lincolnshire,LIX,M,0,0,0,0,0,67,67
Lincolnshire,LM,F,0,0,0,0,0,6,6
Lincolnshire,LM,M,0,0,0,0,0,3,3
Lincolnshire,LMX,F,0,0,0,0,0,19,19
Lincolnshire,LR,F,489,418,329,270,206,"1,145","2,857"
Lincolnshire,LR,M,483,193,50,14,14,35,789
Lincolnshire,LRX,F,178,197,124,93,58,255,905
Lincolnshire,LRX,M,205,88,11,2,0,5,311
Lincolnshire,LUX,F,0,1,0,0,0,0,1
Lincolnshire,LUX,M,0,1,0,0,0,0,1
Lincolnshire,MA,F,0,0,0,0,0,3,3
Lincolnshire,MALX,M,0,2,0,0,0,0,2
Lincolnshire,MAX,F,1,2,0,0,0,13,16
Lincolnshire,MAX,M,0,5,0,0,0,0,5
Lincolnshire,MG,F,34,4,7,20,14,45,124
Lincolnshire,MG,M,25,25,0,0,1,3,54
Lincolnshire,MGX,F,0,2,0,1,1,9,13
Lincolnshire,MGX,M,1,0,0,0,0,0,1
Lincolnshire,MO,F,1,5,13,2,32,18,71
Lincolnshire,MO,M,15,12,2,0,0,0,29
Lincolnshire,MOX,F,14,14,20,13,21,65,147
Lincolnshire,MOX,M,37,49,20,0,0,3,109
Lincolnshire,MRI,F,0,1,1,3,1,1,7
Lincolnshire,MRI,M,1,18,2,0,1,0,22
Lincolnshire,MRIX,F,5,1,17,5,5,39,72
Lincolnshire,MRIX,M,7,10,10,0,1,0,28
Lincolnshire,NDX,F,0,0,0,0,0,1,1
Lincolnshire,NO,F,1,0,0,0,1,1,3
Lincolnshire,NO,M,0,1,0,0,0,0,1
Lincolnshire,NOX,F,3,0,0,0,0,0,3
Lincolnshire,NOX,M,1,1,0,0,0,0,2
Lincolnshire,NR,M,2,0,0,0,0,0,2
Lincolnshire,NRX,F,4,0,0,0,0,0,4
Lincolnshire,NRX,M,4,0,1,0,0,0,5
Lincolnshire,NS,F,0,0,0,0,0,165,165
Lincolnshire,NS,M,0,0,0,0,0,8,8
Lincolnshire,OB,F,0,0,0,0,0,1,1
Lincolnshire,OE,F,0,0,0,0,0,1,1
Lincolnshire,OEX,M,0,0,1,0,0,0,1
Lincolnshire,PA,F,9,10,6,2,4,27,58
Lincolnshire,PA,M,8,6,2,4,4,2,26
Lincolnshire,PAX,F,52,77,17,2,7,44,199
Lincolnshire,PAX,M,50,24,2,0,0,0,76
Lincolnshire,PI,F,0,0,0,0,0,7,7
Lincolnshire,PI,M,0,0,0,0,0,4,4
Lincolnshire,PIX,F,2,16,1,0,1,28,48
Lincolnshire,PIX,M,3,22,6,0,0,2,33
Lincolnshire,RO,F,0,0,0,0,0,2,2
Lincolnshire,ROX,F,0,3,0,0,6,17,26
Lincolnshire,ROX,M,0,0,0,0,1,3,4
Lincolnshire,RP,F,0,2,0,0,1,5,8
Lincolnshire,RP,M,3,10,0,0,0,6,19
Lincolnshire,RPX,F,0,5,2,8,3,12,30
Lincolnshire,RPX,M,5,8,0,0,0,0,13
Lincolnshire,SA,F,2,2,4,3,3,13,27
Lincolnshire,SA,M,2,4,4,0,0,1,11
Lincolnshire,SAX,F,79,93,69,44,23,134,442
Lincolnshire,SAX,M,53,85,9,0,0,1,148
Lincolnshire,SB,F,0,0,0,0,0,6,6
Lincolnshire,SBX,M,0,0,1,0,0,0,1
Lincolnshire,SD,F,27,51,38,20,31,94,261
Lincolnshire,SD,M,24,31,21,6,3,6,91
Lincolnshire,SDX,F,111,100,62,36,35,127,471
Lincolnshire,SDX,M,103,63,12,0,0,4,182
Lincolnshire,SG,F,0,0,0,0,0,2,2
Lincolnshire,SH,F,3,9,1,2,0,5,20
Lincolnshire,SH,M,4,5,1,0,0,1,11
Lincolnshire,SHO,F,1,2,0,2,0,5,10
Lincolnshire,SHO,M,33,23,6,0,0,1,63
Lincolnshire,SHOX,F,1,11,4,1,1,11,29
Lincolnshire,SHOX,M,21,33,6,0,0,2,62
Lincolnshire,SHX,F,0,1,1,2,0,0,4
Lincolnshire,SHX,M,1,0,0,0,0,0,1
Lincolnshire,SM,F,215,248,82,107,84,454,"1,190"
Lincolnshire,SM,M,239,146,23,11,8,68,495
Lincolnshire,SMX,F,722,912,366,290,277,"1,797","4,364"
Lincolnshire,SMX,M,809,758,175,6,4,129,"1,881"
Lincolnshire,SOB,F,4,2,3,6,0,6,21
Lincolnshire,SOB,M,2,1,0,0,0,2,5
Lincolnshire,SOBX,F,3,30,10,7,2,5,57
Lincolnshire,SOBX,M,1,2,2,0,0,0,5
Lincolnshire,SRW,M,1,0,0,0,0,0,1
Lincolnshire,SRWX,F,20,1,1,0,0,2,24
Lincolnshire,SRWX,M,11,10,1,0,1,0,23
Lincolnshire,ST,F,11,7,2,4,3,8,35
Lincolnshire,ST,M,8,19,2,1,3,1,34
Lincolnshire,STX,F,78,55,13,4,3,0,153
Lincolnshire,STX,M,89,34,0,0,0,0,123
Lincolnshire,SU,F,0,0,0,0,1,0,1
Lincolnshire,SU,M,0,8,0,0,0,0,8
Lincolnshire,SUX,F,0,2,0,0,0,3,5
Lincolnshire,SUX,M,0,12,0,0,0,0,12
Lincolnshire,WB,F,0,0,0,0,0,9,9
Lincolnshire,WB,M,2,8,2,0,0,0,12
Lincolnshire,WBX,F,7,4,6,0,1,18,36
Lincolnshire,WBX,M,9,22,1,0,0,1,33
Lincolnshire,WG,F,0,1,0,0,0,1,2
Lincolnshire,WPX,F,0,0,0,0,0,2,2
Lincolnshire,WPX,M,0,1,0,0,0,0,1
Lincolnshire,WSX,F,0,0,0,0,2,3,5
Merseyside,AA,F,56,40,21,32,13,57,219
Merseyside,AA,M,54,29,4,3,3,8,101
Merseyside,AAX,F,61,100,19,10,12,61,263
Merseyside,AAX,M,42,41,17,1,0,1,102
Merseyside,AY,F,0,0,0,0,0,9,9
Merseyside,AY,M,0,0,0,0,0,5,5
Merseyside,AYX,F,4,2,0,0,0,11,17
Merseyside,AYX,M,0,0,0,0,0,1,1
Merseyside,BA,F,3,1,1,0,1,2,8
Merseyside,BA,M,0,2,0,0,0,1,3
Merseyside,BALX,M,2,0,0,0,0,0,2
Merseyside,BAX,F,14,32,3,1,1,3,54
Merseyside,BAX,M,16,16,8,0,0,2,42
Merseyside,BAZX,M,2,7,0,0,0,0,9
Merseyside,BB,F,0,16,9,0,1,16,42
Merseyside,BB,M,3,5,9,0,0,17,34
Merseyside,BBX,F,27,106,65,2,5,41,246
Merseyside,BBX,M,251,75,53,1,0,10,390
Merseyside,BF,F,57,62,51,52,66,125,413
Merseyside,BF,M,23,3,10,0,2,1,39
Merseyside,BFX,F,1,1,1,1,1,9,14
Merseyside,BFX,M,5,0,1,0,0,0,6
Merseyside,BH,F,0,0,0,0,0,9,9
Merseyside,BHX,F,0,0,0,0,0,1,1
Merseyside,BLG,F,0,1,0,0,0,0,1
Merseyside,BS,F,0,0,0,0,0,1,1
Merseyside,BSH,F,0,2,0,0,0,0,2
Merseyside,BSH,M,0,10,0,1,0,0,11
Merseyside,BSHX,F,0,2,1,0,0,0,3
Merseyside,BSHX,M,0,9,1,0,0,0,10
Merseyside,BSX,F,1,0,0,0,0,1,2
Merseyside,BSX,M,0,0,2,0,0,0,2
Merseyside,BW,F,0,0,0,0,0,1,1
Merseyside,CH,F,4,17,7,4,5,45,82
Merseyside,CH,M,8,11,8,1,1,3,32
Merseyside,CHX,F,41,121,37,3,1,65,268
Merseyside,CHX,M,23,88,40,1,0,9,161
Merseyside,DEVX,M,1,0,0,0,0,0,1
Merseyside,DEX,F,0,0,1,1,0,6,8
Merseyside,DEX,M,0,0,0,0,0,1,1
Merseyside,DG,F,0,0,0,0,0,1,1
Merseyside,DS,F,2,0,0,0,0,2,4
Merseyside,DSX,F,9,3,0,0,2,0,14
Merseyside,FR,F,0,0,0,0,0,354,354
Merseyside,FR,M,0,0,0,0,0,83,83
Merseyside,FRX,F,0,0,0,0,0,41,41
Merseyside,FRX,M,0,0,0,0,0,3,3
Merseyside,GA,F,3,3,5,6,1,38,56
Merseyside,GA,M,2,2,0,0,1,1,6
Merseyside,GAX,F,0,4,2,1,0,21,28
Merseyside,GAX,M,0,8,0,0,0,0,8
Merseyside,GE,M,0,4,0,0,0,0,4
Merseyside,GEX,F,0,0,0,0,0,1,1
Merseyside,GL,F,0,0,0,0,0,1,1
Merseyside,GU,F,29,22,12,16,8,60,147
Merseyside,GU,M,13,1,0,0,0,0,14
Merseyside,GUX,F,0,4,0,0,0,1,5
Merseyside,H,F,0,0,0,0,0,6,6
Merseyside,H,M,0,0,0,0,0,3,3
Merseyside,HE,F,3,16,3,0,2,11,35
Merseyside,HE,M,4,6,5,0,1,0,16
Merseyside,HEBLX,F,0,0,0,0,0,4,4
Merseyside,HEX,F,56,75,26,8,5,35,205
Merseyside,HEX,M,51,36,28,1,0,1,117
Merseyside,HF,F,269,274,279,286,276,524,"1,908"
Merseyside,HF,M,76,34,26,7,8,7,158
Merseyside,HFX,F,27,21,23,43,8,6,128
Merseyside,HFX,M,6,9,5,0,0,0,20
Merseyside,HI,F,3,1,5,3,1,8,21
Merseyside,HI,M,1,1,0,0,0,0,2
Merseyside,HO,F,0,1,1,3,4,65,74
Merseyside,HO,M,0,1,1,0,3,2,7
Merseyside,HOX,F,0,0,0,0,0,1,1
Merseyside,HOX,M,3,0,0,0,0,1,4
Merseyside,HX,F,0,0,0,0,0,14,14
Merseyside,HX,M,0,0,0,0,0,2,2
Merseyside,IM,F,6,3,1,1,3,11,25
Merseyside,IM,M,0,0,0,0,0,2,2
Merseyside,JEX,F,0,2,0,0,0,0,2
Merseyside,LH,F,7,7,4,2,4,17,41
Merseyside,LH,M,9,7,2,1,0,1,20
Merseyside,LHX,F,15,2,3,0,1,0,21
Merseyside,LHX,M,12,2,0,0,0,1,15
Merseyside,LI,F,0,0,0,0,0,3,3
Merseyside,LI,M,0,0,0,0,0,2,2
Merseyside,LIM,F,7,27,18,0,2,12,66
Merseyside,LIM,M,9,14,23,3,2,2,53
Merseyside,LIMBX,F,0,0,0,0,0,1,1
Merseyside,LIMRX,F,0,0,0,0,0,1,1
Merseyside,LIMX,F,160,236,100,3,51,136,686
Merseyside,LIMX,M,174,109,116,0,0,4,403
Merseyside,LIX,F,0,0,0,0,0,13,13
Merseyside,LIX,M,0,0,0,0,0,5,5
Merseyside,LM,F,0,0,0,0,0,5,5
Merseyside,LMX,F,0,0,0,0,0,1,1
Merseyside,MG,F,0,0,0,0,0,1,1
Merseyside,MGX,F,0,0,0,0,0,1,1
Merseyside,MO,M,0,0,1,0,0,0,1
Merseyside,MRI,F,0,0,1,0,0,5,6
Merseyside,MRI,M,0,0,0,0,0,1,1
Merseyside,MRIX,F,0,1,1,2,3,6,13
Merseyside,MRIX,M,0,0,0,0,0,1,1
Merseyside,NS,F,0,0,0,0,0,59,59
Merseyside,PIX,F,0,1,0,0,0,1,2
Merseyside,RP,F,2,1,0,0,0,2,5
Merseyside,RP,M,0,1,0,0,0,0,1
Merseyside,SA,F,0,0,0,0,0,3,3
Merseyside,SA,M,0,2,0,0,0,1,3
Merseyside,SAX,F,0,0,0,0,0,13,13
Merseyside,SAX,M,1,0,3,0,0,0,4
Merseyside,SD,F,2,0,3,3,0,1,9
Merseyside,SD,M,0,8,7,1,0,0,16
Merseyside,SDX,F,15,16,0,0,0,0,31
Merseyside,SDX,M,21,10,1,0,0,0,32
Merseyside,SH,F,1,3,5,0,0,4,13
Merseyside,SH,M,1,0,0,0,0,1,2
Merseyside,SHO,F,21,4,4,3,1,12,45
Merseyside,SHO,M,11,6,1,0,0,0,18
Merseyside,SHOX,F,17,3,1,0,0,4,25
Merseyside,SHOX,M,18,2,0,0,0,0,20
Merseyside,SHX,M,0,1,0,0,0,0,1
Merseyside,SM,F,35,26,10,7,6,77,161
Merseyside,SM,M,20,12,6,5,3,6,52
Merseyside,SMX,F,100,147,33,19,7,56,362
Merseyside,SMX,M,111,127,42,4,2,21,307
Merseyside,WB,F,0,1,0,0,0,0,1
Merseyside,WB,M,0,1,1,0,0,0,2
Merseyside,WBX,F,0,3,1,0,0,0,4
Merseyside,WBX,M,0,9,0,0,0,0,9
Merseyside,WP,F,0,0,0,0,0,1,1
Merseyside,WP,M,0,0,0,0,0,1,1
Great London E,AA,F,0,0,0,0,0,1,1
Great London E,AAX,F,3,0,0,0,0,7,10
Great London E,AAX,M,1,0,1,0,0,0,2
Great London E,AY,F,2,2,0,0,1,50,55
Great London E,BA,F,4,3,0,1,0,12,20
Great London E,BA,M,2,3,0,1,0,6,12
Great London E,BAX,F,3,0,0,0,0,2,5
Great London E,BAX,M,2,0,0,0,0,0,2
Great London E,BB,F,0,2,0,0,4,2,8
Great London E,BB,M,1,0,0,0,0,1,2
Great London E,BBX,F,3,0,11,2,8,10,34
Great London E,BBX,M,1,0,3,1,0,1,6
Great London E,BF,F,0,1,11,10,1,14,37
Great London E,BF,M,0,5,0,0,0,0,5
Great London E,CH,F,0,1,0,0,0,2,3
Great London E,CH,M,0,0,0,0,0,1,1
Great London E,CHX,F,20,1,0,1,0,24,46
Great London E,CHX,M,5,2,0,0,0,4,11
Great London E,DEX,F,0,0,1,2,1,16,20
Great London E,DEX,M,0,0,0,3,0,0,3
Great London E,DS,F,2,0,0,0,0,0,2
Great London E,DV,F,0,0,0,0,0,1,1
Great London E,DV,M,0,0,0,0,0,1,1
Great London E,DVX,M,0,0,0,0,0,2,2
Great London E,FR,F,0,0,0,0,0,31,31
Great London E,FR,M,0,0,0,0,0,9,9
Great London E,FRX,M,0,0,0,0,0,1,1
Great London E,GEX,F,0,1,0,0,0,6,7
Great London E,HE,F,0,0,0,0,0,1,1
Great London E,HE,M,1,0,0,0,0,0,1
Great London E,HEX,F,1,0,0,0,0,16,17
Great London E,HF,F,2,2,9,4,2,5,24
Great London E,HF,M,2,1,3,0,0,0,6
Great London E,HFX,M,0,1,0,0,0,0,1
Great London E,HI,F,0,0,0,1,0,6,7
Great London E,HI,M,0,0,1,0,1,0,2
Great London E,HO,F,0,0,0,0,0,1,1
Great London E,HOX,F,0,0,0,0,0,1,1
Great London E,HX,M,0,0,0,0,0,1,1
Great London E,IM,F,0,0,1,1,0,0,2
Great London E,JE,F,0,0,0,0,0,7,7
Great London E,LI,M,0,0,0,0,0,2,2
Great London E,LIM,F,9,1,0,3,4,10,27
Great London E,LIM,M,6,0,0,0,0,1,7
Great London E,LIM X,F,0,0,0,0,0,1,1
Great London E,LIMX,F,20,5,4,7,0,38,74
Great London E,LIMX,M,27,3,0,0,0,1,31
Great London E,LIX,F,0,0,0,0,0,6,6
Great London E,LIX,M,0,0,0,0,0,3,3
Great London E,LRX,M,3,0,0,0,0,0,3
Great London E,MRIX,F,0,0,0,0,0,2,2
Great London E,NS,F,0,0,0,0,0,2,2
Great London E,PIX,F,0,0,0,0,0,9,9
Great London E,PIX,M,0,0,0,0,0,1,1
Great London E,RP,F,0,0,0,1,0,3,4
Great London E,RPX,F,0,1,0,0,0,0,1
Great London E,RPX,M,2,0,0,0,0,0,2
Great London E,SM,F,0,0,0,0,1,1,2
Great London E,SM,M,1,0,0,1,0,2,4
Great London E,SMX,F,25,3,10,0,0,9,47
Great London E,SMX,M,18,0,5,0,0,0,23
Great London E,SU,F,0,0,0,0,0,1,1
Great London SE,AA,F,1,8,3,2,0,1,15
Great London SE,AA,M,0,0,0,0,0,1,1
Great London SE,AAX,F,18,10,28,1,0,25,82
Great London SE,AAX,M,11,6,0,0,0,0,17
Great London SE,AY,F,2,2,0,0,0,1,5
Great London SE,BA,M,0,0,0,0,1,0,1
Great London SE,BAX,F,10,0,0,2,0,0,12
Great London SE,BAX,M,0,0,0,0,0,3,3
Great London SE,BB,F,8,1,3,4,2,9,27
Great London SE,BB,M,6,1,0,0,0,1,8
Great London SE,BBX,F,41,17,1,1,1,11,72
Great London SE,BBX,M,45,28,0,0,0,1,74
Great London SE,BF,F,0,0,0,0,1,3,4
Great London SE,BF,M,1,0,0,0,0,0,1
Great London SE,BFX,F,2,0,0,0,0,5,7
Great London SE,BFX,M,1,0,0,0,0,0,1
Great London SE,BG,F,0,0,0,0,0,1,1
Great London SE,BG,M,1,0,0,0,0,0,1
Great London SE,BH,F,0,0,0,0,0,1,1
Great London SE,BSH,F,0,0,1,0,0,0,1
Great London SE,BSHX,F,0,0,2,0,0,0,2
Great London SE,BW,F,0,0,0,0,1,0,1
Great London SE,BW,M,0,0,0,0,0,1,1
Great London SE,CH,F,3,1,0,0,0,22,26
Great London SE,CH,M,1,0,0,0,1,5,7
Great London SE,CHX,F,54,8,2,7,3,77,151
Great London SE,CHX,M,50,5,0,1,0,11,67
Great London SE,DEX,F,0,0,4,0,1,9,14
Great London SE,DEX,M,2,3,0,0,0,2,7
Great London SE,DEXX,M,0,1,0,0,0,0,1
Great London SE,DSX,F,0,0,0,0,2,1,3
Great London SE,DVX,F,0,0,0,0,0,1,1
Great London SE,DVX,M,0,0,0,0,0,1,1
Great London SE,FR,F,0,0,0,0,0,80,80
Great London SE,FR,M,0,0,0,0,0,11,11
Great London SE,FRX,F,0,0,0,0,0,2,2
Great London SE,GU,F,0,0,0,0,0,3,3
Great London SE,GY,F,1,0,0,0,0,0,1
Great London SE,H,F,0,0,0,0,0,12,12
Great London SE,HE,F,3,13,6,11,5,17,55
Great London SE,HE,M,1,0,2,0,0,0,3
Great London SE,HEBLX,F,0,0,0,0,0,1,1
Great London SE,HEX,F,19,20,6,13,7,42,107
Great London SE,HEX,M,15,2,0,0,0,2,19
Great London SE,HF,F,108,52,107,102,114,261,744
Great London SE,HF,M,16,3,3,0,0,1,23
Great London SE,HFX,F,0,0,0,0,1,3,4
Great London SE,HI,F,0,0,2,1,0,3,6
Great London SE,HI,M,0,0,1,0,0,0,1
Great London SE,HIX,F,0,2,0,0,0,0,2
Great London SE,HO,F,0,1,0,1,6,12,20
Great London SE,HO,M,0,0,0,1,0,2,3
Great London SE,HX,F,0,0,0,0,0,10,10
Great London SE,HX,M,0,0,0,0,0,3,3
Great London SE,JE,F,6,36,2,4,4,13,65
Great London SE,JEX,F,1,0,0,0,0,0,1
Great London SE,LH,F,6,4,4,0,4,14,32
Great London SE,LH,M,5,0,0,0,0,3,8
Great London SE,LI,F,0,0,0,0,0,2,2
Great London SE,LI,M,0,0,0,0,0,1,1
Great London SE,LIM,F,38,5,4,13,8,22,90
Great London SE,LIM,M,25,8,0,1,0,0,34
Great London SE,LIMX,F,45,13,1,3,1,8,71
Great London SE,LIMX,M,11,4,0,1,1,1,18
Great London SE,LIX,F,0,0,0,0,0,1,1
Great London SE,LIX,M,0,0,0,0,0,1,1
Great London SE,LR,F,0,0,2,0,0,0,2
Great London SE,MG,M,0,0,0,0,0,1,1
Great London SE,MO,M,8,0,0,0,0,0,8
Great London SE,NRX,M,1,0,0,0,0,0,1
Great London SE,NS,F,0,0,0,0,0,3,3
Great London SE,SDX,F,0,0,0,0,0,1,1
Great London SE,SM,F,12,1,4,1,1,17,36
Great London SE,SM,M,7,1,0,0,0,3,11
Great London SE,SMX,F,56,8,1,5,5,17,92
Great London SE,SMX,M,41,16,1,0,1,3,62
Great London SE,SU,F,0,3,6,2,6,13,30
Great London SE,SUX,F,2,0,0,1,6,5,14
Great London SE,SUX,M,2,0,0,0,0,1,3
Norfolk,AA,F,335,334,162,135,121,492,"1,579"
Norfolk,AA,M,372,312,57,25,13,55,834
Norfolk,AAX,F,"1,324","1,000",406,287,172,946,"4,135"
Norfolk,AAX,M,"1,382","1,115",178,10,4,69,"2,758"
Norfolk,AN,M,0,1,0,0,0,0,1
Norfolk,AR,F,0,0,0,1,0,0,1
Norfolk,ARX,M,0,1,0,0,0,0,1
Norfolk,AU,F,0,0,0,0,0,6,6
Norfolk,AU,M,0,0,0,0,0,1,1
Norfolk,AY,F,8,5,2,4,5,11,35
Norfolk,AY,M,1,11,0,0,0,4,16
Norfolk,AYX,F,1,2,1,0,0,3,7
Norfolk,AYX,M,0,0,1,0,0,0,1
Norfolk,BA,F,72,63,22,17,26,139,339
Norfolk,BA,M,90,53,18,11,9,38,219
Norfolk,BABX,F,0,0,0,0,0,3,3
Norfolk,BABX,M,0,0,0,0,0,1,1
Norfolk,BAL,F,0,0,0,0,1,2,3
Norfolk,BALX,M,3,0,0,0,0,0,3
Norfolk,BARX,F,0,0,0,0,0,1,1
Norfolk,BAWX,F,0,0,0,0,0,10,10
Norfolk,BAX,F,848,709,138,94,101,564,"2,454"
Norfolk,BAX,M,893,611,43,0,2,69,"1,618"
Norfolk,BAZ,F,7,2,1,2,0,24,36
Norfolk,BAZ,M,6,5,0,0,0,29,40
Norfolk,BAZX,F,187,113,20,19,8,57,404
Norfolk,BAZX,M,212,118,9,4,0,1,344
Norfolk,BB,F,51,73,14,9,12,113,272
Norfolk,BB,M,97,75,12,9,5,32,230
Norfolk,BBX,F,803,729,147,132,89,553,"2,453"
Norfolk,BBX,M,910,636,89,12,4,65,"1,716"
Norfolk,BF,F,177,188,224,213,195,317,"1,314"
Norfolk,BF,M,272,212,51,27,2,8,572
Norfolk,BFX,F,11,9,7,7,9,19,62
Norfolk,BFX,M,21,29,2,3,0,0,55
Norfolk,BG,F,6,6,2,0,1,5,20
Norfolk,BG,M,3,1,1,0,2,0,7
Norfolk,BGX,F,5,0,0,0,0,0,5
Norfolk,BGX,M,3,1,0,0,0,0,4
Norfolk,BH,F,25,0,0,0,0,63,88
Norfolk,BH,M,17,0,0,0,0,0,17
Norfolk,BHX,M,1,0,0,0,0,0,1
Norfolk,BLG,F,0,0,1,0,0,3,4
Norfolk,BLGX,F,0,0,0,0,0,7,7
Norfolk,BLP,F,0,0,0,0,0,1,1
Norfolk,BRX,F,1,0,0,0,0,1,2
Norfolk,BS,F,16,12,13,3,2,11,57
Norfolk,BS,M,13,37,5,0,0,1,56
Norfolk,BSH,F,30,28,10,12,8,62,150
Norfolk,BSH,M,31,19,0,2,2,3,57
Norfolk,BSHO,F,0,0,0,0,0,1,1
Norfolk,BSHX,F,45,28,7,3,4,12,99
Norfolk,BSHX,M,53,64,3,0,0,0,120
Norfolk,BSX,F,19,11,20,17,15,15,97
Norfolk,BSX,M,18,7,3,0,0,1,29
Norfolk,BW,F,48,43,22,13,20,110,256
Norfolk,BW,M,46,45,13,0,1,5,110
Norfolk,BWX,F,13,4,1,3,3,22,46
Norfolk,BWX,M,21,6,1,0,0,1,29
Norfolk,CA,F,0,0,0,0,0,4,4
Norfolk,CAX,F,0,0,0,0,0,1,1
Norfolk,CB,F,15,6,0,0,0,35,56
Norfolk,CB,M,6,1,0,0,0,0,7
Norfolk,CH,F,185,197,71,85,74,486,"1,098"
Norfolk,CH,M,206,162,29,18,14,76,505
Norfolk,CHI,M,0,0,0,0,0,1,1
Norfolk,CHIX,F,0,1,0,0,0,0,1
Norfolk,CHL,F,0,1,0,0,0,0,1
Norfolk,CHX,F,"1,030","1,089",268,173,125,962,"3,647"
Norfolk,CHX,M,"1,129","1,093",137,19,5,114,"2,497"
Norfolk,DE,F,0,0,0,0,0,3,3
Norfolk,DEV,F,3,7,1,0,3,27,41
Norfolk,DEV,M,1,2,0,0,2,4,9
Norfolk,DEVX,F,44,39,6,4,1,53,147
Norfolk,DEVX,M,44,30,1,0,0,1,76
Norfolk,DEX,F,35,32,26,23,19,97,232
Norfolk,DEX,M,41,30,3,2,1,11,88
Norfolk,DEXX,F,2,7,3,0,2,4,18
Norfolk,DEXX,M,2,15,1,0,0,0,18
Norfolk,DG,F,0,0,0,0,0,1,1
Norfolk,DRX,M,1,0,0,0,0,0,1
Norfolk,DS,F,30,29,28,24,18,52,181
Norfolk,DS,M,33,33,1,2,0,4,73
Norfolk,DSHO,F,1,0,0,0,0,2,3
Norfolk,DSX,F,2,0,1,0,0,21,24
Norfolk,DSX,M,1,3,0,0,0,0,4
Norfolk,DV,F,0,0,0,0,0,33,33
Norfolk,DV,M,0,0,0,0,0,11,11
Norfolk,DVX,F,0,0,0,0,0,19,19
Norfolk,DVX,M,0,0,0,0,0,3,3
Norfolk,FR,F,0,0,0,0,0,"1,518","1,518"
Norfolk,FR,M,0,0,0,0,0,84,84
Norfolk,FRX,F,0,0,0,0,0,73,73
Norfolk,FRX,M,0,0,0,0,0,30,30
Norfolk,GA,F,3,9,6,3,1,25,47
Norfolk,GA,M,4,3,7,0,0,2,16
Norfolk,GASX,F,6,3,0,0,0,0,9
Norfolk,GASX,M,4,2,0,0,0,1,7
Norfolk,GAX,F,6,16,7,2,3,9,43
Norfolk,GAX,M,8,8,0,0,0,0,16
Norfolk,GBX,F,1,0,0,0,0,0,1
Norfolk,GE,F,27,22,2,4,11,50,116
Norfolk,GE,M,25,7,2,2,0,9,45
Norfolk,GEX,F,47,52,5,8,22,109,243
Norfolk,GEX,M,50,50,2,0,0,5,107
Norfolk,GL,F,1,0,1,1,2,22,27
Norfolk,GL,M,2,0,1,0,0,0,3
Norfolk,GLX,F,4,11,3,0,0,0,18
Norfolk,GLX,M,4,11,1,0,0,0,16
Norfolk,GU,F,22,32,24,22,30,110,240
Norfolk,GU,M,13,6,0,0,0,5,24
Norfolk,GUX,F,0,4,0,1,1,1,7
Norfolk,GUX,M,1,0,0,0,0,0,1
Norfolk,H,F,0,0,0,0,0,77,77
Norfolk,H,M,0,0,0,0,0,27,27
Norfolk,HE,F,72,124,64,49,37,149,495
Norfolk,HE,M,81,93,14,7,3,16,214
Norfolk,HEBL,F,0,0,0,0,0,6,6
Norfolk,HEBLX,F,0,0,0,0,0,97,97
Norfolk,HEBLX,M,0,0,0,0,0,2,2
Norfolk,HEBRX,M,0,0,0,0,0,1,1
Norfolk,HER,F,0,0,0,0,0,8,8
Norfolk,HERX,F,0,0,0,0,0,47,47
Norfolk,HERX,M,0,0,0,0,0,3,3
Norfolk,HEX,F,498,409,350,388,326,"1,341","3,312"
Norfolk,HEX,M,477,550,116,10,3,14,"1,170"
Norfolk,HF,F,"1,807","1,824","1,779","1,636","1,312","2,599","10,957"
Norfolk,HF,M,"1,489","1,020",375,63,19,29,"2,995"
Norfolk,HFX,F,10,4,15,13,19,72,133
Norfolk,HFX,M,23,34,9,5,0,1,72
Norfolk,HI,F,55,44,31,29,26,149,334
Norfolk,HI,M,35,54,27,3,2,22,143
Norfolk,HIX,F,14,15,4,1,2,5,41
Norfolk,HIX,M,21,5,3,3,0,2,34
Norfolk,HL,F,0,0,0,0,0,9,9
Norfolk,HO,F,540,493,427,353,270,368,"2,451"
Norfolk,HO,M,286,154,69,38,8,4,559
Norfolk,HOX,F,1,3,0,2,0,4,10
Norfolk,HOX,M,5,2,0,1,0,0,8
Norfolk,HX,F,0,0,0,0,0,450,450
Norfolk,HX,M,0,0,0,0,0,35,35
Norfolk,IM,F,2,0,0,1,0,1,4
Norfolk,IM,M,1,3,0,0,0,0,4
Norfolk,IMX,F,0,0,0,0,0,1,1
Norfolk,IMX,M,0,3,0,0,0,0,3
Norfolk,JE,F,141,98,83,85,76,308,791
Norfolk,JE,M,12,13,4,2,0,2,33
Norfolk,JEX,F,4,4,6,5,9,17,45
Norfolk,JEX,M,4,4,1,0,0,2,11
Norfolk,JY,F,7,0,0,0,0,0,7
Norfolk,KE,M,0,1,0,0,0,0,1
Norfolk,LH,F,31,35,22,19,15,41,163
Norfolk,LH,M,27,22,1,1,1,4,56
Norfolk,LHX,F,6,4,5,4,1,2,22
Norfolk,LHX,M,8,9,2,0,0,0,19
Norfolk,LI,F,0,0,0,0,0,109,109
Norfolk,LI,M,0,0,0,0,0,40,40
Norfolk,LIM,F,244,264,86,76,58,295,"1,023"
Norfolk,LIM,M,272,261,61,24,20,46,684
Norfolk,LIMB,F,0,0,0,0,0,9,9
Norfolk,LIMBX,F,0,0,0,0,0,51,51
Norfolk,LIMBX,M,0,0,0,0,0,1,1
Norfolk,LIMR,F,0,0,0,0,0,4,4
Norfolk,LIMR,M,0,0,0,0,0,6,6
Norfolk,LIMRX,F,0,0,0,0,0,13,13
Norfolk,LIMRX,M,0,0,0,0,0,1,1
Norfolk,LIMX,F,"1,793","1,935",606,304,261,"1,485","6,384"
Norfolk,LIMX,M,"1,997","1,981",232,34,8,60,"4,312"
Norfolk,LIX,F,0,0,0,0,0,492,492
Norfolk,LIX,M,0,0,0,0,0,139,139
Norfolk,LM,M,0,0,0,0,0,2,2
Norfolk,LMX,F,0,0,0,0,0,10,10
Norfolk,LR,F,26,14,3,13,21,45,122
Norfolk,LR,M,32,20,3,0,0,5,60
Norfolk,LRX,F,44,41,21,4,10,11,131
Norfolk,LRX,M,40,39,2,0,0,0,81
Norfolk,MAR,F,0,0,0,0,0,1,1
Norfolk,MARX,F,0,1,0,5,1,0,7
Norfolk,MARX,M,0,1,0,0,0,0,1
Norfolk,MG,F,5,8,1,1,4,26,45
Norfolk,MG,M,7,5,0,0,0,0,12
Norfolk,MGX,F,5,5,10,2,1,29,52
Norfolk,MGX,M,7,1,0,0,0,4,12
Norfolk,MO,F,0,1,1,1,1,2,6
Norfolk,MO,M,17,5,1,4,0,0,27
Norfolk,MOX,F,2,1,2,1,1,3,10
Norfolk,MOX,M,6,7,2,0,0,0,15
Norfolk,MRI,F,0,1,0,1,1,18,21
Norfolk,MRI,M,1,11,5,0,0,0,17
Norfolk,MRIX,F,0,1,9,0,0,4,14
Norfolk,MRIX,M,9,18,13,1,0,0,41
Norfolk,ND,F,0,0,0,0,0,1,1
Norfolk,NDX,F,0,0,0,0,0,7,7
Norfolk,NO,F,1,0,0,0,0,0,1
Norfolk,NO,M,1,0,0,0,0,1,2
Norfolk,NOX,F,0,2,0,1,0,4,7
Norfolk,NOX,M,1,1,2,0,0,0,4
Norfolk,NR,F,0,0,0,0,0,2,2
Norfolk,NRX,F,0,1,0,0,0,2,3
Norfolk,NRX,M,0,1,0,0,0,0,1
Norfolk,NS,F,0,0,0,0,0,316,316
Norfolk,NS,M,0,0,0,0,0,1,1
Norfolk,OE,F,0,0,0,0,4,2,6
Norfolk,OEX,F,0,0,1,0,0,0,1
Norfolk,OEX,M,0,1,0,0,0,0,1
Norfolk,PA,F,0,2,0,0,0,0,2
Norfolk,PA,M,0,0,1,0,0,0,1
Norfolk,PAX,F,0,0,0,0,0,8,8
Norfolk,PI,F,0,0,1,0,0,4,5
Norfolk,PI,M,0,0,0,0,2,1,3
Norfolk,PIX,F,12,19,7,1,0,18,57
Norfolk,PIX,M,11,10,1,0,0,1,23
Norfolk,RO,F,0,0,0,0,0,1,1
Norfolk,ROTX,F,0,1,0,0,0,0,1
Norfolk,ROX,F,7,3,0,0,0,2,12
Norfolk,ROX,M,7,0,0,0,0,0,7
Norfolk,RP,F,195,120,81,58,61,275,790
Norfolk,RP,M,187,105,10,7,1,10,320
Norfolk,RPX,F,40,37,18,12,5,38,150
Norfolk,RPX,M,52,35,1,1,0,0,89
Norfolk,SA,F,0,9,1,0,8,37,55
Norfolk,SA,M,4,11,2,0,1,2,20
Norfolk,SAX,F,27,60,10,17,20,163,297
Norfolk,SAX,M,33,104,2,0,0,9,148
Norfolk,SBX,F,0,0,0,0,1,0,1
Norfolk,SD,F,74,89,64,40,45,187,499
Norfolk,SD,M,81,53,9,3,3,7,156
Norfolk,SDX,F,88,74,36,27,26,81,332
Norfolk,SDX,M,75,64,7,1,1,4,152
Norfolk,SH,F,0,1,1,2,1,5,10
Norfolk,SHO,F,3,12,1,12,4,20,52
Norfolk,SHO,M,10,6,1,1,0,2,20
Norfolk,SHOX,F,121,75,23,5,26,25,275
Norfolk,SHOX,M,109,86,4,1,0,3,203
Norfolk,SHX,F,11,4,2,0,0,3,20
Norfolk,SHX,M,3,1,0,1,0,0,5
Norfolk,SM,F,353,290,174,142,131,689,"1,779"
Norfolk,SM,M,408,257,44,37,23,122,891
Norfolk,SMX,F,"1,957","1,781",639,508,502,"2,716","8,103"
Norfolk,SMX,M,"2,379","1,636",182,31,13,177,"4,418"
Norfolk,SOB,F,0,0,1,0,0,0,1
Norfolk,SOBX,F,0,0,1,0,0,0,1
Norfolk,SRW,F,6,0,0,0,0,0,6
Norfolk,SRW,M,2,0,0,0,0,0,2
Norfolk,SRWX,F,2,0,0,0,0,0,2
Norfolk,SRWX,M,10,0,2,0,0,0,12
Norfolk,ST,M,0,2,0,0,0,0,2
Norfolk,STX,F,0,7,5,13,0,0,25
Norfolk,STX,M,34,12,5,0,0,0,51
Norfolk,SU,F,2,2,1,0,0,6,11
Norfolk,SU,M,2,4,0,0,0,0,6
Norfolk,SUX,F,2,34,4,2,4,33,79
Norfolk,SUX,M,9,40,2,0,0,2,53
Norfolk,WB,F,13,7,5,9,4,28,66
Norfolk,WB,M,13,15,2,5,2,1,38
Norfolk,WBX,F,88,68,14,4,2,5,181
Norfolk,WBX,M,69,45,0,0,0,1,115
Norfolk,WGX,F,0,1,0,0,0,0,1
Norfolk,WP,F,22,17,14,6,14,45,118
Norfolk,WP,M,25,17,5,2,0,0,49
Norfolk,WPX,F,0,3,2,1,0,1,7
Norfolk,WPX,M,3,3,0,0,0,0,6
Norfolk,WS,F,0,2,0,0,0,2,4
Norfolk,WS,M,0,0,0,0,0,1,1
Norfolk,WSX,F,0,1,0,0,0,6,7
Norfolk,WSX,M,0,2,0,0,0,0,2
Norfolk,ZE,F,1,0,1,0,0,2,4
Norfolk,ZE,M,0,0,0,1,0,0,1
Northamptonshire,AA,F,82,133,68,35,25,159,502
Northamptonshire,AA,M,89,172,23,6,6,19,315
Northamptonshire,AAX,F,608,524,336,176,82,364,"2,090"
Northamptonshire,AAX,M,633,815,130,11,7,50,"1,646"
Northamptonshire,AUX,F,0,0,0,0,0,2,2
Northamptonshire,AY,F,0,1,4,2,0,20,27
Northamptonshire,AY,M,1,0,0,1,0,0,2
Northamptonshire,AYX,F,0,0,0,0,0,1,1
Northamptonshire,BA,F,81,70,28,23,25,85,312
Northamptonshire,BA,M,84,68,32,13,7,37,241
Northamptonshire,BABX,F,0,0,0,0,0,5,5
Northamptonshire,BAL,F,0,0,0,0,0,1,1
Northamptonshire,BARX,F,0,0,0,0,0,6,6
Northamptonshire,BAWX,F,0,0,0,0,0,7,7
Northamptonshire,BAX,F,842,697,138,110,100,417,"2,304"
Northamptonshire,BAX,M,840,743,122,7,1,37,"1,750"
Northamptonshire,BAZ,M,0,1,0,0,0,3,4
Northamptonshire,BAZX,F,9,7,3,4,3,22,48
Northamptonshire,BAZX,M,9,5,1,1,1,3,20
Northamptonshire,BB,F,55,42,38,19,46,224,424
Northamptonshire,BB,M,69,76,25,4,3,48,225
Northamptonshire,BBX,F,593,500,295,120,132,552,"2,192"
Northamptonshire,BBX,M,672,568,184,8,2,55,"1,489"
Northamptonshire,BF,F,138,135,227,262,258,412,"1,432"
Northamptonshire,BF,M,278,202,63,6,6,7,562
Northamptonshire,BFX,F,39,10,39,5,11,88,192
Northamptonshire,BFX,M,54,17,8,2,2,5,88
Northamptonshire,BG,F,0,0,0,0,1,2,3
Northamptonshire,BH,F,0,0,0,0,0,63,63
Northamptonshire,BHX,F,0,0,0,0,0,6,6
Northamptonshire,BRX,F,2,1,0,2,0,1,6
Northamptonshire,BRX,M,1,0,0,0,0,0,1
Northamptonshire,BS,F,0,1,0,0,0,0,1
Northamptonshire,BS,M,1,2,1,0,0,0,4
Northamptonshire,BSH,F,27,22,15,17,4,28,113
Northamptonshire,BSH,M,45,19,1,2,3,2,72
Northamptonshire,BSHO,F,0,0,0,0,0,1,1
Northamptonshire,BSHX,F,14,7,5,0,0,27,53
Northamptonshire,BSHX,M,15,11,0,0,0,0,26
Northamptonshire,BSX,F,1,0,5,3,0,1,10
Northamptonshire,BSX,M,13,5,2,0,0,0,20
Northamptonshire,BU,F,0,0,0,0,0,1,1
Northamptonshire,BW,F,5,4,1,2,3,10,25
Northamptonshire,BW,M,2,2,0,1,0,0,5
Northamptonshire,BWB,M,2,0,0,0,0,0,2
Northamptonshire,BWX,F,0,4,0,0,1,3,8
Northamptonshire,BWX,M,1,4,0,0,0,0,5
Northamptonshire,CAX,F,0,0,0,0,0,1,1
Northamptonshire,CB,F,0,1,0,0,7,27,35
Northamptonshire,CD,F,0,0,0,0,0,25,25
Northamptonshire,CH,F,191,241,76,46,90,508,"1,152"
Northamptonshire,CH,M,209,277,53,20,7,64,630
Northamptonshire,CHIX,F,0,0,0,0,0,1,1
Northamptonshire,CHLX,F,1,0,0,0,0,0,1
Northamptonshire,CHX,F,805,898,264,117,112,702,"2,898"
Northamptonshire,CHX,M,999,"1,486",308,11,4,67,"2,875"
Northamptonshire,DE,F,0,0,0,0,0,1,1
Northamptonshire,DEV,F,0,0,0,1,2,12,15
Northamptonshire,DEVX,F,25,14,2,1,5,5,52
Northamptonshire,DEVX,M,22,14,2,0,2,1,41
Northamptonshire,DEX,F,58,56,31,26,16,90,277
Northamptonshire,DEX,M,60,54,13,2,2,14,145
Northamptonshire,DEXX,F,3,0,0,0,0,0,3
Northamptonshire,DEXX,M,2,0,0,0,0,0,2
Northamptonshire,DS,F,0,0,0,0,4,2,6
Northamptonshire,DSX,F,0,1,1,0,1,3,6
Northamptonshire,DV,F,0,0,0,0,0,38,38
Northamptonshire,DV,M,0,0,0,0,0,8,8
Northamptonshire,DVX,F,0,0,0,0,0,16,16
Northamptonshire,DVX,M,0,0,0,0,0,1,1
Northamptonshire,FR,F,0,0,0,0,0,"1,319","1,319"
Northamptonshire,FR,M,0,0,0,0,0,99,99
Northamptonshire,FRX,F,0,0,0,0,0,52,52
Northamptonshire,FRX,M,0,0,0,0,0,4,4
Northamptonshire,GA,F,0,0,0,0,0,1,1
Northamptonshire,GA,M,0,0,0,0,0,2,2
Northamptonshire,GASX,F,1,0,0,0,0,0,1
Northamptonshire,GAX,F,2,1,1,2,0,2,8
Northamptonshire,GAX,M,1,1,0,0,0,1,3
Northamptonshire,GE,F,31,33,15,16,9,71,175
Northamptonshire,GE,M,30,9,0,0,0,3,42
Northamptonshire,GEX,F,2,10,1,3,9,27,52
Northamptonshire,GEX,M,2,8,4,0,0,3,17
Northamptonshire,GL,F,4,3,2,1,1,7,18
Northamptonshire,GL,M,0,1,1,0,0,0,2
Northamptonshire,GLX,F,0,0,0,0,1,0,1
Northamptonshire,GU,F,4,1,7,5,10,15,42
Northamptonshire,GU,M,3,2,1,0,0,0,6
Northamptonshire,GUX,F,0,0,0,0,0,4,4
Northamptonshire,H,F,0,0,0,0,0,70,70
Northamptonshire,H,M,0,0,0,0,0,10,10
Northamptonshire,HE,F,81,99,52,42,36,123,433
Northamptonshire,HE,M,90,72,9,11,4,13,199
Northamptonshire,HEBL,F,0,0,0,0,0,1,1
Northamptonshire,HEBLX,F,0,0,0,0,0,46,46
Northamptonshire,HER,F,0,0,0,0,0,10,10
Northamptonshire,HERX,F,0,0,0,0,0,21,21
Northamptonshire,HEX,F,486,462,181,132,143,651,"2,055"
Northamptonshire,HEX,M,459,695,102,1,4,17,"1,278"
Northamptonshire,HF,F,930,"1,180",848,718,610,"1,438","5,724"
Northamptonshire,HF,M,810,429,218,12,4,30,"1,503"
Northamptonshire,HFX,F,26,39,20,8,12,15,120
Northamptonshire,HFX,M,31,29,4,1,0,0,65
Northamptonshire,HI,F,14,22,15,7,5,43,106
Northamptonshire,HI,M,11,22,14,2,0,7,56
Northamptonshire,HIX,F,3,1,2,3,0,3,12
Northamptonshire,HIX,M,1,3,0,0,0,1,5
Northamptonshire,HO,F,128,94,109,89,70,157,647
Northamptonshire,HO,M,162,25,16,0,1,1,205
Northamptonshire,HOX,F,1,1,1,0,1,0,4
Northamptonshire,HOX,M,7,2,0,0,0,0,9
Northamptonshire,HX,F,0,0,0,0,0,223,223
Northamptonshire,HX,M,0,0,0,0,0,19,19
Northamptonshire,JE,F,32,36,21,28,16,82,215
Northamptonshire,JE,M,3,2,2,1,0,4,12
Northamptonshire,JEX,F,4,0,6,5,5,5,25
Northamptonshire,JEX,M,3,4,0,0,0,0,7
Northamptonshire,JYX,F,3,0,0,0,0,1,4
Northamptonshire,LH,F,27,46,18,10,20,141,262
Northamptonshire,LH,M,49,24,3,3,2,8,89
Northamptonshire,LHX,F,5,1,4,0,1,3,14
Northamptonshire,LHX,M,7,3,1,0,0,0,11
Northamptonshire,LI,F,0,0,0,0,0,102,102
Northamptonshire,LI,M,0,0,0,0,0,28,28
Northamptonshire,LIM,F,254,229,84,82,84,349,"1,082"
Northamptonshire,LIM,M,270,266,100,32,26,66,760
Northamptonshire,LIM X,F,0,0,0,0,0,1,1
Northamptonshire,LIMB,F,0,0,0,0,0,3,3
Northamptonshire,LIMBX,F,0,0,0,0,0,52,52
Northamptonshire,LIMBX,M,0,0,0,0,0,7,7
Northamptonshire,LIMR,F,0,0,0,0,0,10,10
Northamptonshire,LIMR,M,0,0,0,0,0,1,1
Northamptonshire,LIMRX,F,0,0,0,0,0,42,42
Northamptonshire,LIMRX,M,0,0,0,0,0,2,2
Northamptonshire,LIMX,F,"1,974","1,945",592,345,313,"1,429","6,598"
Northamptonshire,LIMX,M,"2,025","2,097",465,31,13,42,"4,673"
Northamptonshire,LIX,F,0,0,0,0,0,466,466
Northamptonshire,LIX,M,0,0,0,0,0,76,76
Northamptonshire,LM,F,0,0,0,0,0,6,6
Northamptonshire,LMX,F,0,0,0,0,0,23,23
Northamptonshire,LR,F,32,21,0,0,0,53,106
Northamptonshire,LR,M,18,19,0,0,0,1,38
Northamptonshire,LRX,F,0,5,0,3,0,5,13
Northamptonshire,LUX,F,0,0,0,0,0,2,2
Northamptonshire,MARX,F,5,0,0,0,0,0,5
Northamptonshire,MARX,M,3,1,0,0,0,0,4
Northamptonshire,MAX,F,0,0,0,0,0,1,1
Northamptonshire,MG,F,4,3,1,1,1,14,24
Northamptonshire,MG,M,3,6,0,0,0,6,15
Northamptonshire,MGX,F,4,5,0,0,0,3,12
Northamptonshire,MGX,M,8,9,1,0,0,0,18
Northamptonshire,MO,F,0,0,0,0,0,2,2
Northamptonshire,MO,M,0,5,3,0,0,0,8
Northamptonshire,MOX,F,14,0,0,1,0,12,27
Northamptonshire,MOX,M,15,3,1,0,0,1,20
Northamptonshire,MRI,F,0,0,0,2,3,9,14
Northamptonshire,MRI,M,0,3,0,0,0,4,7
Northamptonshire,MRIX,F,0,1,3,3,1,15,23
Northamptonshire,MRIX,M,9,13,2,0,0,1,25
Northamptonshire,NO,F,0,0,0,0,0,1,1
Northamptonshire,NRX,M,5,0,0,0,0,0,5
Northamptonshire,NS,F,0,0,0,0,0,172,172
Northamptonshire,NS,M,0,0,0,0,0,1,1
Northamptonshire,OB,F,0,0,0,0,0,1,1
Northamptonshire,OE,F,0,0,0,0,0,1,1
Northamptonshire,OEX,F,1,0,0,0,0,0,1
Northamptonshire,PI,F,0,0,0,0,0,4,4
Northamptonshire,PIX,F,23,28,7,11,1,24,94
Northamptonshire,PIX,M,19,7,4,0,0,8,38
Northamptonshire,RO,F,10,3,0,0,0,1,14
Northamptonshire,RO,M,7,3,0,0,0,2,12
Northamptonshire,ROX,F,0,0,1,0,0,8,9
Northamptonshire,ROX,M,0,0,1,0,0,3,4
Northamptonshire,RP,F,3,1,0,1,0,9,14
Northamptonshire,RP,M,2,4,0,0,1,0,7
Northamptonshire,RPX,F,5,7,0,1,1,2,16
Northamptonshire,RPX,M,6,9,0,0,0,0,15
Northamptonshire,RWFR,F,0,0,0,0,0,1,1
Northamptonshire,SA,F,21,28,26,35,5,29,144
Northamptonshire,SA,M,33,14,3,1,1,2,54
Northamptonshire,SAX,F,34,45,18,11,4,26,138
Northamptonshire,SAX,M,64,55,15,0,0,0,134
Northamptonshire,SB,F,1,0,0,0,0,0,1
Northamptonshire,SBX,F,0,1,0,0,0,0,1
Northamptonshire,SBX,M,1,0,0,0,0,0,1
Northamptonshire,SD,F,130,115,64,99,54,247,709
Northamptonshire,SD,M,134,58,12,6,6,8,224
Northamptonshire,SDX,F,155,54,17,14,12,60,312
Northamptonshire,SDX,M,157,73,12,0,0,3,245
Northamptonshire,SGX,F,0,0,0,0,0,1,1
Northamptonshire,SH,F,5,6,6,4,7,14,42
Northamptonshire,SH,M,9,9,0,3,0,2,23
Northamptonshire,SHO,F,1,4,1,5,5,50,66
Northamptonshire,SHO,M,1,6,0,0,0,0,7
Northamptonshire,SHOX,F,54,32,21,11,11,47,176
Northamptonshire,SHOX,M,41,35,9,1,1,2,89
Northamptonshire,SHX,F,0,0,0,0,0,2,2
Northamptonshire,SHX,M,0,0,1,0,0,0,1
Northamptonshire,SM,F,168,163,112,86,81,429,"1,039"
Northamptonshire,SM,M,228,170,22,7,5,32,464
Northamptonshire,SMX,F,635,638,272,274,183,"1,173","3,175"
Northamptonshire,SMX,M,748,885,216,13,2,60,"1,924"
Northamptonshire,SOBX,F,0,0,0,1,0,0,1
Northamptonshire,SRW,M,1,0,0,0,0,0,1
Northamptonshire,SRWX,F,0,0,0,13,2,0,15
Northamptonshire,SRWX,M,1,0,0,0,0,0,1
Northamptonshire,SU,F,2,3,1,0,2,5,13
Northamptonshire,SU,M,0,0,1,0,1,0,2
Northamptonshire,SUX,F,6,14,2,1,2,8,33
Northamptonshire,SUX,M,3,14,4,0,0,0,21
Northamptonshire,WB,F,1,0,0,0,0,6,7
Northamptonshire,WB,M,2,11,2,0,0,0,15
Northamptonshire,WBX,F,3,1,0,0,0,5,9
Northamptonshire,WBX,M,5,14,4,0,0,1,24
Northamptonshire,WP,F,7,6,4,7,3,9,36
Northamptonshire,WP,M,10,5,0,1,0,0,16
Northamptonshire,WPX,F,1,0,1,2,0,0,4
Northamptonshire,WPX,M,4,0,0,0,0,0,4
Northamptonshire,WSX,F,0,0,0,0,0,2,2
Northamptonshire,WSX,M,0,5,0,0,0,0,5
Tyne & Wear,AA,F,26,30,9,17,22,62,166
Tyne & Wear,AA,M,34,20,15,3,5,4,81
Tyne & Wear,AAX,F,150,131,21,33,29,148,512
Tyne & Wear,AAX,M,155,77,6,1,1,2,242
Tyne & Wear,AY,F,0,2,1,4,0,7,14
Tyne & Wear,AY,M,1,0,0,2,0,0,3
Tyne & Wear,AYX,F,0,0,1,0,0,1,2
Tyne & Wear,AYX,M,0,0,0,2,0,0,2
Tyne & Wear,BA,F,29,28,25,10,11,76,179
Tyne & Wear,BA,M,27,14,4,1,1,12,59
Tyne & Wear,BABX,F,0,0,0,0,0,1,1
Tyne & Wear,BALX,F,0,0,0,0,0,1,1
Tyne & Wear,BARX,F,0,0,0,0,0,5,5
Tyne & Wear,BAX,F,84,59,13,13,11,131,311
Tyne & Wear,BAX,M,87,33,9,1,0,6,136
Tyne & Wear,BAZX,F,4,3,0,0,1,2,10
Tyne & Wear,BAZX,M,5,2,0,0,0,0,7
Tyne & Wear,BB,F,1,2,3,1,0,9,16
Tyne & Wear,BB,M,1,3,2,2,0,1,9
Tyne & Wear,BBX,F,29,47,6,5,7,41,135
Tyne & Wear,BBX,M,46,49,1,0,1,1,98
Tyne & Wear,BF,F,11,7,1,29,32,41,121
Tyne & Wear,BF,M,15,20,5,3,7,7,57
Tyne & Wear,BFX,F,2,0,0,2,0,0,4
Tyne & Wear,BFX,M,3,0,0,1,0,0,4
Tyne & Wear,BGX,F,0,0,0,0,0,1,1
Tyne & Wear,BH,F,0,0,0,0,0,2,2
Tyne & Wear,BHX,F,0,0,0,0,0,1,1
Tyne & Wear,BLG,M,0,11,0,0,0,0,11
Tyne & Wear,BP,M,1,0,0,0,0,0,1
Tyne & Wear,BRX,F,1,4,2,0,0,0,7
Tyne & Wear,BRX,M,1,0,0,0,0,0,1
Tyne & Wear,BSH,F,0,1,0,0,1,0,2
Tyne & Wear,BSH,M,1,5,0,1,1,0,8
Tyne & Wear,BSHX,F,1,0,0,0,0,1,2
Tyne & Wear,BSHX,M,1,0,0,0,0,0,1
Tyne & Wear,BSX,F,0,0,1,0,0,0,1
Tyne & Wear,CB,F,0,0,0,0,0,1,1
Tyne & Wear,CH,F,6,12,6,8,12,52,96
Tyne & Wear,CH,M,12,5,1,0,0,12,30
Tyne & Wear,CHL,F,0,0,0,0,0,1,1
Tyne & Wear,CHLX,M,1,0,0,0,0,0,1
Tyne & Wear,CHX,F,60,69,16,16,10,76,247
Tyne & Wear,CHX,M,65,89,30,2,2,25,213
Tyne & Wear,DEV,F,0,0,0,0,1,0,1
Tyne & Wear,DEX,F,1,0,0,0,0,2,3
Tyne & Wear,DEX,M,1,1,0,0,0,1,3
Tyne & Wear,DS,M,1,0,0,0,0,0,1
Tyne & Wear,DSX,F,0,0,0,0,0,1,1
Tyne & Wear,DV,F,0,0,0,0,0,5,5
Tyne & Wear,FR,F,0,0,0,0,0,114,114
Tyne & Wear,FR,M,0,0,0,0,0,17,17
Tyne & Wear,FRX,F,0,0,0,0,0,2,2
Tyne & Wear,FRX,M,0,0,0,0,0,2,2
Tyne & Wear,GA,F,1,0,0,0,0,0,1
Tyne & Wear,GAX,F,1,0,0,1,0,2,4
Tyne & Wear,GEX,F,0,0,0,1,0,0,1
Tyne & Wear,H,F,0,0,0,0,0,2,2
Tyne & Wear,HE,F,2,0,2,2,4,13,23
Tyne & Wear,HE,M,0,1,0,1,0,0,2
Tyne & Wear,HEBL,F,0,0,0,0,0,5,5
Tyne & Wear,HEBLX,F,0,0,0,0,0,8,8
Tyne & Wear,HER,F,0,0,0,0,0,2,2
Tyne & Wear,HERX,F,0,0,0,0,0,6,6
Tyne & Wear,HEX,F,9,11,10,9,8,57,104
Tyne & Wear,HEX,M,11,6,0,0,0,0,17
Tyne & Wear,HF,F,50,51,41,43,31,103,319
Tyne & Wear,HF,M,69,51,9,5,0,4,138
Tyne & Wear,HFX,F,0,2,0,0,0,1,3
Tyne & Wear,HI,F,0,2,4,4,0,9,19
Tyne & Wear,HI,M,1,2,1,2,0,3,9
Tyne & Wear,HIX,F,0,0,0,0,1,1,2
Tyne & Wear,HIX,M,2,0,0,0,0,0,2
Tyne & Wear,HO,F,0,0,0,1,1,10,12
Tyne & Wear,HO,M,4,0,0,0,0,0,4
Tyne & Wear,HOX,F,0,0,0,0,0,1,1
Tyne & Wear,HX,F,0,0,0,0,0,21,21
Tyne & Wear,HX,M,0,0,0,0,0,3,3
Tyne & Wear,JE,F,0,0,0,0,0,3,3
Tyne & Wear,JE,M,0,0,0,0,0,2,2
Tyne & Wear,JEX,F,0,1,0,0,0,0,1
Tyne & Wear,LH,F,9,12,11,9,1,29,71
Tyne & Wear,LH,M,20,10,5,1,0,0,36
Tyne & Wear,LHX,F,2,2,0,3,4,6,17
Tyne & Wear,LHX,M,0,0,0,0,1,2,3
Tyne & Wear,LI,F,0,0,0,0,0,6,6
Tyne & Wear,LI,M,0,0,0,0,0,1,1
Tyne & Wear,LIM,F,12,27,15,26,9,30,119
Tyne & Wear,LIM,M,14,17,4,7,3,11,56
Tyne & Wear,LIMBX,F,0,0,0,0,0,6,6
Tyne & Wear,LIMR,M,0,0,0,0,0,2,2
Tyne & Wear,LIMRX,F,0,0,0,0,0,10,10
Tyne & Wear,LIMX,F,446,497,107,109,104,346,"1,609"
Tyne & Wear,LIMX,M,451,343,56,1,2,7,860
Tyne & Wear,LIX,F,0,0,0,0,0,100,100
Tyne & Wear,LIX,M,0,0,0,0,0,24,24
Tyne & Wear,LM,F,0,0,0,0,0,1,1
Tyne & Wear,LMX,F,0,0,0,0,0,12,12
Tyne & Wear,LUX,F,0,0,0,0,0,1,1
Tyne & Wear,LUX,M,0,1,0,0,0,0,1
Tyne & Wear,MO,F,2,2,0,0,1,2,7
Tyne & Wear,MO,M,0,1,1,0,0,1,3
Tyne & Wear,MOX,F,46,36,0,0,0,2,84
Tyne & Wear,MOX,M,50,6,0,0,0,0,56
Tyne & Wear,MRI,F,0,0,1,0,0,1,2
Tyne & Wear,MRIX,F,0,0,0,0,0,1,1
Tyne & Wear,MRIX,M,2,1,0,0,0,0,3
Tyne & Wear,NS,F,0,0,0,0,0,64,64
Tyne & Wear,OB,M,0,0,0,0,0,2,2
Tyne & Wear,PA,M,0,1,0,0,0,0,1
Tyne & Wear,RPX,F,1,0,0,0,0,1,2
Tyne & Wear,RPX,M,1,0,0,0,0,0,1
Tyne & Wear,SA,F,0,1,1,0,1,8,11
Tyne & Wear,SA,M,2,0,0,0,0,1,3
Tyne & Wear,SAX,F,3,1,0,2,6,25,37
Tyne & Wear,SD,F,18,20,9,6,3,19,75
Tyne & Wear,SD,M,16,3,1,0,1,0,21
Tyne & Wear,SDX,F,11,1,1,4,2,9,28
Tyne & Wear,SDX,M,10,0,0,0,0,0,10
Tyne & Wear,SHO,F,0,0,1,0,0,4,5
Tyne & Wear,SHO,M,5,0,1,0,0,1,7
Tyne & Wear,SHOX,F,3,2,2,0,1,1,9
Tyne & Wear,SHOX,M,0,8,0,0,0,0,8
Tyne & Wear,SHX,M,0,1,0,0,0,0,1
Tyne & Wear,SM,F,0,3,1,2,0,11,17
Tyne & Wear,SM,M,0,2,1,0,0,2,5
Tyne & Wear,SMX,F,14,16,8,12,6,183,239
Tyne & Wear,SMX,M,16,17,3,2,1,5,44
Tyne & Wear,STX,F,4,2,0,0,0,0,6
Tyne & Wear,STX,M,4,1,2,0,0,0,7
Tyne & Wear,SU,F,2,0,0,0,0,3,5
Tyne & Wear,SU,M,2,0,0,0,0,1,3
Tyne & Wear,SUX,F,1,0,0,0,0,0,1
Tyne & Wear,WB,F,0,2,0,0,2,1,5
Tyne & Wear,WB,M,0,0,2,0,0,0,2
Tyne & Wear,WBX,M,0,4,1,0,0,0,5
Tyne & Wear,WSX,F,0,0,0,0,1,3,4
Tyne & Wear,WSX,M,1,34,3,0,0,0,38
Northumberland,AA,F,351,283,230,177,186,853,"2,080"
Northumberland,AA,M,369,316,89,29,29,54,886
Northumberland,AAX,F,"1,986","1,833",963,696,705,"4,356","10,539"
Northumberland,AAX,M,"2,016","1,585",286,3,2,43,"3,935"
Northumberland,AMX,F,0,0,0,0,0,1,1
Northumberland,ARX,F,0,0,0,1,1,0,2
Northumberland,AY,F,28,28,17,17,29,114,233
Northumberland,AY,M,15,0,0,0,0,9,24
Northumberland,AYX,F,22,25,19,24,18,22,130
Northumberland,AYX,M,5,1,0,0,0,0,6
Northumberland,BA,F,73,43,13,28,35,146,338
Northumberland,BA,M,55,33,11,9,8,67,183
Northumberland,BABX,F,0,0,0,0,0,18,18
Northumberland,BAR,F,0,0,0,0,0,1,1
Northumberland,BARX,F,0,0,0,0,0,16,16
Northumberland,BARX,M,0,0,0,0,0,1,1
Northumberland,BAX,F,"1,019",688,173,110,145,"1,261","3,396"
Northumberland,BAX,M,"1,008",585,148,15,3,190,"1,949"
Northumberland,BAZ,F,0,0,0,0,0,2,2
Northumberland,BAZ,M,0,1,1,0,1,0,3
Northumberland,BAZX,F,24,8,8,4,0,11,55
Northumberland,BAZX,M,25,15,1,0,0,0,41
Northumberland,BB,F,37,51,52,50,53,309,552
Northumberland,BB,M,40,28,21,10,15,54,168
Northumberland,BBX,F,"1,149","1,024",709,603,533,"2,298","6,316"
Northumberland,BBX,M,"1,269",822,102,17,7,71,"2,288"
Northumberland,BF,F,228,197,192,166,199,338,"1,320"
Northumberland,BF,M,231,94,21,3,4,3,356
Northumberland,BFX,F,8,10,0,2,4,8,32
Northumberland,BFX,M,13,8,1,0,0,0,22
Northumberland,BG,F,45,33,33,29,15,48,203
Northumberland,BG,M,69,136,45,21,3,6,280
Northumberland,BGX,F,23,13,5,4,8,15,68
Northumberland,BGX,M,24,19,2,0,0,0,45
Northumberland,BH,F,0,0,0,0,0,67,67
Northumberland,BLG,F,63,10,2,2,15,121,213
Northumberland,BLG,M,62,9,2,0,0,0,73
Northumberland,BLGX,F,0,0,0,0,0,1,1
Northumberland,BRX,M,0,1,0,0,0,0,1
Northumberland,BS,F,5,4,5,7,0,11,32
Northumberland,BS,M,2,3,1,0,0,0,6
Northumberland,BSH,F,10,19,6,7,7,16,65
Northumberland,BSH,M,18,12,4,6,2,1,43
Northumberland,BSHX,F,139,65,12,10,5,30,261
Northumberland,BSHX,M,165,47,2,0,0,2,216
Northumberland,BSX,F,6,19,6,13,5,1,50
Northumberland,BSX,M,2,0,2,0,0,0,4
Northumberland,BU,F,1,1,0,1,1,0,4
Northumberland,BU,M,1,0,0,0,0,1,2
Northumberland,BW,F,3,3,2,1,0,2,11
Northumberland,BW,M,3,1,0,1,0,0,5
Northumberland,BWX,F,0,0,0,1,1,0,2
Northumberland,BWX,M,2,1,0,0,0,0,3
Northumberland,BX,F,0,0,0,0,0,1,1
Northumberland,CB,F,1,0,0,0,1,118,120
Northumberland,CB,M,1,1,0,0,0,0,2
Northumberland,CD,F,2,0,0,0,0,0,2
Northumberland,CD,M,4,0,0,0,0,1,5
Northumberland,CH,F,226,170,135,115,86,492,"1,224"
Northumberland,CH,M,202,138,30,36,34,167,607
Northumberland,CHI,F,0,0,0,0,0,1,1
Northumberland,CHI,M,0,1,0,0,0,0,1
Northumberland,CHIX,F,2,0,0,0,1,6,9
Northumberland,CHIX,M,0,4,0,0,0,0,4
Northumberland,CHLX,M,2,0,0,0,0,0,2
Northumberland,CHX,F,"2,876","2,215",233,79,90,"1,803","7,296"
Northumberland,CHX,M,"2,864","2,449",257,14,4,365,"5,953"
Northumberland,DE,F,0,0,0,0,0,2,2
Northumberland,DEV,F,0,0,0,0,0,2,2
Northumberland,DEV,M,0,0,2,0,0,0,2
Northumberland,DEVX,F,0,0,1,0,0,10,11
Northumberland,DEX,F,46,39,26,26,22,67,226
Northumberland,DEX,M,40,56,18,3,2,4,123
Northumberland,DEXX,F,0,1,0,1,0,0,2
Northumberland,DEXX,M,1,0,0,0,0,0,1
Northumberland,DG,F,0,0,0,0,0,17,17
Northumberland,DS,F,61,59,67,61,23,90,361
Northumberland,DS,M,13,8,0,0,0,0,21
Northumberland,DSHO,F,2,0,0,0,0,4,6
Northumberland,DSHO,M,1,0,0,0,0,0,1
Northumberland,DSX,F,0,2,1,1,2,4,10
Northumberland,DSX,M,8,5,0,0,0,0,13
Northumberland,DV,F,0,0,0,0,0,15,15
Northumberland,DVX,F,0,0,0,0,0,25,25
Northumberland,FR,F,0,0,0,0,0,"1,218","1,218"
Northumberland,FR,M,0,0,0,0,0,132,132
Northumberland,FRX,F,0,0,0,0,0,27,27
Northumberland,FRX,M,0,0,0,0,0,10,10
Northumberland,GA,F,109,152,121,122,77,556,"1,137"
Northumberland,GA,M,125,127,46,18,2,11,329
Northumberland,GAS,F,0,0,0,0,0,4,4
Northumberland,GASX,F,1,0,0,0,0,0,1
Northumberland,GASX,M,0,0,1,0,0,0,1
Northumberland,GAX,F,42,17,9,7,5,112,192
Northumberland,GAX,M,65,21,3,1,0,4,94
Northumberland,GBX,F,1,3,2,0,1,0,7
Northumberland,GBX,M,1,1,0,0,0,0,2
Northumberland,GE,F,6,4,2,1,2,11,26
Northumberland,GE,M,1,4,0,0,1,0,6
Northumberland,GEX,F,0,0,0,0,1,4,5
Northumberland,GEX,M,0,2,0,0,0,0,2
Northumberland,GU,M,1,0,0,0,0,0,1
Northumberland,GUX,F,0,0,0,0,0,2,2
Northumberland,H,F,0,0,0,0,0,55,55
Northumberland,H,M,0,0,0,0,0,2,2
Northumberland,HE,F,26,18,17,26,12,79,178
Northumberland,HE,M,33,31,12,4,2,1,83
Northumberland,HEBL,F,0,0,0,0,0,6,6
Northumberland,HEBLX,F,0,0,0,0,0,115,115
Northumberland,HER,F,0,0,0,0,0,3,3
Northumberland,HERX,F,0,0,0,0,0,34,34
Northumberland,HEX,F,117,179,170,123,151,824,"1,564"
Northumberland,HEX,M,259,270,48,0,0,1,578
Northumberland,HF,F,"1,081",905,"1,038",949,857,"1,641","6,471"
Northumberland,HF,M,632,430,128,25,12,55,"1,282"
Northumberland,HFX,F,14,6,3,7,5,24,59
Northumberland,HFX,M,21,20,3,0,0,0,44
Northumberland,HI,F,38,44,39,27,20,128,296
Northumberland,HI,M,40,35,24,30,11,14,154
Northumberland,HIX,F,2,1,2,0,1,20,26
Northumberland,HIX,M,1,1,1,0,0,1,4
Northumberland,HL,F,0,0,0,0,0,9,9
Northumberland,HL,M,0,0,0,0,0,1,1
Northumberland,HO,F,264,290,284,254,209,432,"1,733"
Northumberland,HO,M,73,91,21,0,1,7,193
Northumberland,HOX,F,19,16,15,16,12,18,96
Northumberland,HOX,M,3,3,0,5,0,0,11
Northumberland,HX,F,0,0,0,0,0,260,260
Northumberland,HX,M,0,0,0,0,0,3,3
Northumberland,JE,F,36,30,32,26,37,39,200
Northumberland,JE,M,10,1,0,0,0,0,11
Northumberland,JEX,F,0,3,0,1,0,0,4
Northumberland,JEX,M,0,0,0,0,0,1,1
Northumberland,JY,F,15,0,0,0,0,1,16
Northumberland,JY,M,13,0,0,0,0,0,13
Northumberland,LH,F,26,15,16,20,5,27,109
Northumberland,LH,M,37,28,13,6,2,2,88
Northumberland,LHX,F,1,0,6,1,4,25,37
Northumberland,LHX,M,1,4,0,0,0,0,5
Northumberland,LI,F,0,0,0,0,0,378,378
Northumberland,LI,M,0,0,0,0,0,137,137
Northumberland,LIM,F,647,536,341,316,303,"1,299","3,442"
Northumberland,LIM,M,680,480,135,98,82,375,"1,850"
Northumberland,LIM X,F,0,0,0,0,0,3,3
Northumberland,LIM X,M,0,0,0,0,0,4,4
Northumberland,LIMB,F,0,0,0,0,0,18,18
Northumberland,LIMB,M,0,0,0,0,0,2,2
Northumberland,LIMBX,F,0,0,0,0,0,659,659
Northumberland,LIMBX,M,0,0,0,0,0,5,5
Northumberland,LIMR,F,0,0,0,0,0,36,36
Northumberland,LIMR,M,0,0,0,0,0,16,16
Northumberland,LIMRX,F,0,0,0,0,0,266,266
Northumberland,LIMRX,M,0,0,0,0,0,5,5
Northumberland,LIMX,F,"11,849","7,363","2,437","2,101","2,175","11,664","37,589"
Northumberland,LIMX,M,"11,957","7,671",871,86,35,98,"20,718"
Northumberland,LIX,F,0,0,0,0,0,"3,878","3,878"
Northumberland,LIX,M,0,0,0,0,0,707,707
Northumberland,LM,F,0,0,0,0,0,84,84
Northumberland,LM,M,0,0,0,0,0,29,29
Northumberland,LMX,F,0,0,0,0,0,328,328
Northumberland,LMX,M,0,0,0,0,0,1,1
Northumberland,LR,F,0,2,0,0,0,0,2
Northumberland,LR,M,0,1,0,0,0,0,1
Northumberland,LRX,F,0,0,0,0,7,14,21
Northumberland,LU,F,58,29,45,63,37,109,341
Northumberland,LU,M,56,37,4,0,2,2,101
Northumberland,LUX,F,38,32,16,1,1,26,114
Northumberland,LUX,M,18,26,2,0,0,0,46
Northumberland,MA,F,0,0,0,0,0,1,1
Northumberland,MAX,F,0,0,0,0,0,10,10
Northumberland,MG,F,0,0,0,0,0,2,2
Northumberland,MGX,F,0,0,2,0,0,1,3
Northumberland,MO,F,0,10,0,0,1,3,14
Northumberland,MO,M,1,9,0,1,1,0,12
Northumberland,MOX,F,59,16,5,3,3,5,91
Northumberland,MOX,M,57,30,0,0,0,0,87
Northumberland,MRI,F,0,2,0,2,0,2,6
Northumberland,MRI,M,1,4,2,0,0,0,7
Northumberland,MRIX,F,23,1,1,0,31,23,79
Northumberland,MRIX,M,11,5,0,0,0,0,16
Northumberland,ND,F,0,0,0,0,0,1,1
Northumberland,NOX,F,0,0,0,1,2,4,7
Northumberland,NOX,M,2,1,0,0,0,0,3
Northumberland,NRX,F,0,0,0,0,1,1,2
Northumberland,NS,F,0,0,0,0,0,284,284
Northumberland,NS,M,0,0,0,0,0,1,1
Northumberland,OB,F,0,0,0,0,0,9,9
Northumberland,PAX,F,15,2,3,0,1,16,37
Northumberland,PAX,M,8,7,1,0,1,0,17
Northumberland,PI,F,3,2,0,0,0,10,15
Northumberland,PI,M,1,0,0,0,0,2,3
Northumberland,PIX,F,0,2,0,3,10,22,37
Northumberland,PIX,M,0,0,1,0,0,2,3
Northumberland,RO,F,0,0,0,0,1,1,2
Northumberland,RO,M,1,1,1,1,0,2,6
Northumberland,ROX,F,0,0,1,2,3,27,33
Northumberland,ROX,M,0,2,0,2,0,6,10
Northumberland,RP,F,10,4,0,3,17,3,37
Northumberland,RP,M,9,5,1,0,0,0,15
Northumberland,RPX,F,10,0,0,0,0,1,11
Northumberland,RPX,M,10,0,0,0,0,0,10
Northumberland,RWFR,F,0,0,0,0,0,1,1
Northumberland,SA,F,20,16,16,11,12,56,131
Northumberland,SA,M,16,10,1,4,3,12,46
Northumberland,SAX,F,96,96,50,44,64,332,682
Northumberland,SAX,M,84,60,12,1,0,34,191
Northumberland,SD,F,50,46,28,14,18,130,286
Northumberland,SD,M,62,43,1,3,2,3,114
Northumberland,SDX,F,16,29,46,37,69,137,334
Northumberland,SDX,M,13,29,0,0,0,0,42
Northumberland,SH,F,0,0,0,0,0,2,2
Northumberland,SH,M,2,1,0,0,0,0,3
Northumberland,SHO,F,3,20,1,2,5,86,117
Northumberland,SHO,M,24,18,1,1,2,5,51
Northumberland,SHOX,F,64,25,16,20,2,103,230
Northumberland,SHOX,M,72,33,2,0,1,15,123
Northumberland,SHX,F,0,0,0,0,0,5,5
Northumberland,SM,F,122,95,95,76,81,494,963
Northumberland,SM,M,150,146,22,12,14,51,395
Northumberland,SMX,F,"1,147","1,181",509,516,626,"4,137","8,116"
Northumberland,SMX,M,"1,301","1,165",205,7,1,112,"2,791"
Northumberland,SRW,F,5,2,0,0,0,0,7
Northumberland,SRW,M,8,0,0,0,0,0,8
Northumberland,SRWX,F,3,9,1,0,7,1,21
Northumberland,SRWX,M,5,0,0,0,0,0,5
Northumberland,ST,F,43,27,22,23,11,0,126
Northumberland,ST,M,69,21,14,16,15,4,139
Northumberland,STX,F,"1,006",816,421,268,156,76,"2,743"
Northumberland,STX,M,"1,018",325,4,2,0,0,"1,349"
Northumberland,SU,F,4,0,0,3,1,8,16
Northumberland,SU,M,3,0,0,0,0,0,3
Northumberland,SUX,F,1,0,0,0,4,17,22
Northumberland,SUX,M,2,0,0,0,0,1,3
Northumberland,WB,F,6,28,19,6,11,61,131
Northumberland,WB,M,16,8,3,0,0,6,33
Northumberland,WBX,F,11,3,4,5,2,59,84
Northumberland,WBX,M,7,1,1,0,0,0,9
Northumberland,WG,F,13,9,13,7,4,21,67
Northumberland,WG,M,16,21,8,1,1,0,47
Northumberland,WGX,F,3,3,0,0,0,1,7
Northumberland,WGX,M,2,0,0,0,0,0,2
Northumberland,WP,F,2,1,1,0,0,2,6
Northumberland,WP,M,1,1,1,0,0,0,3
Northumberland,WS,F,9,7,5,1,3,7,32
Northumberland,WS,M,5,4,1,2,1,11,24
Northumberland,WSX,F,61,37,10,16,2,50,176
Northumberland,WSX,M,52,19,8,1,1,0,81
Nottinghamshire,AA,F,117,106,54,36,39,202,554
Nottinghamshire,AA,M,126,71,18,10,4,21,250
Nottinghamshire,AAX,F,416,432,125,59,40,260,"1,332"
Nottinghamshire,AAX,M,469,353,55,10,1,13,901
Nottinghamshire,AM,F,0,1,0,0,0,0,1
Nottinghamshire,AY,F,0,1,1,0,0,15,17
Nottinghamshire,AY,M,3,8,3,0,1,1,16
Nottinghamshire,AYX,F,0,0,2,0,0,1,3
Nottinghamshire,AYX,M,0,4,0,0,0,0,4
Nottinghamshire,BA,F,38,37,13,23,16,113,240
Nottinghamshire,BA,M,51,33,2,8,3,23,120
Nottinghamshire,BABX,F,0,0,0,0,0,3,3
Nottinghamshire,BAL,F,0,0,0,0,0,1,1
Nottinghamshire,BAL,M,1,3,0,0,0,0,4
Nottinghamshire,BALX,M,0,0,0,1,0,0,1
Nottinghamshire,BARX,M,0,0,0,0,0,1,1
Nottinghamshire,BAX,F,395,398,107,66,56,283,"1,305"
Nottinghamshire,BAX,M,431,327,56,6,8,22,850
Nottinghamshire,BAZ,F,9,6,0,2,2,12,31
Nottinghamshire,BAZ,M,5,8,4,0,0,1,18
Nottinghamshire,BAZX,F,36,31,14,1,5,13,100
Nottinghamshire,BAZX,M,22,36,7,0,1,1,67
Nottinghamshire,BB,F,65,90,25,23,15,109,327
Nottinghamshire,BB,M,114,81,25,3,2,17,242
Nottinghamshire,BBX,F,415,504,158,60,50,243,"1,430"
Nottinghamshire,BBX,M,855,698,174,5,4,24,"1,760"
Nottinghamshire,BF,F,335,265,321,325,332,475,"2,053"
Nottinghamshire,BF,M,506,249,81,8,5,8,857
Nottinghamshire,BFX,F,16,36,32,23,19,35,161
Nottinghamshire,BFX,M,41,20,19,0,0,0,80
Nottinghamshire,BG,F,3,0,1,1,0,2,7
Nottinghamshire,BG,M,1,0,0,0,0,0,1
Nottinghamshire,BGX,F,0,0,0,0,0,1,1
Nottinghamshire,BH,F,0,0,0,0,0,49,49
Nottinghamshire,BH,M,2,0,0,0,0,0,2
Nottinghamshire,BHX,F,7,0,0,0,0,8,15
Nottinghamshire,BHX,M,8,0,0,0,0,1,9
Nottinghamshire,BRX,M,0,1,0,0,0,0,1
Nottinghamshire,BS,F,8,3,1,3,1,3,19
Nottinghamshire,BS,M,10,6,0,0,0,0,16
Nottinghamshire,BSH,F,5,12,28,25,5,18,93
Nottinghamshire,BSH,M,15,10,0,1,0,1,27
Nottinghamshire,BSHO,F,0,0,0,0,0,1,1
Nottinghamshire,BSHX,F,20,22,3,6,5,10,66
Nottinghamshire,BSHX,M,39,21,4,1,0,0,65
Nottinghamshire,BSX,F,23,1,1,0,2,6,33
Nottinghamshire,BSX,M,16,11,1,0,0,1,29
Nottinghamshire,BU,F,1,1,0,0,1,2,5
Nottinghamshire,BU,M,1,0,0,0,1,1,3
Nottinghamshire,BW,F,0,0,0,0,1,3,4
Nottinghamshire,BW,M,0,8,1,0,0,0,9
Nottinghamshire,BWX,F,0,1,0,0,1,2,4
Nottinghamshire,BWX,M,1,0,0,0,0,0,1
Nottinghamshire,CB,F,0,0,1,0,0,0,1
Nottinghamshire,CB,M,0,1,0,0,0,0,1
Nottinghamshire,CD,F,0,7,0,0,0,0,7
Nottinghamshire,CD,M,0,1,0,0,0,0,1
Nottinghamshire,CH,F,246,215,110,83,94,556,"1,304"
Nottinghamshire,CH,M,264,236,46,19,13,61,639
Nottinghamshire,CHIX,F,0,2,0,0,1,7,10
Nottinghamshire,CHIX,M,1,0,1,0,0,0,2
Nottinghamshire,CHX,F,357,601,127,59,49,392,"1,585"
Nottinghamshire,CHX,M,569,921,191,12,5,34,"1,732"
Nottinghamshire,DE,F,0,0,0,0,0,1,1
Nottinghamshire,DE,M,0,0,0,0,0,1,1
Nottinghamshire,DEV,F,0,0,0,0,0,5,5
Nottinghamshire,DEV,M,0,0,0,0,0,1,1
Nottinghamshire,DEVX,F,4,0,2,0,0,2,8
Nottinghamshire,DEVX,M,1,0,0,0,0,0,1
Nottinghamshire,DEX,F,41,60,30,15,17,97,260
Nottinghamshire,DEX,M,50,34,14,4,1,6,109
Nottinghamshire,DEXX,F,5,8,1,0,1,9,24
Nottinghamshire,DEXX,M,9,4,3,0,0,0,16
Nottinghamshire,DS,F,22,28,20,14,20,24,128
Nottinghamshire,DS,M,25,6,2,0,0,1,34
Nottinghamshire,DSHO,F,1,0,0,0,0,0,1
Nottinghamshire,DSHO,M,0,0,0,0,0,1,1
Nottinghamshire,DSX,F,7,6,6,4,2,5,30
Nottinghamshire,DSX,M,3,2,0,0,0,1,6
Nottinghamshire,DV,F,0,0,0,0,0,31,31
Nottinghamshire,DV,M,0,0,0,0,0,2,2
Nottinghamshire,DVX,F,0,0,0,0,0,15,15
Nottinghamshire,FR,F,0,0,0,0,0,"1,566","1,566"
Nottinghamshire,FR,M,0,0,0,0,0,70,70
Nottinghamshire,FRX,F,0,0,0,0,0,56,56
Nottinghamshire,FRX,M,0,0,0,0,0,11,11
Nottinghamshire,GA,F,0,0,0,0,0,3,3
Nottinghamshire,GA,M,1,0,0,1,0,0,2
Nottinghamshire,GASX,F,0,0,0,0,0,2,2
Nottinghamshire,GASX,M,1,0,0,0,0,0,1
Nottinghamshire,GAX,F,0,0,1,1,1,0,3
Nottinghamshire,GAX,M,0,2,2,5,2,0,11
Nottinghamshire,GE,F,0,1,0,0,0,0,1
Nottinghamshire,GEX,F,0,0,0,0,0,1,1
Nottinghamshire,GEX,M,2,1,3,0,0,0,6
Nottinghamshire,GL,F,0,0,0,1,0,0,1
Nottinghamshire,GL,M,0,0,0,0,0,1,1
Nottinghamshire,GLX,F,0,1,1,0,0,0,2
Nottinghamshire,GLX,M,0,1,0,0,0,0,1
Nottinghamshire,GU,F,1,0,0,1,0,6,8
Nottinghamshire,GU,M,0,1,0,0,0,0,1
Nottinghamshire,GUX,F,0,0,0,0,0,1,1
Nottinghamshire,H,F,0,0,0,0,0,49,49
Nottinghamshire,H,M,0,0,0,0,0,12,12
Nottinghamshire,HE,F,41,29,22,22,18,82,214
Nottinghamshire,HE,M,51,45,6,6,5,12,125
Nottinghamshire,HEBL,F,0,0,0,0,0,1,1
Nottinghamshire,HEBLX,F,0,0,0,0,0,17,17
Nottinghamshire,HER,F,0,0,0,0,0,3,3
Nottinghamshire,HERX,F,0,0,0,0,0,4,4
Nottinghamshire,HEX,F,259,238,106,53,54,148,858
Nottinghamshire,HEX,M,260,267,46,10,1,5,589
Nottinghamshire,HF,F,"1,415","1,157","1,199","1,149","1,000","1,966","7,886"
Nottinghamshire,HF,M,"1,052",796,235,37,16,30,"2,166"
Nottinghamshire,HFX,F,101,102,93,113,94,178,681
Nottinghamshire,HFX,M,50,31,10,2,0,1,94
Nottinghamshire,HI,F,12,9,7,6,8,25,67
Nottinghamshire,HI,M,8,8,2,2,3,2,25
Nottinghamshire,HIX,F,0,1,0,1,1,7,10
Nottinghamshire,HIX,M,2,3,0,0,0,1,6
Nottinghamshire,HL,F,0,0,0,0,0,6,6
Nottinghamshire,HO,F,102,122,194,165,155,310,"1,048"
Nottinghamshire,HO,M,219,73,24,10,2,3,331
Nottinghamshire,HOX,F,6,8,10,5,10,14,53
Nottinghamshire,HOX,M,3,2,0,0,1,0,6
Nottinghamshire,HX,F,0,0,0,0,0,126,126
Nottinghamshire,HX,M,0,0,0,0,0,12,12
Nottinghamshire,IM,F,9,12,4,2,3,4,34
Nottinghamshire,IM,M,1,0,0,0,0,2,3
Nottinghamshire,IMX,F,0,0,2,2,0,0,4
Nottinghamshire,JE,F,86,68,182,54,31,155,576
Nottinghamshire,JE,M,34,3,2,1,1,7,48
Nottinghamshire,JEX,F,5,0,1,5,1,3,15
Nottinghamshire,JEX,M,1,1,1,3,0,0,6
Nottinghamshire,JY,F,0,0,0,0,0,11,11
Nottinghamshire,JYX,F,0,0,0,0,0,1,1
Nottinghamshire,KE,F,0,0,0,0,1,3,4
Nottinghamshire,KE,M,3,4,2,0,1,0,10
Nottinghamshire,LH,F,34,21,18,19,14,86,192
Nottinghamshire,LH,M,30,11,5,0,4,6,56
Nottinghamshire,LHX,F,2,16,2,1,0,5,26
Nottinghamshire,LHX,M,4,5,2,0,0,0,11
Nottinghamshire,LI,F,0,0,0,0,0,72,72
Nottinghamshire,LI,M,0,0,0,0,0,19,19
Nottinghamshire,LIM,F,387,392,122,106,78,276,"1,361"
Nottinghamshire,LIM,M,439,320,90,34,18,48,949
Nottinghamshire,LIM X,F,0,0,0,0,0,1,1
Nottinghamshire,LIMB,F,0,0,0,0,0,4,4
Nottinghamshire,LIMBX,F,0,0,0,0,0,15,15
Nottinghamshire,LIMBX,M,0,0,0,0,0,2,2
Nottinghamshire,LIMR,F,0,0,0,0,0,22,22
Nottinghamshire,LIMR,M,0,0,0,0,0,4,4
Nottinghamshire,LIMRX,F,0,0,0,0,0,51,51
Nottinghamshire,LIMRX,M,0,0,0,0,0,2,2
Nottinghamshire,LIMX,F,"1,407","1,407",353,186,141,610,"4,104"
Nottinghamshire,LIMX,M,"1,845","1,708",343,23,10,35,"3,964"
Nottinghamshire,LIX,F,0,0,0,0,0,208,208
Nottinghamshire,LIX,M,0,0,0,0,0,44,44
Nottinghamshire,LM,F,0,0,0,0,0,15,15
Nottinghamshire,LM,M,0,0,0,0,0,2,2
Nottinghamshire,LMX,F,0,0,0,0,0,3,3
Nottinghamshire,LR,F,23,8,19,10,10,35,105
Nottinghamshire,LR,M,24,5,1,1,1,1,33
Nottinghamshire,LRX,F,27,11,6,4,1,11,60
Nottinghamshire,LRX,M,13,7,3,0,0,0,23
Nottinghamshire,MG,F,0,0,0,0,0,2,2
Nottinghamshire,MG,M,1,0,2,0,0,0,3
Nottinghamshire,MGX,F,0,1,0,0,0,0,1
Nottinghamshire,MGX,M,0,0,2,0,0,0,2
Nottinghamshire,MO,F,1,0,1,1,0,1,4
Nottinghamshire,MO,M,1,6,1,1,0,0,9
Nottinghamshire,MOX,F,0,1,0,1,0,5,7
Nottinghamshire,MOX,M,8,12,2,1,0,0,23
Nottinghamshire,MRI,F,0,4,0,2,0,7,13
Nottinghamshire,MRI,M,1,2,0,0,0,1,4
Nottinghamshire,MRIX,F,0,1,0,0,4,13,18
Nottinghamshire,MRIX,M,7,6,6,0,0,0,19
Nottinghamshire,NDX,F,0,0,0,0,0,1,1
Nottinghamshire,NOX,F,0,0,0,0,1,2,3
Nottinghamshire,NRX,M,2,0,0,0,0,0,2
Nottinghamshire,NS,F,0,0,0,0,0,154,154
Nottinghamshire,NS,M,0,0,0,0,0,2,2
Nottinghamshire,OEX,F,0,0,1,0,0,0,1
Nottinghamshire,PA,F,0,0,0,1,1,1,3
Nottinghamshire,PA,M,1,1,0,0,0,1,3
Nottinghamshire,PAX,F,17,14,1,0,1,13,46
Nottinghamshire,PAX,M,19,15,0,0,0,0,34
Nottinghamshire,PI,F,0,0,0,0,0,3,3
Nottinghamshire,PIX,F,1,6,1,2,1,8,19
Nottinghamshire,PIX,M,2,4,1,0,0,0,7
Nottinghamshire,RO,F,1,0,0,3,1,14,19
Nottinghamshire,RO,M,1,1,0,1,0,2,5
Nottinghamshire,ROX,F,5,4,0,5,2,56,72
Nottinghamshire,ROX,M,8,9,0,1,0,10,28
Nottinghamshire,RP,F,0,1,1,0,0,5,7
Nottinghamshire,RP,M,0,0,0,0,0,4,4
Nottinghamshire,RPX,F,7,6,0,0,0,3,16
Nottinghamshire,RPX,M,10,1,6,0,0,0,17
Nottinghamshire,RWFR,F,0,0,0,0,0,1,1
Nottinghamshire,SA,F,0,0,0,0,0,2,2
Nottinghamshire,SA,M,0,3,3,0,0,0,6
Nottinghamshire,SAX,F,19,51,9,2,5,41,127
Nottinghamshire,SAX,M,32,33,7,0,0,3,75
Nottinghamshire,SD,F,36,41,54,40,31,71,273
Nottinghamshire,SD,M,51,27,6,0,0,2,86
Nottinghamshire,SDX,F,29,37,13,27,7,34,147
Nottinghamshire,SDX,M,39,30,4,0,0,1,74
Nottinghamshire,SH,F,0,0,0,1,0,1,2
Nottinghamshire,SHO,F,27,4,3,4,0,15,53
Nottinghamshire,SHO,M,36,6,2,1,0,3,48
Nottinghamshire,SHOX,F,3,3,1,1,0,6,14
Nottinghamshire,SHOX,M,6,38,1,0,0,0,45
Nottinghamshire,SHX,F,0,0,1,0,0,1,2
Nottinghamshire,SM,F,166,108,79,42,34,338,767
Nottinghamshire,SM,M,218,122,38,10,10,49,447
Nottinghamshire,SMX,F,557,485,158,77,116,678,"2,071"
Nottinghamshire,SMX,M,760,527,147,6,8,86,"1,534"
Nottinghamshire,SOBX,M,0,1,0,0,0,0,1
Nottinghamshire,SRW,F,1,0,0,0,0,0,1
Nottinghamshire,SRW,M,1,0,0,0,0,0,1
Nottinghamshire,SRWX,F,9,0,0,1,7,0,17
Nottinghamshire,SRWX,M,17,4,0,0,0,0,21
Nottinghamshire,STX,F,1,0,0,0,0,0,1
Nottinghamshire,SUX,F,0,1,0,0,0,4,5
Nottinghamshire,SUX,M,0,3,0,0,0,0,3
Nottinghamshire,WB,F,1,0,0,0,1,1,3
Nottinghamshire,WB,M,0,1,1,0,0,1,3
Nottinghamshire,WBX,F,3,1,1,1,0,8,14
Nottinghamshire,WBX,M,2,8,2,0,0,1,13
Nottinghamshire,WG,F,0,1,0,0,0,1,2
Nottinghamshire,WGX,M,0,0,1,0,0,0,1
Nottinghamshire,WP,F,2,4,1,2,0,7,16
Nottinghamshire,WP,M,6,2,1,0,0,2,11
Nottinghamshire,WPX,F,0,1,0,0,0,0,1
Nottinghamshire,WPX,M,0,1,0,0,0,0,1
Nottinghamshire,WSX,M,0,5,0,0,0,0,5
Oxfordshire,AA,F,351,279,124,107,86,428,"1,375"
Oxfordshire,AA,M,397,276,80,18,9,44,824
Oxfordshire,AAX,F,"1,206","1,090",403,164,146,753,"3,762"
Oxfordshire,AAX,M,"1,560","1,914",465,12,1,34,"3,986"
Oxfordshire,ARX,F,1,2,0,0,0,1,4
Oxfordshire,ARX,M,0,1,0,0,0,0,1
Oxfordshire,AY,F,1,1,2,1,3,5,13
Oxfordshire,AY,M,5,0,0,0,0,0,5
Oxfordshire,AYX,F,0,12,37,2,0,1,52
Oxfordshire,AYX,M,0,1,0,0,0,0,1
Oxfordshire,BA,F,66,60,40,25,16,103,310
Oxfordshire,BA,M,79,39,9,3,3,30,163
Oxfordshire,BAB,F,0,0,0,0,0,1,1
Oxfordshire,BABX,F,0,0,0,0,0,17,17
Oxfordshire,BAL,F,1,0,0,0,0,0,1
Oxfordshire,BAL,M,1,0,0,0,0,0,1
Oxfordshire,BALX,F,0,2,2,3,4,1,12
Oxfordshire,BARX,F,0,0,0,0,0,23,23
Oxfordshire,BAWX,F,0,0,0,0,0,4,4
Oxfordshire,BAX,F,488,439,167,59,59,406,"1,618"
Oxfordshire,BAX,M,522,337,56,3,3,23,944
Oxfordshire,BAZ,M,0,1,0,1,0,0,2
Oxfordshire,BAZX,F,5,7,0,1,0,1,14
Oxfordshire,BAZX,M,9,13,1,0,0,0,23
Oxfordshire,BB,F,37,51,22,15,10,61,196
Oxfordshire,BB,M,42,39,7,12,7,28,135
Oxfordshire,BBX,F,728,701,393,239,138,426,"2,625"
Oxfordshire,BBX,M,753,584,181,4,2,40,"1,564"
Oxfordshire,BF,F,148,279,343,275,260,832,"2,137"
Oxfordshire,BF,M,267,205,70,13,1,3,559
Oxfordshire,BFX,F,40,55,78,20,14,31,238
Oxfordshire,BFX,M,64,57,17,1,0,0,139
Oxfordshire,BG,F,4,7,3,2,4,12,32
Oxfordshire,BG,M,8,3,1,0,1,1,14
Oxfordshire,BGX,F,0,0,0,1,2,15,18
Oxfordshire,BGX,M,2,0,0,0,0,0,2
Oxfordshire,BH,F,4,0,0,0,0,79,83
Oxfordshire,BH,M,1,0,0,0,0,1,2
Oxfordshire,BHX,F,0,0,0,0,0,12,12
Oxfordshire,BHX,M,1,0,0,0,0,0,1
Oxfordshire,BI,F,7,0,2,3,5,6,23
Oxfordshire,BI,M,8,0,0,0,0,1,9
Oxfordshire,BLGX,M,0,1,0,0,0,0,1
Oxfordshire,BRX,M,0,0,1,0,0,0,1
Oxfordshire,BS,F,8,10,26,13,36,24,117
Oxfordshire,BS,M,9,10,2,0,0,0,21
Oxfordshire,BSH,F,13,17,11,4,2,16,63
Oxfordshire,BSH,M,10,16,3,2,0,1,32
Oxfordshire,BSHX,F,3,8,3,7,3,7,31
Oxfordshire,BSHX,M,13,10,0,2,0,0,25
Oxfordshire,BSX,F,15,19,27,6,1,6,74
Oxfordshire,BSX,M,18,32,7,0,0,0,57
Oxfordshire,BU,F,12,1,16,8,2,43,82
Oxfordshire,BU,M,11,2,12,1,0,7,33
Oxfordshire,BW,F,15,4,5,10,13,29,76
Oxfordshire,BW,M,11,10,0,1,0,1,23
Oxfordshire,BWB,F,0,0,0,2,0,0,2
Oxfordshire,BWX,F,3,2,0,0,2,7,14
Oxfordshire,BWX,M,2,0,0,0,0,0,2
Oxfordshire,CAX,F,0,0,0,0,0,2,2
Oxfordshire,CB,F,0,0,0,0,0,5,5
Oxfordshire,CD,M,0,1,0,0,0,0,1
Oxfordshire,CH,F,209,121,91,101,46,312,880
Oxfordshire,CH,M,173,137,29,17,8,38,402
Oxfordshire,CHIX,F,0,0,0,0,0,2,2
Oxfordshire,CHX,F,825,994,360,98,127,804,"3,208"
Oxfordshire,CHX,M,847,944,92,10,1,42,"1,936"
Oxfordshire,CON,F,0,0,0,0,0,12,12
Oxfordshire,CON,M,0,0,0,0,0,2,2
Oxfordshire,DEV,F,45,34,24,16,25,50,194
Oxfordshire,DEV,M,53,35,6,1,0,1,96
Oxfordshire,DEVX,F,11,15,10,8,6,37,87
Oxfordshire,DEVX,M,12,21,1,2,0,0,36
Oxfordshire,DEX,F,91,79,60,48,40,148,466
Oxfordshire,DEX,M,114,87,36,0,4,10,251
Oxfordshire,DEXX,F,2,2,1,2,1,4,12
Oxfordshire,DEXX,M,3,4,1,0,0,2,10
Oxfordshire,DRX,M,0,0,1,0,0,0,1
Oxfordshire,DS,F,1,0,0,2,0,9,12
Oxfordshire,DS,M,1,1,0,0,0,0,2
Oxfordshire,DSHO,M,2,0,0,0,0,0,2
Oxfordshire,DSX,M,1,0,1,0,0,0,2
Oxfordshire,DV,F,0,0,0,0,0,22,22
Oxfordshire,DV,M,0,0,0,0,0,1,1
Oxfordshire,DVX,F,0,0,0,0,0,50,50
Oxfordshire,DVX,M,0,0,0,0,0,9,9
Oxfordshire,FR,F,0,0,0,0,0,"3,176","3,176"
Oxfordshire,FR,M,0,0,0,0,0,102,102
Oxfordshire,FRX,F,0,0,0,0,0,56,56
Oxfordshire,FRX,M,0,0,0,0,0,18,18
Oxfordshire,GA,F,0,0,0,0,0,2,2
Oxfordshire,GAX,F,4,3,0,0,2,2,11
Oxfordshire,GAX,M,2,0,0,0,0,0,2
Oxfordshire,GBX,F,0,0,0,0,0,1,1
Oxfordshire,GBX,M,0,1,0,0,0,0,1
Oxfordshire,GE,F,2,1,1,1,0,2,7
Oxfordshire,GE,M,6,1,0,1,0,0,8
Oxfordshire,GEX,F,4,7,2,3,2,5,23
Oxfordshire,GEX,M,4,2,0,0,0,0,6
Oxfordshire,GL,F,1,1,1,0,0,9,12
Oxfordshire,GL,M,1,0,0,0,0,1,2
Oxfordshire,GLX,M,2,2,0,0,0,0,4
Oxfordshire,GU,F,0,0,2,1,0,38,41
Oxfordshire,GU,M,7,1,0,0,0,0,8
Oxfordshire,H,F,0,0,0,0,0,64,64
Oxfordshire,H,M,0,0,0,0,0,9,9
Oxfordshire,HE,F,72,68,27,27,30,70,294
Oxfordshire,HE,M,82,71,23,7,5,8,196
Oxfordshire,HEBL,F,0,0,0,0,0,2,2
Oxfordshire,HEBLX,F,0,0,0,0,0,70,70
Oxfordshire,HER,F,0,0,0,0,0,3,3
Oxfordshire,HERX,F,0,0,0,0,0,16,16
Oxfordshire,HEX,F,492,505,238,211,173,753,"2,372"
Oxfordshire,HEX,M,557,661,280,3,2,9,"1,512"
Oxfordshire,HF,F,"1,676","1,626","1,582","1,468","1,226","1,644","9,222"
Oxfordshire,HF,M,"1,016",645,182,8,3,15,"1,869"
Oxfordshire,HFX,F,137,81,67,82,89,145,601
Oxfordshire,HFX,M,110,43,17,1,0,0,171
Oxfordshire,HI,F,4,19,5,11,6,63,108
Oxfordshire,HI,M,7,5,1,0,1,15,29
Oxfordshire,HIX,F,0,3,0,0,0,7,10
Oxfordshire,HIX,M,1,2,1,0,0,0,4
Oxfordshire,HL,F,0,0,0,0,0,1,1
Oxfordshire,HO,F,259,241,219,199,186,276,"1,380"
Oxfordshire,HO,M,157,71,44,1,3,4,280
Oxfordshire,HOX,F,1,2,11,1,7,11,33
Oxfordshire,HOX,M,2,0,0,0,0,0,2
Oxfordshire,HX,F,0,0,0,0,0,236,236
Oxfordshire,HX,M,0,0,0,0,0,38,38
Oxfordshire,IM,F,0,0,0,0,0,1,1
Oxfordshire,JE,F,127,173,153,127,98,247,925
Oxfordshire,JE,M,11,6,3,0,1,4,25
Oxfordshire,JEX,F,5,0,2,3,7,5,22
Oxfordshire,JEX,M,2,0,0,2,0,1,5
Oxfordshire,JY,F,60,0,0,0,0,1,61
Oxfordshire,JY,M,1,0,0,0,0,0,1
Oxfordshire,KE,F,0,0,0,0,0,1,1
Oxfordshire,LH,F,24,20,16,10,7,40,117
Oxfordshire,LH,M,26,11,5,0,1,6,49
Oxfordshire,LHX,F,3,4,6,8,12,37,70
Oxfordshire,LHX,M,4,2,1,0,0,0,7
Oxfordshire,LI,F,0,0,0,0,0,85,85
Oxfordshire,LI,M,0,0,0,0,0,33,33
Oxfordshire,LIM,F,285,263,137,103,64,300,"1,152"
Oxfordshire,LIM,M,321,186,30,16,10,39,602
Oxfordshire,LIM X,F,0,0,0,0,0,1,1
Oxfordshire,LIMBX,F,0,0,0,0,0,16,16
Oxfordshire,LIMR,F,0,0,0,0,0,5,5
Oxfordshire,LIMR,M,0,0,0,0,0,3,3
Oxfordshire,LIMRX,F,0,0,0,0,0,13,13
Oxfordshire,LIMX,F,"1,315","1,271",540,204,147,798,"4,275"
Oxfordshire,LIMX,M,"1,295","1,067",144,3,3,35,"2,547"
Oxfordshire,LIX,F,0,0,0,0,0,205,205
Oxfordshire,LIX,M,0,0,0,0,0,50,50
Oxfordshire,LM,F,0,0,0,0,0,2,2
Oxfordshire,LMX,F,0,0,0,0,0,6,6
Oxfordshire,LR,F,0,2,2,2,1,0,7
Oxfordshire,LR,M,2,0,0,2,0,0,4
Oxfordshire,LRX,F,6,0,0,0,0,0,6
Oxfordshire,LRX,M,3,0,0,0,0,0,3
Oxfordshire,MARX,F,0,0,0,0,0,1,1
Oxfordshire,MAX,F,0,0,0,0,0,1,1
Oxfordshire,MAX,M,0,3,1,0,0,0,4
Oxfordshire,MG,F,0,0,0,0,0,6,6
Oxfordshire,MGX,F,0,1,1,1,0,6,9
Oxfordshire,MGX,M,2,1,0,0,0,0,3
Oxfordshire,MO,F,0,1,0,0,0,1,2
Oxfordshire,MO,M,1,1,3,0,1,0,6
Oxfordshire,MOX,F,0,0,2,0,0,10,12
Oxfordshire,MOX,M,6,2,2,0,0,0,10
Oxfordshire,MRI,F,2,3,3,2,0,16,26
Oxfordshire,MRI,M,5,2,1,0,0,1,9
Oxfordshire,MRIX,F,4,12,7,0,0,3,26
Oxfordshire,MRIX,M,13,3,2,0,0,0,18
Oxfordshire,ND,F,0,0,0,0,0,4,4
Oxfordshire,NDX,F,0,0,0,0,0,1,1
Oxfordshire,NO,F,0,0,0,0,0,2,2
Oxfordshire,NO,M,0,0,0,0,0,1,1
Oxfordshire,NOX,F,0,0,0,0,0,2,2
Oxfordshire,NOX,M,0,0,1,0,0,0,1
Oxfordshire,NRX,F,14,3,0,0,0,0,17
Oxfordshire,NRX,M,1,0,0,0,0,0,1
Oxfordshire,NS,F,0,0,0,0,0,212,212
Oxfordshire,NS,M,0,0,0,0,0,1,1
Oxfordshire,OE,F,0,0,0,0,0,3,3
Oxfordshire,OEX,F,1,0,0,0,0,0,1
Oxfordshire,PAX,F,0,0,1,0,0,0,1
Oxfordshire,PI,M,1,0,0,0,0,0,1
Oxfordshire,PIX,F,16,6,0,1,3,6,32
Oxfordshire,PIX,M,17,9,0,0,0,0,26
Oxfordshire,RO,F,0,0,0,0,0,4,4
Oxfordshire,RO,M,0,0,0,0,0,2,2
Oxfordshire,ROX,F,0,2,0,0,0,4,6
Oxfordshire,ROX,M,0,0,0,0,0,2,2
Oxfordshire,RP,F,0,0,0,1,0,2,3
Oxfordshire,RP,M,2,0,0,0,0,0,2
Oxfordshire,RPX,M,0,1,0,0,0,0,1
Oxfordshire,SA,F,56,56,5,7,17,57,198
Oxfordshire,SA,M,59,6,4,0,1,5,75
Oxfordshire,SAX,F,66,57,25,11,14,168,341
Oxfordshire,SAX,M,98,63,5,1,0,1,168
Oxfordshire,SD,F,51,41,39,28,28,85,272
Oxfordshire,SD,M,40,40,8,5,3,4,100
Oxfordshire,SDX,F,106,102,53,19,16,141,437
Oxfordshire,SDX,M,146,118,6,0,0,0,270
Oxfordshire,SH,F,1,1,2,0,1,5,10
Oxfordshire,SH,M,2,2,1,3,0,1,9
Oxfordshire,SHO,F,1,2,2,1,1,12,19
Oxfordshire,SHO,M,5,3,2,0,0,2,12
Oxfordshire,SHOX,F,0,5,0,0,0,10,15
Oxfordshire,SHOX,M,0,2,0,0,0,0,2
Oxfordshire,SHX,F,5,1,1,1,0,2,10
Oxfordshire,SHX,M,5,1,2,0,0,0,8
Oxfordshire,SM,F,220,169,90,68,74,276,897
Oxfordshire,SM,M,232,72,34,12,10,31,391
Oxfordshire,SMX,F,926,"1,075",569,220,186,978,"3,954"
Oxfordshire,SMX,M,"1,044",727,139,5,0,36,"1,951"
Oxfordshire,SRW,F,0,0,0,1,4,0,5
Oxfordshire,SRWX,F,65,16,3,0,19,5,108
Oxfordshire,SRWX,M,9,2,16,0,0,0,27
Oxfordshire,SU,F,12,9,26,24,3,30,104
Oxfordshire,SU,M,15,34,0,1,0,0,50
Oxfordshire,SUX,F,6,7,5,2,3,4,27
Oxfordshire,SUX,M,7,6,0,0,0,0,13
Oxfordshire,TB,F,0,0,0,0,0,1,1
Oxfordshire,TBX,F,0,0,0,0,0,4,4
Oxfordshire,WB,F,18,23,12,4,4,37,98
Oxfordshire,WB,M,25,14,2,0,0,3,44
Oxfordshire,WBX,F,0,1,0,0,0,0,1
Oxfordshire,WBX,M,3,2,1,1,0,0,7
Oxfordshire,WP,F,7,2,6,6,3,29,53
Oxfordshire,WP,M,11,0,1,1,0,0,13
Oxfordshire,WPX,F,0,0,0,0,0,2,2
Oxfordshire,WPX,M,1,0,0,0,0,0,1
Oxfordshire,YK,M,0,0,0,0,0,1,1
Oxfordshire,ZE,F,0,0,0,0,0,3,3
Avon,AA,F,308,296,128,70,55,280,"1,137"
Avon,AA,M,332,310,70,19,14,52,797
Avon,AAX,F,"1,029","1,116",316,114,146,532,"3,253"
Avon,AAX,M,"1,420","1,207",202,4,4,69,"2,906"
Avon,AR,F,0,0,0,1,0,0,1
Avon,ARX,F,0,2,1,1,0,2,6
Avon,ARX,M,1,2,1,0,0,0,4
Avon,AY,F,36,42,36,32,37,77,260
Avon,AY,M,2,0,0,1,0,0,3
Avon,AYX,F,0,5,18,6,5,12,46
Avon,AYX,M,1,0,2,0,0,0,3
Avon,BA,F,111,90,57,34,16,121,429
Avon,BA,M,74,53,15,5,4,10,161
Avon,BABX,F,0,0,0,0,0,6,6
Avon,BABX,M,0,0,0,0,0,1,1
Avon,BAL,M,0,1,0,0,0,0,1
Avon,BARX,F,0,0,0,0,0,4,4
Avon,BAX,F,380,350,117,50,98,242,"1,237"
Avon,BAX,M,358,264,59,4,8,12,705
Avon,BAZ,F,0,0,0,0,0,6,6
Avon,BAZX,F,1,3,0,0,0,1,5
Avon,BAZX,M,0,1,1,0,0,0,2
Avon,BB,F,121,95,30,18,10,111,385
Avon,BB,M,95,80,22,4,2,15,218
Avon,BBX,F,864,580,282,121,111,379,"2,337"
Avon,BBX,M,704,635,191,5,1,30,"1,566"
Avon,BF,F,"1,274","1,203","1,386","1,351","1,357","2,383","8,954"
Avon,BF,M,914,601,245,40,15,25,"1,840"
Avon,BFX,F,157,190,226,157,99,292,"1,121"
Avon,BFX,M,138,67,23,7,3,6,244
Avon,BG,F,6,8,3,1,0,9,27
Avon,BG,M,2,7,2,0,0,1,12
Avon,BGX,F,1,0,0,0,0,5,6
Avon,BGX,M,0,3,0,0,0,0,3
Avon,BH,F,3,0,0,0,0,146,149
Avon,BH,M,8,0,0,0,0,4,12
Avon,BHX,F,10,0,0,0,0,38,48
Avon,BHX,M,6,0,0,0,0,0,6
Avon,BP,M,0,0,1,0,0,0,1
Avon,BR,F,0,0,1,0,0,1,2
Avon,BR,M,1,0,0,0,0,0,1
Avon,BRX,F,0,0,0,1,0,0,1
Avon,BS,F,2,0,1,1,0,5,9
Avon,BS,M,5,2,3,0,0,0,10
Avon,BSH,F,5,5,5,4,3,8,30
Avon,BSH,M,10,4,1,0,0,0,15
Avon,BSHX,F,18,4,0,0,0,1,23
Avon,BSHX,M,3,10,1,0,0,0,14
Avon,BSX,F,38,29,1,0,4,10,82
Avon,BSX,M,41,8,4,0,0,0,53
Avon,BU,F,1,0,8,0,0,1,10
Avon,BU,M,0,0,0,1,0,0,1
Avon,BW,F,0,0,0,1,1,5,7
Avon,BW,M,0,1,0,0,0,1,2
Avon,BWX,F,4,1,1,0,0,5,11
Avon,BWX,M,1,3,1,0,0,0,5
Avon,CB,F,2,0,0,0,0,2,4
Avon,CB,M,3,1,0,0,0,0,4
Avon,CH,F,94,113,52,20,14,212,505
Avon,CH,M,114,75,13,5,6,51,264
Avon,CHX,F,684,917,274,78,82,554,"2,589"
Avon,CHX,M,672,632,177,11,6,73,"1,571"
Avon,DEV,F,17,24,34,22,14,14,125
Avon,DEV,M,29,28,9,3,0,4,73
Avon,DEVX,F,77,85,14,5,4,49,234
Avon,DEVX,M,116,112,32,0,0,2,262
Avon,DEX,F,37,26,14,18,11,53,159
Avon,DEX,M,34,20,13,3,2,6,78
Avon,DEXX,F,8,3,2,1,3,0,17
Avon,DEXX,M,6,2,0,0,0,0,8
Avon,DRX,F,0,0,1,0,1,0,2
Avon,DS,F,4,6,5,3,15,5,38
Avon,DS,M,11,9,2,1,0,0,23
Avon,DSHO,F,0,0,0,0,0,2,2
Avon,DSX,F,0,0,1,0,0,0,1
Avon,DV,F,0,0,0,0,0,2,2
Avon,DVX,F,0,0,0,0,0,10,10
Avon,DVX,M,0,0,0,0,0,1,1
Avon,FR,F,0,0,0,0,0,"5,863","5,863"
Avon,FR,M,0,0,0,0,0,71,71
Avon,FRX,F,0,0,0,0,0,132,132
Avon,FRX,M,0,0,0,0,0,14,14
Avon,GA,F,0,0,0,0,0,1,1
Avon,GA,M,0,0,2,0,0,0,2
Avon,GASX,F,0,0,0,0,0,1,1
Avon,GAX,F,3,0,0,0,0,1,4
Avon,GB,F,1,0,0,0,0,0,1
Avon,GB,M,1,0,0,0,0,0,1
Avon,GBX,F,2,0,0,0,0,0,2
Avon,GE,F,0,1,0,1,0,0,2
Avon,GE,M,0,0,0,0,0,1,1
Avon,GEX,F,5,6,1,0,0,4,16
Avon,GEX,M,2,2,4,1,0,0,9
Avon,GL,F,5,4,1,5,2,24,41
Avon,GL,M,2,5,4,1,0,1,13
Avon,GLX,F,0,2,1,0,0,1,4
Avon,GU,F,179,142,170,116,111,339,"1,057"
Avon,GU,M,21,16,2,1,1,2,43
Avon,GUX,F,0,1,32,5,1,2,41
Avon,H,F,0,0,0,0,0,83,83
Avon,H,M,0,0,0,0,0,19,19
Avon,HE,F,222,124,70,59,37,109,621
Avon,HE,M,230,126,38,11,7,37,449
Avon,HEBL,F,0,0,0,0,0,3,3
Avon,HEBLX,F,0,0,0,0,0,108,108
Avon,HEBLX,M,0,0,0,0,0,2,2
Avon,HER,F,0,0,0,0,0,4,4
Avon,HER,M,0,0,0,0,0,2,2
Avon,HERX,F,0,0,0,0,0,32,32
Avon,HEX,F,"1,027","1,091",407,206,278,725,"3,734"
Avon,HEX,M,"1,261","1,076",226,9,5,25,"2,602"
Avon,HF,F,"3,142","2,987","2,713","2,444","2,282","4,248","17,816"
Avon,HF,M,"2,707",705,269,27,6,20,"3,734"
Avon,HFX,F,160,103,153,96,172,364,"1,048"
Avon,HFX,M,176,70,31,1,0,2,280
Avon,HI,F,13,14,8,4,6,33,78
Avon,HI,M,12,11,3,0,1,6,33
Avon,HIX,F,2,3,5,0,2,4,16
Avon,HIX,M,3,1,1,1,1,2,9
Avon,HO,F,177,275,258,229,199,454,"1,592"
Avon,HO,M,187,27,26,3,1,2,246
Avon,HOX,F,5,0,17,36,30,73,161
Avon,HOX,M,8,2,1,0,0,0,11
Avon,HX,F,0,0,0,0,0,291,291
Avon,HX,M,0,0,0,0,0,54,54
Avon,JE,F,49,75,70,59,26,111,390
Avon,JE,M,4,2,0,2,0,0,8
Avon,JEX,F,50,21,39,17,5,7,139
Avon,JEX,M,15,2,0,0,0,0,17
Avon,LH,F,9,6,8,11,2,13,49
Avon,LH,M,11,10,1,2,0,3,27
Avon,LHX,F,16,17,8,1,4,8,54
Avon,LHX,M,15,13,0,0,0,0,28
Avon,LI,F,0,0,0,0,0,28,28
Avon,LI,M,0,0,0,0,0,13,13
Avon,LIM,F,299,243,67,59,26,154,848
Avon,LIM,M,237,175,52,21,12,40,537
Avon,LIMB,F,0,0,0,0,0,2,2
Avon,LIMBX,F,0,0,0,0,0,24,24
Avon,LIMR,F,0,0,0,0,0,3,3
Avon,LIMRX,F,0,0,0,0,0,15,15
Avon,LIMX,F,"1,646","1,718",497,161,175,528,"4,725"
Avon,LIMX,M,"1,653","1,415",316,17,7,29,"3,437"
Avon,LIX,F,0,0,0,0,0,217,217
Avon,LIX,M,0,0,0,0,0,38,38
Avon,LMX,F,0,0,0,0,0,7,7
Avon,LR,F,0,1,0,0,0,0,1
Avon,LR,M,0,1,0,0,0,0,1
Avon,LRX,F,0,0,1,0,0,0,1
Avon,MAX,F,0,0,0,0,1,0,1
Avon,MG,F,0,0,0,0,0,2,2
Avon,MGX,F,0,2,0,0,0,2,4
Avon,MGX,M,1,4,0,0,0,0,5
Avon,MO,F,14,20,26,43,39,81,223
Avon,MO,M,24,2,1,0,0,1,28
Avon,MOX,F,17,9,10,1,3,29,69
Avon,MOX,M,17,18,2,0,0,4,41
Avon,MRI,F,9,10,18,13,5,59,114
Avon,MRI,M,12,8,3,1,1,1,26
Avon,MRIX,F,60,27,68,44,38,112,349
Avon,MRIX,M,74,21,7,0,1,3,106
Avon,ND,F,0,0,0,0,0,2,2
Avon,NDX,F,0,0,0,0,0,2,2
Avon,NO,F,1,1,0,0,0,1,3
Avon,NO,M,0,0,2,0,0,0,2
Avon,NOX,F,8,0,0,0,0,7,15
Avon,NOX,M,9,0,0,0,0,0,9
Avon,NRX,F,4,0,2,0,0,0,6
Avon,NRX,M,2,0,0,0,0,0,2
Avon,NS,F,0,0,0,0,0,444,444
Avon,NS,M,0,0,0,0,0,2,2
Avon,PAX,F,0,0,2,0,0,4,6
Avon,PAX,M,0,0,0,0,0,1,1
Avon,PI,F,0,0,0,0,0,4,4
Avon,PINX,F,0,0,0,0,0,1,1
Avon,PIX,F,1,1,0,0,0,5,7
Avon,PIX,M,2,11,0,0,0,2,15
Avon,ROT,F,0,0,0,0,0,1,1
Avon,RP,F,0,0,0,0,0,1,1
Avon,RP,M,1,1,0,0,0,0,2
Avon,RPX,F,0,2,0,0,0,2,4
Avon,RWFR,F,0,0,0,0,0,6,6
Avon,SA,F,1,0,0,0,0,1,2
Avon,SA,M,2,1,0,0,0,0,3
Avon,SAX,F,23,15,10,1,1,48,98
Avon,SAX,M,21,5,9,0,0,1,36
Avon,SD,F,12,18,11,12,5,32,90
Avon,SD,M,10,10,4,1,0,2,27
Avon,SDX,F,39,26,2,5,5,26,103
Avon,SDX,M,36,19,8,1,1,3,68
Avon,SH,F,0,0,0,0,0,2,2
Avon,SH,M,0,1,0,0,0,1,2
Avon,SHO,F,4,4,4,0,3,60,75
Avon,SHO,M,3,8,3,0,0,0,14
Avon,SHOX,F,4,3,8,2,0,15,32
Avon,SHOX,M,3,16,1,0,0,0,20
Avon,SM,F,168,156,66,37,57,213,697
Avon,SM,M,160,108,64,18,12,39,401
Avon,SMX,F,"1,103","1,090",368,122,144,750,"3,577"
Avon,SMX,M,"1,119",957,335,18,5,84,"2,518"
Avon,SRW,F,3,0,2,0,0,0,5
Avon,SRWX,F,18,0,5,1,0,0,24
Avon,SRWX,M,37,0,2,0,0,0,39
Avon,STX,F,2,0,0,0,0,0,2
Avon,STX,M,5,0,0,0,0,0,5
Avon,SU,F,0,5,0,0,0,2,7
Avon,SU,M,0,0,0,0,0,1,1
Avon,SUX,F,3,3,1,0,0,5,12
Avon,SUX,M,1,0,0,0,0,0,1
Avon,WB,F,11,6,6,4,13,14,54
Avon,WB,M,4,7,1,1,0,1,14
Avon,WBX,F,16,2,1,0,2,4,25
Avon,WBX,M,7,0,2,0,0,0,9
Shropshire,AA,F,323,363,160,141,135,398,"1,520"
Shropshire,AA,M,315,402,90,22,17,52,898
Shropshire,AAX,F,"1,060","1,093",393,202,139,938,"3,825"
Shropshire,AAX,M,"1,451","1,279",242,15,4,43,"3,034"
Shropshire,AR,F,0,1,0,0,0,1,2
Shropshire,ARX,F,0,1,1,0,0,0,2
Shropshire,ARX,M,1,1,0,0,0,0,2
Shropshire,AY,F,176,137,142,164,162,403,"1,184"
Shropshire,AY,M,63,27,9,8,0,3,110
Shropshire,AYX,F,51,54,8,10,9,12,144
Shropshire,AYX,M,10,0,0,0,0,0,10
Shropshire,BA,F,189,189,62,35,49,197,721
Shropshire,BA,M,174,136,31,22,15,86,464
Shropshire,BABX,F,0,0,0,0,0,16,16
Shropshire,BAL,F,0,0,2,1,0,1,4
Shropshire,BAL,M,0,1,1,0,0,0,2
Shropshire,BALX,F,11,2,2,0,0,0,15
Shropshire,BALX,M,9,3,0,0,0,1,13
Shropshire,BAR,F,0,0,0,0,0,3,3
Shropshire,BARX,F,0,0,0,0,0,10,10
Shropshire,BAX,F,"1,422","1,079",237,134,133,791,"3,796"
Shropshire,BAX,M,"1,488",858,111,9,2,69,"2,537"
Shropshire,BAZ,F,0,1,0,0,0,1,2
Shropshire,BAZX,F,1,3,0,11,0,1,16
Shropshire,BAZX,M,3,3,3,0,0,0,9
Shropshire,BB,F,253,326,92,59,78,355,"1,163"
Shropshire,BB,M,237,261,85,15,17,76,691
Shropshire,BBX,F,"2,493","2,110",794,457,410,"1,494","7,758"
Shropshire,BBX,M,"2,562","1,666",491,34,13,106,"4,872"
Shropshire,BF,F,"1,489","1,764","2,161","2,284","2,368","4,292","14,358"
Shropshire,BF,M,"1,152",678,344,59,15,43,"2,291"
Shropshire,BFX,F,267,196,156,167,157,314,"1,257"
Shropshire,BFX,M,167,65,35,3,3,0,273
Shropshire,BG,F,10,12,8,11,3,15,59
Shropshire,BG,M,12,12,1,2,1,2,30
Shropshire,BGX,F,0,1,0,0,1,3,5
Shropshire,BGX,M,3,2,1,0,0,0,6
Shropshire,BH,F,44,0,0,0,0,420,464
Shropshire,BH,M,44,0,0,0,0,6,50
Shropshire,BHX,F,6,0,0,0,0,152,158
Shropshire,BHX,M,2,0,0,0,0,0,2
Shropshire,BLG,F,0,1,2,0,0,2,5
Shropshire,BLG,M,0,0,1,0,0,0,1
Shropshire,BP,F,0,0,1,0,0,0,1
Shropshire,BR,F,1,0,1,0,1,0,3
Shropshire,BR,M,1,0,0,0,0,0,1
Shropshire,BRX,F,2,0,1,0,0,2,5
Shropshire,BS,F,103,101,78,93,58,149,582
Shropshire,BS,M,50,12,3,0,2,2,69
Shropshire,BSH,F,19,11,15,8,5,9,67
Shropshire,BSH,M,29,17,1,2,1,3,53
Shropshire,BSHX,F,30,20,5,5,0,8,68
Shropshire,BSHX,M,50,20,4,0,0,0,74
Shropshire,BSX,F,139,114,45,11,15,73,397
Shropshire,BSX,M,52,34,1,2,1,0,90
Shropshire,BU,F,1,2,0,0,2,1,6
Shropshire,BU,M,0,1,1,0,0,0,2
Shropshire,BW,F,4,11,7,3,8,28,61
Shropshire,BW,M,8,12,4,0,0,3,27
Shropshire,BWB,F,5,2,3,0,2,2,14
Shropshire,BWB,M,4,0,0,0,0,0,4
Shropshire,BWX,F,3,9,1,9,1,16,39
Shropshire,BWX,M,7,8,1,0,0,1,17
Shropshire,BX,M,0,0,0,0,0,1,1
Shropshire,CAX,F,0,0,0,0,0,2,2
Shropshire,CB,F,0,0,0,0,0,10,10
Shropshire,CB,M,0,1,0,0,0,0,1
Shropshire,CD,F,0,0,0,0,0,27,27
Shropshire,CH,F,343,389,155,100,92,753,"1,832"
Shropshire,CH,M,350,371,97,44,28,220,"1,110"
Shropshire,CHI,F,0,0,0,0,0,1,1
Shropshire,CHIX,F,0,0,0,0,0,2,2
Shropshire,CHL,F,0,1,0,0,0,0,1
Shropshire,CHX,F,"3,439","3,751",691,268,250,"2,071","10,470"
Shropshire,CHX,M,"3,728","3,604",703,35,12,271,"8,353"
Shropshire,DE,F,0,0,0,0,0,1,1
Shropshire,DEV,F,10,7,4,7,3,11,42
Shropshire,DEV,M,10,6,1,1,0,4,22
Shropshire,DEVX,F,7,23,2,1,3,11,47
Shropshire,DEVX,M,5,8,3,0,0,0,16
Shropshire,DEX,F,76,75,48,34,36,136,405
Shropshire,DEX,M,87,71,19,3,2,9,191
Shropshire,DEXX,F,1,5,0,1,0,3,10
Shropshire,DEXX,M,3,2,0,0,0,0,5
Shropshire,DGX,F,0,0,0,0,0,1,1
Shropshire,DR,F,0,1,3,9,7,2,22
Shropshire,DRX,F,0,5,5,2,0,1,13
Shropshire,DRX,M,1,1,0,0,0,0,2
Shropshire,DS,F,61,25,32,33,21,57,229
Shropshire,DS,M,19,11,2,0,1,1,34
Shropshire,DSHO,F,1,0,0,0,0,0,1
Shropshire,DSX,F,4,5,1,3,1,16,30
Shropshire,DSX,M,2,2,0,0,0,0,4
Shropshire,DV,F,0,0,0,0,0,6,6
Shropshire,DV,M,0,0,0,0,0,2,2
Shropshire,DVX,F,0,0,0,0,0,21,21
Shropshire,FE,F,0,1,0,1,0,0,2
Shropshire,FR,F,0,0,0,0,1,"14,964","14,965"
Shropshire,FR,M,0,0,0,0,0,165,165
Shropshire,FRX,F,0,0,0,0,1,348,349
Shropshire,FRX,M,0,0,0,0,0,34,34
Shropshire,GA,F,6,6,7,8,18,22,67
Shropshire,GA,M,1,2,3,0,1,0,7
Shropshire,GASX,F,0,0,0,0,0,2,2
Shropshire,GAX,F,3,6,5,0,0,4,18
Shropshire,GAX,M,3,1,1,0,0,0,5
Shropshire,GB,F,0,1,0,0,0,1,2
Shropshire,GBX,F,2,2,0,0,0,0,4
Shropshire,GBX,M,3,0,0,1,0,0,4
Shropshire,GE,F,0,0,0,0,0,1,1
Shropshire,GEX,F,0,1,0,0,0,1,2
Shropshire,GEX,M,0,8,0,0,0,0,8
Shropshire,GL,F,2,2,1,2,2,9,18
Shropshire,GL,M,7,2,4,0,0,0,13
Shropshire,GLX,F,0,0,0,0,1,3,4
Shropshire,GU,F,5,7,11,10,6,51,90
Shropshire,GU,M,1,0,0,2,0,0,3
Shropshire,GUX,F,0,1,3,0,0,3,7
Shropshire,GY,F,4,0,0,0,0,0,4
Shropshire,H,F,0,0,0,0,0,308,308
Shropshire,H,M,0,0,0,0,0,64,64
Shropshire,HE,F,260,231,169,157,104,365,"1,286"
Shropshire,HE,M,288,266,74,29,29,53,739
Shropshire,HEBL,F,0,0,0,0,0,9,9
Shropshire,HEBLX,F,0,0,0,0,0,193,193
Shropshire,HEBLX,M,0,0,0,0,0,1,1
Shropshire,HER,F,0,0,0,0,0,24,24
Shropshire,HERX,F,0,0,0,0,0,70,70
Shropshire,HERX,M,0,0,0,0,0,1,1
Shropshire,HEX,F,"1,679","1,685",813,592,462,"2,240","7,471"
Shropshire,HEX,M,"1,985","1,639",345,39,18,43,"4,069"
Shropshire,HF,F,"9,893","9,627","10,029","9,045","7,668","15,058","61,320"
Shropshire,HF,M,"4,231","1,894",787,118,31,76,"7,137"
Shropshire,HFX,F,752,625,668,637,598,923,"4,203"
Shropshire,HFX,M,312,106,29,4,1,6,458
Shropshire,HI,F,37,54,44,39,20,105,299
Shropshire,HI,M,43,39,24,6,6,24,142
Shropshire,HIX,F,19,1,2,1,1,10,34
Shropshire,HIX,M,13,3,1,0,0,0,17
Shropshire,HL,F,0,0,0,0,0,7,7
Shropshire,HO,F,"1,562","1,452","1,426","1,083",957,"1,958","8,438"
Shropshire,HO,M,514,189,101,16,10,13,843
Shropshire,HOX,F,27,17,15,36,44,224,363
Shropshire,HOX,M,18,3,4,0,0,0,25
Shropshire,HX,F,0,0,0,0,0,894,894
Shropshire,HX,M,0,0,0,0,0,126,126
Shropshire,IM,F,2,0,1,1,1,3,8
Shropshire,IM,M,0,5,0,0,0,0,5
Shropshire,IMX,F,1,0,0,0,0,1,2
Shropshire,JE,F,722,896,741,786,645,"1,180","4,970"
Shropshire,JE,M,30,19,12,8,2,3,74
Shropshire,JEX,F,301,258,238,232,172,123,"1,324"
Shropshire,JEX,M,15,4,3,1,0,0,23
Shropshire,JY,F,178,0,0,0,0,1,179
Shropshire,JY,M,7,0,0,0,0,0,7
Shropshire,KEX,F,0,0,0,0,2,0,2
Shropshire,KEX,M,0,0,0,0,1,0,1
Shropshire,LH,F,53,39,36,45,16,84,273
Shropshire,LH,M,40,59,4,3,0,7,113
Shropshire,LHX,F,4,19,11,9,7,19,69
Shropshire,LHX,M,6,26,0,0,0,0,32
Shropshire,LI,F,0,0,0,0,0,402,402
Shropshire,LI,M,0,0,0,0,0,96,96
Shropshire,LIM,F,"1,263","1,186",558,390,397,"1,411","5,205"
Shropshire,LIM,M,"1,246",919,241,101,63,285,"2,855"
Shropshire,LIM X,F,0,0,0,0,0,6,6
Shropshire,LIMB,F,0,0,0,0,0,15,15
Shropshire,LIMB,M,0,0,0,0,0,1,1
Shropshire,LIMBX,F,0,0,0,0,0,222,222
Shropshire,LIMBX,M,0,0,0,0,0,5,5
Shropshire,LIMR,F,0,0,0,0,0,67,67
Shropshire,LIMR,M,0,0,0,0,0,10,10
Shropshire,LIMRX,F,0,0,0,0,0,121,121
Shropshire,LIMRX,M,0,0,0,0,0,7,7
Shropshire,LIMX,F,"8,124","7,297","2,304","1,207","1,170","4,777","24,879"
Shropshire,LIMX,M,"8,146","6,153","1,211",110,27,162,"15,809"
Shropshire,LIX,F,0,0,0,0,0,"1,370","1,370"
Shropshire,LIX,M,0,0,0,0,0,228,228
Shropshire,LM,F,0,0,0,0,0,20,20
Shropshire,LM,M,0,0,0,0,0,3,3
Shropshire,LMX,F,0,0,0,0,0,27,27
Shropshire,LRX,F,0,0,0,0,1,3,4
Shropshire,LRX,M,0,1,0,0,0,0,1
Shropshire,LU,F,0,1,0,0,0,0,1
Shropshire,LU,M,0,10,1,0,0,0,11
Shropshire,MARX,M,0,0,1,0,0,0,1
Shropshire,MG,F,0,0,0,1,0,5,6
Shropshire,MG,M,0,0,2,0,0,0,2
Shropshire,MGX,F,14,18,8,7,11,39,97
Shropshire,MGX,M,22,4,3,0,1,2,32
Shropshire,MO,F,45,23,19,28,0,72,187
Shropshire,MO,M,36,11,3,2,0,0,52
Shropshire,MOX,F,102,42,44,17,27,20,252
Shropshire,MOX,M,100,37,11,0,0,0,148
Shropshire,MRI,F,49,46,41,29,20,68,253
Shropshire,MRI,M,29,12,4,1,0,1,47
Shropshire,MRIX,F,30,43,21,49,25,85,253
Shropshire,MRIX,M,35,49,13,0,0,1,98
Shropshire,ND,F,0,0,0,0,0,1,1
Shropshire,NO,F,0,5,0,0,0,2,7
Shropshire,NOX,F,0,0,0,1,2,4,7
Shropshire,NOX,M,2,1,0,0,0,0,3
Shropshire,NR,F,1,0,0,0,0,0,1
Shropshire,NRX,F,15,0,0,0,0,0,15
Shropshire,NRX,M,15,0,0,0,0,0,15
Shropshire,NS,F,0,0,0,0,0,690,690
Shropshire,OB,F,0,0,0,0,0,2,2
Shropshire,OE,F,0,0,0,0,0,2,2
Shropshire,OO,M,0,0,0,0,0,1,1
Shropshire,PA,F,0,1,0,0,0,0,1
Shropshire,PAX,F,2,2,0,0,2,4,10
Shropshire,PAX,M,1,4,6,0,0,0,11
Shropshire,PI,F,1,3,2,1,1,5,13
Shropshire,PI,M,1,1,1,1,1,0,5
Shropshire,PIX,F,20,22,5,0,3,14,64
Shropshire,PIX,M,19,11,2,0,0,0,32
Shropshire,RO,F,0,0,0,0,0,1,1
Shropshire,ROTX,F,0,0,1,0,0,7,8
Shropshire,ROX,F,0,0,0,0,0,9,9
Shropshire,RP,F,3,11,7,4,0,6,31
Shropshire,RP,M,3,9,0,2,0,1,15
Shropshire,RPX,F,2,2,0,0,0,1,5
Shropshire,RWFR,F,0,0,0,0,0,4,4
Shropshire,SA,F,51,57,16,23,31,60,238
Shropshire,SA,M,37,27,3,2,2,6,77
Shropshire,SAX,F,154,196,95,67,91,255,858
Shropshire,SAX,M,138,142,26,7,2,6,321
Shropshire,SBX,F,0,0,0,0,0,1,1
Shropshire,SD,F,65,81,51,38,37,108,380
Shropshire,SD,M,76,39,9,4,2,5,135
Shropshire,SDX,F,144,120,30,15,20,42,371
Shropshire,SDX,M,157,57,6,0,0,0,220
Shropshire,SH,F,1,2,1,1,1,5,11
Shropshire,SH,M,2,3,0,0,0,0,5
Shropshire,SHO,F,19,65,49,31,19,91,274
Shropshire,SHO,M,38,55,8,1,0,0,102
Shropshire,SHOX,F,100,125,98,34,20,43,420
Shropshire,SHOX,M,52,46,18,1,0,1,118
Shropshire,SHX,F,3,2,2,2,0,7,16
Shropshire,SHX,M,5,3,0,1,0,0,9
Shropshire,SM,F,237,283,104,94,59,305,"1,082"
Shropshire,SM,M,267,171,63,36,11,81,629
Shropshire,SMX,F,"1,741","1,672",637,296,287,"1,822","6,455"
Shropshire,SMX,M,"1,892","1,534",410,28,9,136,"4,009"
Shropshire,SRW,F,28,0,0,0,1,0,29
Shropshire,SRW,M,2,3,0,0,0,0,5
Shropshire,SRWX,F,55,20,1,5,4,0,85
Shropshire,SRWX,M,18,6,0,0,0,0,24
Shropshire,ST,F,0,2,0,0,0,0,2
Shropshire,ST,M,0,0,0,0,0,1,1
Shropshire,STX,M,1,1,0,0,0,0,2
Shropshire,SU,F,1,1,0,3,0,0,5
Shropshire,SU,M,1,0,0,0,0,1,2
Shropshire,SUX,F,0,0,2,0,0,1,3
Shropshire,SUX,M,1,3,1,0,0,0,5
Shropshire,WB,F,31,49,22,24,25,201,352
Shropshire,WB,M,46,89,8,9,2,8,162
Shropshire,WBX,F,60,31,28,12,24,139,294
Shropshire,WBX,M,60,48,10,1,1,6,126
Shropshire,WG,M,1,0,1,0,0,0,2
Shropshire,WP,F,7,5,3,3,1,14,33
Shropshire,WP,M,5,3,2,1,3,4,18
Shropshire,WPX,F,1,3,1,0,1,2,8
Shropshire,WPX,M,2,8,9,2,2,1,24
Shropshire,WSX,M,0,1,0,0,0,0,1
Shropshire,WW,F,0,0,1,1,0,1,3
Shropshire,WW,M,4,0,0,0,0,0,4
Somerset ,AA,F,957,761,386,328,251,"1,322","4,005"
Somerset ,AA,M,882,684,165,89,58,221,"2,099"
Somerset ,AAX,F,"4,112","3,351","1,382",849,761,"3,179","13,634"
Somerset ,AAX,M,"3,842","2,820",487,38,21,293,"7,501"
Somerset ,AM,M,1,0,0,0,0,0,1
Somerset ,AMX,F,0,0,1,1,0,0,2
Somerset ,AN,F,0,0,0,0,0,1,1
Somerset ,AR,F,0,1,1,0,0,1,3
Somerset ,AR,M,1,0,0,0,0,1,2
Somerset ,ARX,F,1,2,0,0,0,2,5
Somerset ,ARX,M,0,0,0,0,0,1,1
Somerset ,AUX,M,0,1,0,0,1,0,2
Somerset ,AY,F,70,46,68,90,96,316,686
Somerset ,AY,M,17,8,13,4,0,2,44
Somerset ,AYX,F,16,3,7,8,11,18,63
Somerset ,AYX,M,5,4,0,0,0,1,10
Somerset ,BA,F,65,32,18,24,20,92,251
Somerset ,BA,M,65,35,18,9,8,49,184
Somerset ,BAB,F,0,0,0,0,0,1,1
Somerset ,BABX,F,0,0,0,0,0,3,3
Somerset ,BALX,F,1,0,0,0,0,1,2
Somerset ,BALX,M,0,2,0,0,0,0,2
Somerset ,BARX,F,0,0,0,0,0,7,7
Somerset ,BAWX,F,0,0,0,0,0,6,6
Somerset ,BAWX,M,0,0,0,0,0,1,1
Somerset ,BAX,F,712,567,162,103,77,495,"2,116"
Somerset ,BAX,M,649,529,63,6,5,74,"1,326"
Somerset ,BAZ,F,4,0,1,0,0,12,17
Somerset ,BAZ,M,1,1,2,0,1,6,11
Somerset ,BAZ X,F,0,0,0,0,0,3,3
Somerset ,BAZX,F,43,66,15,11,8,22,165
Somerset ,BAZX,M,43,45,16,0,0,3,107
Somerset ,BB,F,264,208,109,81,91,451,"1,204"
Somerset ,BB,M,244,202,61,15,16,167,705
Somerset ,BBX,F,"2,634","1,929",805,517,292,"1,511","7,688"
Somerset ,BBX,M,"2,629","1,753",490,22,10,234,"5,138"
Somerset ,BF,F,"2,262","2,401","2,707","3,006","3,266","6,411","20,053"
Somerset ,BF,M,"1,934","1,165",400,59,24,64,"3,646"
Somerset ,BFX,F,223,206,199,273,212,473,"1,586"
Somerset ,BFX,M,162,66,67,17,0,11,323
Somerset ,BG,F,3,4,6,4,5,10,32
Somerset ,BG,M,7,9,3,0,0,1,20
Somerset ,BGX,F,11,7,0,5,2,6,31
Somerset ,BGX,M,11,9,1,1,0,0,22
Somerset ,BH,F,21,0,0,0,0,649,670
Somerset ,BH,M,11,0,0,0,0,0,11
Somerset ,BHX,F,13,0,0,0,0,142,155
Somerset ,BHX,M,2,0,0,0,0,1,3
Somerset ,BI,F,0,0,0,3,0,0,3
Somerset ,BI,M,1,0,0,0,0,0,1
Somerset ,BLG,F,2,0,1,0,0,29,32
Somerset ,BLG,M,2,0,0,0,0,0,2
Somerset ,BLGX,F,0,0,0,0,0,1,1
Somerset ,BP,F,0,1,0,0,2,0,3
Somerset ,BR,F,1,0,0,0,0,2,3
Somerset ,BRX,F,1,1,0,0,0,1,3
Somerset ,BS,F,94,81,105,68,66,160,574
Somerset ,BS,M,38,22,7,0,0,2,69
Somerset ,BSH,F,15,13,9,8,10,34,89
Somerset ,BSH,M,12,11,5,2,1,4,35
Somerset ,BSHX,F,11,19,6,8,15,13,72
Somerset ,BSHX,M,5,3,0,0,0,1,9
Somerset ,BSX,F,135,100,88,90,86,129,628
Somerset ,BSX,M,63,35,6,0,0,1,105
Somerset ,BU,F,46,41,28,25,20,65,225
Somerset ,BU,M,33,38,15,2,0,2,90
Somerset ,BW,F,45,39,24,23,11,85,227
Somerset ,BW,M,43,25,8,1,3,6,86
Somerset ,BWX,F,12,7,9,0,0,19,47
Somerset ,BWX,M,16,14,13,0,0,1,44
Somerset ,BX,F,0,0,0,0,0,1,1
Somerset ,CA,F,0,0,0,0,0,1,1
Somerset ,CAX,F,0,0,0,0,0,4,4
Somerset ,CB,F,4,2,0,0,0,7,13
Somerset ,CB,M,6,0,0,0,0,0,6
Somerset ,CD,F,0,0,0,0,0,32,32
Somerset ,CH,F,528,433,207,148,147,876,"2,339"
Somerset ,CH,M,499,345,109,66,63,268,"1,350"
Somerset ,CHI,F,0,0,0,0,0,1,1
Somerset ,CHIX,F,0,0,0,0,0,3,3
Somerset ,CHL,F,0,0,0,0,1,0,1
Somerset ,CHX,F,"4,622","3,612",969,434,431,"2,522","12,590"
Somerset ,CHX,M,"4,542","3,096",658,75,39,314,"8,724"
Somerset ,DE,F,0,0,0,0,0,1,1
Somerset ,DEV,F,470,403,326,217,193,747,"2,356"
Somerset ,DEV,M,430,388,114,27,18,54,"1,031"
Somerset ,DEVX,F,430,357,225,144,142,644,"1,942"
Somerset ,DEVX,M,458,324,92,13,3,21,911
Somerset ,DEX,F,124,83,76,66,52,228,629
Somerset ,DEX,M,135,106,29,7,3,21,301
Somerset ,DEXX,F,3,8,4,2,2,5,24
Somerset ,DEXX,M,3,7,2,1,0,0,13
Somerset ,DG,F,0,0,0,0,0,1,1
Somerset ,DRX,F,1,3,2,1,1,0,8
Somerset ,DRX,M,3,0,0,0,0,0,3
Somerset ,DS,F,47,55,50,57,43,136,388
Somerset ,DS,M,39,22,5,0,0,0,66
Somerset ,DSHO,F,5,0,0,0,0,0,5
Somerset ,DSHO,M,1,0,0,0,0,0,1
Somerset ,DSX,F,19,18,4,2,3,6,52
Somerset ,DSX,M,20,1,1,0,0,0,22
Somerset ,DV,F,0,0,0,0,0,28,28
Somerset ,DV,M,0,0,0,0,0,3,3
Somerset ,DVX,F,0,0,0,0,0,111,111
Somerset ,DVX,M,0,0,0,0,0,15,15
Somerset ,EPX,M,1,0,0,0,0,0,1
Somerset ,FE,F,0,0,0,0,0,4,4
Somerset ,FE,M,3,0,0,0,0,0,3
Somerset ,FR,F,0,0,0,0,0,"22,666","22,666"
Somerset ,FR,M,0,0,0,0,0,265,265
Somerset ,FRX,F,0,0,0,0,0,484,484
Somerset ,FRX,M,0,0,0,0,0,80,80
Somerset ,GA,F,16,17,23,0,1,47,104
Somerset ,GA,M,11,17,0,1,0,2,31
Somerset ,GASX,M,1,0,0,0,0,0,1
Somerset ,GAX,F,4,5,4,1,0,26,40
Somerset ,GAX,M,4,3,0,5,0,0,12
Somerset ,GB,F,1,0,0,0,0,0,1
Somerset ,GBX,F,1,1,0,0,0,1,3
Somerset ,GBX,M,1,0,0,0,0,0,1
Somerset ,GE,F,10,19,4,7,7,40,87
Somerset ,GE,M,10,3,2,1,0,3,19
Somerset ,GEX,F,59,6,3,0,0,7,75
Somerset ,GEX,M,26,3,2,0,0,1,32
Somerset ,GL,F,11,11,9,11,10,19,71
Somerset ,GL,M,8,12,4,2,0,2,28
Somerset ,GLX,F,3,3,2,1,1,5,15
Somerset ,GLX,M,1,2,1,2,0,0,6
Somerset ,GU,F,81,126,143,88,103,437,978
Somerset ,GU,M,20,17,7,2,0,2,48
Somerset ,GUX,F,3,4,4,11,9,3,34
Somerset ,GUX,M,0,0,0,0,0,2,2
Somerset ,GY,F,15,0,0,0,0,0,15
Somerset ,GY,M,3,0,0,0,0,0,3
Somerset ,GYX,F,2,0,0,0,0,0,2
Somerset ,GYX,M,1,0,0,0,0,0,1
Somerset ,H,F,0,0,0,0,0,339,339
Somerset ,H,M,0,0,0,0,0,67,67
Somerset ,HE,F,319,338,184,122,122,465,"1,550"
Somerset ,HE,M,317,324,77,42,33,87,880
Somerset ,HEBL,F,0,0,0,0,0,32,32
Somerset ,HEBL,M,0,0,0,0,0,1,1
Somerset ,HEBLX,F,0,0,0,0,0,259,259
Somerset ,HEBLX,M,0,0,0,0,0,15,15
Somerset ,HER,F,0,0,0,0,0,33,33
Somerset ,HER,M,0,0,0,0,0,4,4
Somerset ,HERX,F,0,0,0,0,0,132,132
Somerset ,HERX,M,0,0,0,0,0,2,2
Somerset ,HEX,,0,1,0,0,0,0,1
Somerset ,HEX,F,"2,643","2,336","1,084",700,542,"2,446","9,751"
Somerset ,HEX,M,"2,600","1,929",414,40,25,82,"5,090"
Somerset ,HF,F,"12,564","12,091","13,028","12,191","10,401","21,049","81,324"
Somerset ,HF,M,"5,702","2,753","1,047",171,71,140,"9,884"
Somerset ,HFX,F,799,590,621,637,530,"1,220","4,397"
Somerset ,HFX,M,427,157,55,5,5,19,668
Somerset ,HI,F,15,18,21,26,6,85,171
Somerset ,HI,M,35,23,8,8,1,12,87
Somerset ,HIX,F,5,11,7,4,2,11,40
Somerset ,HIX,M,3,9,2,6,0,0,20
Somerset ,HL,F,0,0,0,0,0,4,4
Somerset ,HLX,F,0,0,0,0,0,1,1
Somerset ,HO,F,"1,255","1,382","1,366","1,338","1,107","2,312","8,760"
Somerset ,HO,M,265,169,101,15,10,17,577
Somerset ,HOX,F,57,44,73,65,60,178,477
Somerset ,HOX,M,17,8,3,1,1,0,30
Somerset ,HX,F,0,0,0,0,0,"1,027","1,027"
Somerset ,HX,M,0,0,0,0,0,153,153
Somerset ,IM,F,0,2,0,0,0,1,3
Somerset ,IMX,F,0,1,0,0,1,0,2
Somerset ,JE,F,375,605,361,303,298,797,"2,739"
Somerset ,JE,M,23,8,12,2,1,15,61
Somerset ,JEX,F,296,236,196,204,73,95,"1,100"
Somerset ,JEX,M,22,19,5,4,0,2,52
Somerset ,JY,F,81,0,0,0,0,2,83
Somerset ,JY,M,2,0,0,0,0,0,2
Somerset ,JYX,F,2,0,0,0,0,0,2
Somerset ,JYX,M,4,0,0,0,0,0,4
Somerset ,KE,M,1,0,0,0,0,0,1
Somerset ,KEX,F,0,0,0,0,0,1,1
Somerset ,KEX,M,0,0,0,1,0,0,1
Somerset ,LH,F,43,43,40,30,20,103,279
Somerset ,LH,M,30,37,8,9,1,5,90
Somerset ,LHX,F,16,4,9,3,3,68,103
Somerset ,LHX,M,20,2,3,0,0,5,30
Somerset ,LI,F,0,0,0,0,0,225,225
Somerset ,LI,M,0,0,0,0,0,108,108
Somerset ,LIM,F,972,782,327,165,160,736,"3,142"
Somerset ,LIM,M,"1,016",661,202,64,63,180,"2,186"
Somerset ,LIM X,F,0,0,0,0,0,2,2
Somerset ,LIM X,M,0,0,0,0,0,2,2
Somerset ,LIMB,F,0,0,0,0,0,8,8
Somerset ,LIMBX,F,0,0,0,0,0,129,129
Somerset ,LIMBX,M,0,0,0,0,0,5,5
Somerset ,LIMR,F,0,0,0,0,0,36,36
Somerset ,LIMR,M,0,0,0,0,0,11,11
Somerset ,LIMRX,F,0,0,0,0,0,55,55
Somerset ,LIMRX,M,0,0,0,0,0,2,2
Somerset ,LIMX,F,"5,301","4,236","1,302",798,664,"2,370","14,671"
Somerset ,LIMX,M,"4,927","3,392",842,88,56,150,"9,455"
Somerset ,LIX,F,0,0,0,0,0,898,898
Somerset ,LIX,M,0,0,0,0,0,225,225
Somerset ,LM,F,0,0,0,0,0,11,11
Somerset ,LM,M,0,0,0,0,0,1,1
Somerset ,LMX,F,0,0,0,0,0,36,36
Somerset ,LR,F,0,1,0,0,0,2,3
Somerset ,LR,M,1,1,0,0,0,0,2
Somerset ,LRX,F,2,0,0,0,0,1,3
Somerset ,LRX,M,1,1,0,0,0,0,2
Somerset ,LU,F,0,0,0,0,0,5,5
Somerset ,LUX,F,0,0,0,0,0,3,3
Somerset ,MARX,F,0,0,0,0,0,4,4
Somerset ,MAX,F,0,0,0,0,0,1,1
Somerset ,MAX,M,0,2,0,1,0,0,3
Somerset ,MG,F,0,0,0,0,0,12,12
Somerset ,MGX,F,3,2,1,2,3,13,24
Somerset ,MGX,M,1,1,1,0,0,1,4
Somerset ,MO,F,186,197,176,93,85,292,"1,029"
Somerset ,MO,M,111,57,7,2,0,14,191
Somerset ,MOX,F,108,125,88,39,16,83,459
Somerset ,MOX,M,71,48,12,3,0,4,138
Somerset ,MRI,F,44,64,54,58,45,296,561
Somerset ,MRI,M,65,52,16,1,0,28,162
Somerset ,MRIX,F,188,153,237,190,180,564,"1,512"
Somerset ,MRIX,M,205,95,42,9,0,6,357
Somerset ,ND,F,0,0,0,0,0,64,64
Somerset ,ND,M,0,0,0,0,0,5,5
Somerset ,NDX,F,0,0,0,0,0,60,60
Somerset ,NDX,M,0,0,0,0,0,5,5
Somerset ,NO,F,7,15,1,0,1,4,28
Somerset ,NO,M,1,10,1,0,1,0,13
Somerset ,NOX,F,16,33,21,2,0,6,78
Somerset ,NOX,M,6,30,2,0,0,0,38
Somerset ,NR,F,0,0,0,0,0,1,1
Somerset ,NRX,F,24,0,0,0,0,2,26
Somerset ,NRX,M,16,1,0,0,0,0,17
Somerset ,NS,F,0,0,0,0,0,"1,129","1,129"
Somerset ,NS,M,0,0,0,0,0,2,2
Somerset ,OB,F,0,0,0,0,0,4,4
Somerset ,OEX,F,0,0,0,0,0,1,1
Somerset ,OEX,M,1,0,0,1,0,0,2
Somerset ,PAX,F,4,3,0,0,0,1,8
Somerset ,PI,F,0,1,0,0,0,7,8
Somerset ,PI,M,0,2,0,0,0,6,8
Somerset ,PINX,F,0,0,0,0,0,4,4
Somerset ,PINX,M,0,1,0,0,0,0,1
Somerset ,PIX,F,27,9,16,8,2,59,121
Somerset ,PIX,M,25,15,7,0,0,14,61
Somerset ,ROX,F,1,1,0,0,0,1,3
Somerset ,RP,F,3,8,0,0,0,16,27
Somerset ,RP,M,7,3,0,0,0,2,12
Somerset ,RPX,F,2,0,2,7,2,6,19
Somerset ,RPX,M,1,0,4,1,0,0,6
Somerset ,RWFR,F,1,0,0,0,0,18,19
Somerset ,RWFR,M,1,0,0,0,0,0,1
Somerset ,SA,F,7,6,1,0,0,3,17
Somerset ,SA,M,12,7,1,1,0,1,22
Somerset ,SAX,F,22,21,8,26,12,160,249
Somerset ,SAX,M,10,18,5,0,0,4,37
Somerset ,SBX,F,0,2,0,1,1,3,7
Somerset ,SBX,M,0,1,0,0,0,0,1
Somerset ,SD,F,174,118,49,50,75,157,623
Somerset ,SD,M,136,74,2,11,12,9,244
Somerset ,SDX,F,253,176,77,46,46,263,861
Somerset ,SDX,M,285,114,38,7,3,8,455
Somerset ,SH,F,2,4,1,0,1,6,14
Somerset ,SH,M,1,1,0,0,0,0,2
Somerset ,SHO,F,58,38,34,40,68,208,446
Somerset ,SHO,M,35,9,10,1,2,5,62
Somerset ,SHOX,F,113,55,24,33,37,104,366
Somerset ,SHOX,M,21,12,3,3,0,2,41
Somerset ,SHX,F,1,0,1,0,0,8,10
Somerset ,SHX,M,2,1,0,0,0,0,3
Somerset ,SM,F,469,444,225,138,124,910,"2,310"
Somerset ,SM,M,449,310,126,52,43,195,"1,175"
Somerset ,SMX,F,"3,354","2,972","1,088",566,519,"3,250","11,749"
Somerset ,SMX,M,"3,193","2,480",633,48,29,373,"6,756"
Somerset ,SRW,F,1,2,2,11,4,1,21
Somerset ,SRW,M,1,0,0,0,0,0,1
Somerset ,SRWX,F,239,28,22,18,8,10,325
Somerset ,SRWX,M,83,4,1,0,0,0,88
Somerset ,ST,M,0,0,1,0,0,0,1
Somerset ,STX,F,19,16,0,0,0,0,35
Somerset ,STX,M,12,5,0,0,0,0,17
Somerset ,SU,F,0,2,2,6,3,12,25
Somerset ,SU,M,4,4,1,0,1,1,11
Somerset ,SUX,F,35,30,5,0,1,5,76
Somerset ,SUX,M,40,30,8,0,3,1,82
Somerset ,WA,F,5,3,0,0,6,0,14
Somerset ,WA,M,1,2,0,0,0,0,3
Somerset ,WB,F,11,6,3,12,6,30,68
Somerset ,WB,M,12,7,0,0,0,2,21
Somerset ,WBX,F,5,11,11,5,10,76,118
Somerset ,WBX,M,12,1,8,0,0,1,22
Somerset ,WP,F,53,54,42,46,22,137,354
Somerset ,WP,M,61,50,21,7,0,10,149
Somerset ,WPX,F,4,5,2,0,0,2,13
Somerset ,WPX,M,5,3,1,0,0,0,9
Somerset ,WS,F,20,14,11,0,0,0,45
Somerset ,WS,M,16,7,1,1,0,1,26
Somerset ,WSX,F,5,4,0,0,0,29,38
Somerset ,WSX,M,3,0,0,0,0,0,3
Staffordshire,AA,F,447,329,132,119,89,411,"1,527"
Staffordshire,AA,M,425,270,90,24,20,48,877
Staffordshire,AAX,F,"1,255","1,137",425,261,197,858,"4,133"
Staffordshire,AAX,M,"1,224",944,177,16,4,67,"2,432"
Staffordshire,AR,F,0,0,1,0,0,0,1
Staffordshire,AR,M,1,0,0,0,0,0,1
Staffordshire,ARX,F,0,1,0,0,0,1,2
Staffordshire,ARX,M,0,1,0,0,0,0,1
Staffordshire,AY,F,153,155,172,148,155,434,"1,217"
Staffordshire,AY,M,65,27,7,3,1,2,105
Staffordshire,AYX,F,70,44,25,38,21,45,243
Staffordshire,AYX,M,13,2,0,0,0,1,16
Staffordshire,BA,F,82,71,27,22,20,75,297
Staffordshire,BA,M,50,56,13,13,4,34,170
Staffordshire,BABX,F,0,0,0,0,0,4,4
Staffordshire,BAL,F,2,8,6,2,4,37,59
Staffordshire,BAL,M,2,0,2,0,1,0,5
Staffordshire,BALX,F,1,0,0,1,0,12,14
Staffordshire,BALX,M,6,3,0,0,0,0,9
Staffordshire,BAR,F,0,0,0,0,0,2,2
Staffordshire,BARX,F,0,0,0,0,0,2,2
Staffordshire,BAX,F,723,651,144,54,62,221,"1,855"
Staffordshire,BAX,M,620,482,88,3,12,31,"1,236"
Staffordshire,BAZ,F,1,9,0,0,0,2,12
Staffordshire,BAZ,M,0,2,0,0,0,2,4
Staffordshire,BAZX,F,27,19,7,9,4,17,83
Staffordshire,BAZX,M,19,14,2,0,0,0,35
Staffordshire,BB,F,410,382,163,93,71,404,"1,523"
Staffordshire,BB,M,443,278,73,28,12,84,918
Staffordshire,BBX,F,"2,016","1,831",659,290,210,908,"5,914"
Staffordshire,BBX,M,"2,007","1,386",319,28,9,139,"3,888"
Staffordshire,BF,F,"2,204","2,215","2,768","2,798","2,876","4,476","17,337"
Staffordshire,BF,M,"1,476","1,118",333,51,27,40,"3,045"
Staffordshire,BFX,F,299,414,301,276,248,346,"1,884"
Staffordshire,BFX,M,215,134,58,11,4,3,425
Staffordshire,BG,F,15,21,11,8,7,26,88
Staffordshire,BG,M,8,13,9,2,0,2,34
Staffordshire,BG X,F,0,0,0,0,0,1,1
Staffordshire,BGX,F,17,5,1,1,3,6,33
Staffordshire,BGX,M,10,1,2,0,0,1,14
Staffordshire,BH,F,49,0,0,0,0,628,677
Staffordshire,BH,M,12,0,0,0,0,3,15
Staffordshire,BHX,F,8,0,0,0,0,103,111
Staffordshire,BHX,M,1,0,0,0,0,0,1
Staffordshire,BLG,F,0,0,2,0,0,0,2
Staffordshire,BP,F,0,0,0,0,0,1,1
Staffordshire,BR,F,0,0,0,0,1,1,2
Staffordshire,BRX,F,1,0,0,1,0,1,3
Staffordshire,BS,F,20,15,14,18,17,59,143
Staffordshire,BS,M,5,2,1,1,1,0,10
Staffordshire,BSH,F,35,30,32,26,8,28,159
Staffordshire,BSH,M,37,22,4,3,2,5,73
Staffordshire,BSHO,F,0,0,0,0,0,2,2
Staffordshire,BSHX,F,16,20,17,7,26,16,102
Staffordshire,BSHX,M,34,5,6,1,0,0,46
Staffordshire,BSX,F,62,24,36,24,19,90,255
Staffordshire,BSX,M,30,7,8,1,0,4,50
Staffordshire,BU,F,0,2,0,1,0,6,9
Staffordshire,BU,M,3,1,0,0,0,1,5
Staffordshire,BW,F,7,3,7,5,2,17,41
Staffordshire,BW,M,8,4,5,1,1,1,20
Staffordshire,BWB,F,0,0,1,0,0,0,1
Staffordshire,BWX,F,9,5,1,2,1,5,23
Staffordshire,BWX,M,0,4,0,0,0,0,4
Staffordshire,CA,F,0,0,0,0,0,1,1
Staffordshire,CAX,F,0,0,0,0,0,11,11
Staffordshire,CB,F,0,2,3,0,0,2,7
Staffordshire,CB,M,1,4,0,2,0,0,7
Staffordshire,CD,F,0,0,0,0,0,5,5
Staffordshire,CH,F,385,372,148,131,143,736,"1,915"
Staffordshire,CH,M,343,312,74,31,25,115,900
Staffordshire,CHI,F,2,0,0,1,0,2,5
Staffordshire,CHI,M,1,2,0,0,0,0,3
Staffordshire,CHIX,F,0,1,0,0,0,13,14
Staffordshire,CHL,M,0,1,0,0,0,0,1
Staffordshire,CHX,F,"1,662","1,947",448,177,150,"1,178","5,562"
Staffordshire,CHX,M,"1,365","1,485",326,16,15,170,"3,377"
Staffordshire,DEV,F,2,2,3,4,2,28,41
Staffordshire,DEV,M,5,2,1,0,0,4,12
Staffordshire,DEVX,F,32,25,5,3,2,14,81
Staffordshire,DEVX,M,22,8,2,0,0,2,34
Staffordshire,DEX,F,112,86,65,44,52,180,539
Staffordshire,DEX,M,104,96,30,3,5,17,255
Staffordshire,DEXX,F,10,13,6,5,4,3,41
Staffordshire,DEXX,M,17,7,2,0,1,1,28
Staffordshire,DG,F,0,0,0,0,0,9,9
Staffordshire,DRX,F,4,0,0,0,0,0,4
Staffordshire,DS,F,49,42,49,53,120,238,551
Staffordshire,DS,M,6,5,3,2,4,3,23
Staffordshire,DSHO,F,1,0,0,0,0,0,1
Staffordshire,DSX,F,13,8,11,19,26,58,135
Staffordshire,DSX,M,8,0,0,0,1,0,9
Staffordshire,DV,F,0,0,0,0,0,28,28
Staffordshire,DV,M,0,0,0,0,0,5,5
Staffordshire,DVX,F,0,0,0,0,0,11,11
Staffordshire,DVX,M,0,0,0,0,0,1,1
Staffordshire,DZE,F,0,0,0,0,0,1,1
Staffordshire,DZE,M,0,1,0,0,0,0,1
Staffordshire,EP,F,0,0,0,0,0,1,1
Staffordshire,FE,F,0,0,0,0,1,0,1
Staffordshire,FR,F,0,0,0,0,0,"15,768","15,768"
Staffordshire,FR,M,0,0,0,0,0,252,252
Staffordshire,FRX,F,0,0,0,0,0,348,348
Staffordshire,FRX,M,0,1,0,0,0,21,22
Staffordshire,GA,F,9,5,1,1,3,33,52
Staffordshire,GA,M,4,13,5,0,0,3,25
Staffordshire,GASX,F,0,0,0,0,0,1,1
Staffordshire,GAX,F,23,8,7,5,2,10,55
Staffordshire,GAX,M,22,5,1,0,0,1,29
Staffordshire,GB,F,1,0,1,0,0,0,2
Staffordshire,GBX,F,1,0,0,0,0,0,1
Staffordshire,GBX,M,1,0,0,0,0,0,1
Staffordshire,GE,F,0,0,1,0,0,1,2
Staffordshire,GE,M,0,0,0,0,0,1,1
Staffordshire,GEX,F,16,29,14,0,1,5,65
Staffordshire,GEX,M,12,30,11,0,0,1,54
Staffordshire,GL,F,16,14,10,8,4,14,66
Staffordshire,GL,M,14,21,2,0,1,0,38
Staffordshire,GLX,F,1,5,6,0,0,3,15
Staffordshire,GU,F,66,84,103,88,63,213,617
Staffordshire,GU,M,13,4,3,1,0,0,21
Staffordshire,GUX,F,5,1,4,1,1,10,22
Staffordshire,GUX,M,2,0,0,0,0,0,2
Staffordshire,GY,F,2,0,0,0,0,0,2
Staffordshire,GY,M,3,0,0,0,0,0,3
Staffordshire,H,F,0,0,0,0,0,216,216
Staffordshire,H,M,0,0,0,0,0,43,43
Staffordshire,HE,F,269,271,171,64,81,275,"1,131"
Staffordshire,HE,M,320,205,87,51,17,68,748
Staffordshire,HEBL,F,0,0,0,0,0,24,24
Staffordshire,HEBLX,F,0,0,0,0,0,105,105
Staffordshire,HEBLX,M,0,0,0,0,0,12,12
Staffordshire,HEBRX,F,0,0,0,0,0,1,1
Staffordshire,HER,F,0,0,0,0,0,23,23
Staffordshire,HER,M,0,0,0,0,0,4,4
Staffordshire,HERX,F,0,0,0,0,0,39,39
Staffordshire,HERX,M,0,0,0,0,0,3,3
Staffordshire,HEX,F,"1,935","1,511",646,332,215,704,"5,343"
Staffordshire,HEX,M,"1,848","1,343",383,25,15,42,"3,656"
Staffordshire,HF,F,"10,241","9,649","10,532","10,246","8,343","16,455","65,466"
Staffordshire,HF,M,"4,023","1,663",541,108,30,83,"6,448"
Staffordshire,HFX,F,810,783,790,864,735,"1,396","5,378"
Staffordshire,HFX,M,364,225,70,12,1,6,678
Staffordshire,HI,F,30,34,19,22,36,118,259
Staffordshire,HI,M,37,44,10,5,2,19,117
Staffordshire,HIX,F,19,20,3,1,4,7,54
Staffordshire,HIX,M,11,18,1,0,0,0,30
Staffordshire,HL,F,0,0,0,0,0,3,3
Staffordshire,HL,M,0,0,0,0,0,1,1
Staffordshire,HO,F,"1,364","1,498","1,586","1,361","1,386","2,323","9,518"
Staffordshire,HO,M,438,182,77,18,12,16,743
Staffordshire,HOX,F,109,158,147,102,71,211,798
Staffordshire,HOX,M,75,25,1,0,0,0,101
Staffordshire,HX,F,0,0,0,0,0,511,511
Staffordshire,HX,M,0,0,0,0,0,135,135
Staffordshire,IM,F,7,4,4,6,4,13,38
Staffordshire,IM,M,12,1,2,0,0,2,17
Staffordshire,IMX,F,5,10,7,6,5,2,35
Staffordshire,IMX,M,3,1,3,0,1,0,8
Staffordshire,JE,F,295,389,402,344,256,729,"2,415"
Staffordshire,JE,M,21,10,10,3,6,6,56
Staffordshire,JEX,F,391,338,244,292,227,120,"1,612"
Staffordshire,JEX,M,17,9,2,1,0,0,29
Staffordshire,JY,F,41,0,0,0,0,3,44
Staffordshire,JY,M,2,0,0,0,0,0,2
Staffordshire,KE,F,0,2,0,0,0,0,2
Staffordshire,KEX,F,0,1,0,0,0,0,1
Staffordshire,LH,F,60,60,38,42,30,111,341
Staffordshire,LH,M,81,52,8,6,2,22,171
Staffordshire,LHX,F,69,62,29,6,48,27,241
Staffordshire,LHX,M,58,41,12,0,0,5,116
Staffordshire,LI,F,0,0,0,0,0,182,182
Staffordshire,LI,M,0,0,0,0,0,68,68
Staffordshire,LIM,F,"1,043",833,364,298,245,826,"3,609"
Staffordshire,LIM,M,"1,007",645,206,59,55,196,"2,168"
Staffordshire,LIMB,F,0,0,0,0,0,11,11
Staffordshire,LIMBX,F,0,0,0,0,0,82,82
Staffordshire,LIMBX,M,0,0,0,0,0,8,8
Staffordshire,LIMR,F,0,0,0,0,0,37,37
Staffordshire,LIMR,M,0,0,0,0,0,7,7
Staffordshire,LIMRX,F,0,0,0,0,0,63,63
Staffordshire,LIMRX,M,0,0,0,0,0,1,1
Staffordshire,LIMX,F,"4,910","4,231","1,389",697,611,"2,061","13,899"
Staffordshire,LIMX,M,"4,773","3,640",716,57,25,130,"9,341"
Staffordshire,LIX,F,0,0,0,0,0,697,697
Staffordshire,LIX,M,0,0,0,0,0,188,188
Staffordshire,LM,F,0,0,0,0,0,9,9
Staffordshire,LM,M,0,0,0,0,0,2,2
Staffordshire,LMX,F,0,0,0,0,0,15,15
Staffordshire,LR,F,0,1,0,1,1,6,9
Staffordshire,LR,M,0,4,0,0,0,1,5
Staffordshire,LRX,F,3,6,3,3,1,0,16
Staffordshire,LRX,M,2,22,0,0,0,0,24
Staffordshire,LU,F,0,0,0,0,0,1,1
Staffordshire,LUX,M,0,0,1,0,0,0,1
Staffordshire,MAR,F,0,0,0,0,0,1,1
Staffordshire,MARX,F,0,0,0,0,0,1,1
Staffordshire,MAX,F,0,0,0,0,0,2,2
Staffordshire,MG,F,1,5,1,3,2,14,26
Staffordshire,MG,M,1,5,6,2,0,0,14
Staffordshire,MGX,F,2,3,4,3,0,11,23
Staffordshire,MGX,M,3,1,2,0,0,1,7
Staffordshire,MO,F,20,30,20,12,22,40,144
Staffordshire,MO,M,5,6,2,0,0,2,15
Staffordshire,MOX,F,97,92,71,73,61,156,550
Staffordshire,MOX,M,101,36,6,0,0,5,148
Staffordshire,MRI,F,3,5,5,8,6,35,62
Staffordshire,MRI,M,2,17,2,2,0,0,23
Staffordshire,MRIX,F,92,73,110,49,43,103,470
Staffordshire,MRIX,M,57,29,5,0,0,0,91
Staffordshire,ND,F,0,0,0,0,0,3,3
Staffordshire,ND,M,0,0,0,0,0,1,1
Staffordshire,NDX,F,0,0,0,0,0,1,1
Staffordshire,NO,F,0,0,1,2,0,2,5
Staffordshire,NOX,F,1,2,0,0,0,4,7
Staffordshire,NOX,M,1,0,0,0,0,0,1
Staffordshire,NRX,F,17,0,2,0,3,2,24
Staffordshire,NRX,M,12,0,0,0,0,0,12
Staffordshire,NS,F,0,0,0,0,0,686,686
Staffordshire,NS,M,0,0,0,0,0,3,3
Staffordshire,OE,F,0,1,0,0,0,0,1
Staffordshire,OO,F,0,0,0,0,0,2,2
Staffordshire,PA,F,0,1,0,1,0,2,4
Staffordshire,PAX,F,3,6,0,0,1,6,16
Staffordshire,PAX,M,2,6,0,0,0,0,8
Staffordshire,PI,F,0,1,0,0,0,3,4
Staffordshire,PIX,F,27,19,22,0,1,31,100
Staffordshire,PIX,M,22,9,4,1,0,3,39
Staffordshire,ROX,F,1,0,0,1,1,6,9
Staffordshire,ROX,M,1,0,0,0,0,0,1
Staffordshire,RP,F,9,3,3,6,3,13,37
Staffordshire,RP,M,8,10,12,2,0,5,37
Staffordshire,RPX,F,7,7,1,2,0,2,19
Staffordshire,RPX,M,8,4,1,0,0,1,14
Staffordshire,RWFR,F,3,0,0,0,0,16,19
Staffordshire,RWFR,M,1,0,0,0,0,0,1
Staffordshire,SA,F,0,12,0,2,1,17,32
Staffordshire,SA,M,0,6,3,2,0,4,15
Staffordshire,SAX,F,118,117,71,30,9,96,441
Staffordshire,SAX,M,100,117,20,4,1,8,250
Staffordshire,SB,F,0,1,0,0,0,1,2
Staffordshire,SBX,F,0,0,0,1,2,2,5
Staffordshire,SD,F,72,66,59,46,39,140,422
Staffordshire,SD,M,62,27,4,1,1,7,102
Staffordshire,SDX,F,44,56,18,11,14,26,169
Staffordshire,SDX,M,41,37,4,3,1,0,86
Staffordshire,SH,F,0,3,1,0,0,9,13
Staffordshire,SH,M,1,2,1,0,0,0,4
Staffordshire,SHO,F,221,222,191,135,69,447,"1,285"
Staffordshire,SHO,M,167,97,32,7,2,20,325
Staffordshire,SHOX,F,176,97,108,48,37,95,561
Staffordshire,SHOX,M,82,60,29,7,0,3,181
Staffordshire,SHX,F,6,4,1,2,2,8,23
Staffordshire,SHX,M,3,2,0,0,1,1,7
Staffordshire,SM,F,447,409,180,132,143,641,"1,952"
Staffordshire,SM,M,432,363,90,46,30,121,"1,082"
Staffordshire,SMX,F,"2,100","1,907",607,333,330,"1,434","6,711"
Staffordshire,SMX,M,"1,953","1,351",342,50,37,197,"3,930"
Staffordshire,SOB,F,0,0,0,0,0,1,1
Staffordshire,SOBX,F,0,0,0,0,0,1,1
Staffordshire,SRW,F,4,3,1,0,0,0,8
Staffordshire,SRW,M,4,0,0,0,0,0,4
Staffordshire,SRWX,F,60,22,5,11,5,1,104
Staffordshire,SRWX,M,26,12,0,0,0,0,38
Staffordshire,STX,F,0,1,0,0,0,0,1
Staffordshire,STX,M,0,2,0,0,0,0,2
Staffordshire,SU,F,0,0,1,0,0,0,1
Staffordshire,SU,M,0,0,0,1,0,0,1
Staffordshire,SUX,F,5,9,0,0,0,1,15
Staffordshire,SUX,M,6,4,6,0,0,0,16
Staffordshire,TBX,F,0,0,0,3,0,0,3
Staffordshire,WB,F,15,25,12,13,1,45,111
Staffordshire,WB,M,20,70,12,1,0,4,107
Staffordshire,WBX,F,35,18,17,5,3,40,118
Staffordshire,WBX,M,44,17,5,0,0,1,67
Staffordshire,WGX,F,0,0,0,0,0,1,1
Staffordshire,WP,F,20,18,7,6,18,33,102
Staffordshire,WP,M,19,8,6,3,0,2,38
Staffordshire,WPX,F,0,2,0,0,1,0,3
Staffordshire,WPX,M,0,3,0,0,0,0,3
Staffordshire,WS,F,0,0,0,0,0,3,3
Staffordshire,WS,M,0,1,2,0,0,0,3
Staffordshire,WSX,F,5,0,0,0,0,0,5
Staffordshire,WSX,M,9,1,0,0,0,0,10
Staffordshire,WW,F,1,0,1,0,0,2,4
Staffordshire,WW,M,0,0,1,0,0,0,1
Staffordshire,WWX,F,5,2,2,1,1,0,11
Suffolk,AA,F,101,180,90,55,37,124,587
Suffolk,AA,M,111,100,44,7,3,14,279
Suffolk,AAX,F,736,681,235,142,103,347,"2,244"
Suffolk,AAX,M,714,556,179,6,6,29,"1,490"
Suffolk,AN,M,1,0,0,0,0,0,1
Suffolk,AY,M,0,16,0,0,0,0,16
Suffolk,AYX,M,0,1,0,0,0,0,1
Suffolk,BA,F,22,18,5,7,7,28,87
Suffolk,BA,M,27,12,2,4,5,12,62
Suffolk,BABX,F,0,0,0,0,0,4,4
Suffolk,BABX,M,0,0,0,0,0,3,3
Suffolk,BAX,F,374,218,59,37,31,146,865
Suffolk,BAX,M,310,148,24,3,8,26,519
Suffolk,BAZ,F,0,0,0,0,0,1,1
Suffolk,BAZX,F,20,11,0,0,0,3,34
Suffolk,BAZX,M,24,0,0,0,0,3,27
Suffolk,BB,F,59,33,15,11,9,50,177
Suffolk,BB,M,35,19,5,0,2,33,94
Suffolk,BBX,F,619,497,140,117,44,260,"1,677"
Suffolk,BBX,M,404,249,36,5,2,52,748
Suffolk,BF,F,48,74,91,112,133,184,642
Suffolk,BF,M,66,115,60,14,11,3,269
Suffolk,BFX,F,13,14,9,5,13,24,78
Suffolk,BFX,M,5,11,4,1,3,1,25
Suffolk,BG,F,5,18,3,0,3,13,42
Suffolk,BG,M,7,4,2,1,0,3,17
Suffolk,BGX,F,9,2,5,1,1,11,29
Suffolk,BGX,M,8,1,0,0,0,0,9
Suffolk,BH,F,0,0,0,0,0,50,50
Suffolk,BH,M,1,0,0,0,0,1,2
Suffolk,BHX,F,0,0,0,0,0,3,3
Suffolk,BP,M,0,0,1,0,0,0,1
Suffolk,BR,F,0,0,1,0,0,0,1
Suffolk,BRX,M,0,1,0,0,0,0,1
Suffolk,BS,F,0,0,0,1,0,7,8
Suffolk,BS,M,0,1,0,0,0,0,1
Suffolk,BSH,F,0,0,2,7,1,10,20
Suffolk,BSH,M,1,7,3,0,1,1,13
Suffolk,BSHX,F,42,52,23,10,14,5,146
Suffolk,BSHX,M,62,22,1,0,0,1,86
Suffolk,BSX,F,2,3,8,6,0,6,25
Suffolk,BSX,M,8,2,2,0,1,0,13
Suffolk,BU,F,0,0,1,0,0,0,1
Suffolk,BU,M,0,0,1,0,0,0,1
Suffolk,BW,F,6,1,4,5,9,25,50
Suffolk,BW,M,7,4,1,0,0,1,13
Suffolk,BWX,F,1,1,2,0,2,1,7
Suffolk,BWX,M,0,2,0,0,0,0,2
Suffolk,CB,F,0,1,0,0,0,29,30
Suffolk,CH,F,122,83,31,35,36,207,514
Suffolk,CH,M,98,56,10,4,8,29,205
Suffolk,CHI,F,0,0,1,0,0,2,3
Suffolk,CHIX,F,0,0,0,0,0,2,2
Suffolk,CHX,F,447,353,46,53,46,350,"1,295"
Suffolk,CHX,M,322,265,28,1,2,44,662
Suffolk,DEV,F,4,4,0,0,0,3,11
Suffolk,DEV,M,0,2,0,0,0,0,2
Suffolk,DEVX,F,5,20,1,0,0,4,30
Suffolk,DEVX,M,18,5,3,0,0,0,26
Suffolk,DEX,F,29,23,12,17,12,64,157
Suffolk,DEX,M,30,18,11,3,0,3,65
Suffolk,DEXX,F,1,3,0,8,0,1,13
Suffolk,DEXX,M,1,2,0,0,0,1,4
Suffolk,DRX,M,0,1,0,0,0,0,1
Suffolk,DS,F,0,0,0,0,1,0,1
Suffolk,DS,M,0,6,0,0,0,0,6
Suffolk,DV,F,0,0,0,0,0,45,45
Suffolk,DVX,F,0,0,0,0,0,11,11
Suffolk,DVX,M,0,0,0,0,0,2,2
Suffolk,FR,F,0,0,0,0,0,829,829
Suffolk,FR,M,0,0,0,0,0,98,98
Suffolk,FRX,F,0,0,0,0,0,53,53
Suffolk,FRX,M,0,0,0,0,0,7,7
Suffolk,GA,F,3,13,1,2,0,13,32
Suffolk,GA,M,0,2,0,0,0,0,2
Suffolk,GAX,F,0,0,0,0,0,1,1
Suffolk,GBX,F,0,0,0,0,1,0,1
Suffolk,GE,F,0,1,0,0,0,2,3
Suffolk,GE,M,0,0,0,0,0,2,2
Suffolk,GEX,F,39,28,8,5,7,33,120
Suffolk,GEX,M,23,21,3,0,0,3,50
Suffolk,GL,F,1,1,0,1,0,4,7
Suffolk,GLX,F,0,0,0,0,0,1,1
Suffolk,GLX,M,0,1,0,0,0,0,1
Suffolk,GU,F,12,11,5,9,6,44,87
Suffolk,GU,M,12,3,2,1,0,0,18
Suffolk,GUX,F,0,0,1,1,2,1,5
Suffolk,GUX,M,0,1,1,0,0,0,2
Suffolk,H,F,0,0,0,0,0,45,45
Suffolk,H,M,0,0,0,0,0,4,4
Suffolk,HE,F,29,40,13,36,14,41,173
Suffolk,HE,M,35,47,13,1,4,4,104
Suffolk,HEBLX,F,0,0,0,0,0,31,31
Suffolk,HEBLX,M,0,0,0,0,0,3,3
Suffolk,HER,F,0,0,0,0,0,2,2
Suffolk,HERX,F,0,0,0,0,0,17,17
Suffolk,HEX,F,227,263,174,113,74,624,"1,475"
Suffolk,HEX,M,267,388,161,1,1,9,827
Suffolk,HF,F,684,648,760,674,550,964,"4,280"
Suffolk,HF,M,555,509,162,13,9,10,"1,258"
Suffolk,HFX,F,18,20,8,26,60,55,187
Suffolk,HFX,M,25,25,4,0,1,0,55
Suffolk,HI,F,22,18,12,9,14,60,135
Suffolk,HI,M,11,17,12,10,5,17,72
Suffolk,HIX,F,1,2,2,0,0,3,8
Suffolk,HIX,M,4,0,0,0,0,7,11
Suffolk,HO,F,231,208,188,237,206,361,"1,431"
Suffolk,HO,M,217,54,11,3,7,1,293
Suffolk,HOX,F,0,3,0,0,0,11,14
Suffolk,HOX,M,0,1,3,0,0,0,4
Suffolk,HX,F,0,0,0,0,0,249,249
Suffolk,HX,M,0,0,0,0,0,6,6
Suffolk,IM,F,4,0,0,0,1,4,9
Suffolk,IMX,F,0,0,0,1,0,0,1
Suffolk,IMX,M,1,0,0,0,0,0,1
Suffolk,JE,F,52,81,102,74,71,153,533
Suffolk,JE,M,18,15,24,1,0,3,61
Suffolk,JEX,F,6,7,6,5,1,7,32
Suffolk,JEX,M,6,11,1,0,0,1,19
Suffolk,JY,F,15,0,0,0,0,6,21
Suffolk,KE,F,0,0,0,0,0,1,1
Suffolk,KEX,F,0,0,0,0,0,4,4
Suffolk,KEX,M,0,1,0,0,0,0,1
Suffolk,LH,F,17,15,15,9,6,30,92
Suffolk,LH,M,17,18,4,1,0,6,46
Suffolk,LHX,F,1,7,1,0,0,14,23
Suffolk,LHX,M,2,0,0,0,0,0,2
Suffolk,LI,F,0,0,0,0,0,50,50
Suffolk,LI,M,0,0,0,0,0,14,14
Suffolk,LIM,F,232,165,41,54,23,113,628
Suffolk,LIM,M,184,148,26,13,6,22,399
Suffolk,LIM X,F,0,0,0,0,0,1,1
Suffolk,LIMBX,F,0,0,0,0,0,10,10
Suffolk,LIMBX,M,0,0,0,0,0,1,1
Suffolk,LIMR,F,0,0,0,0,0,13,13
Suffolk,LIMR,M,0,0,0,0,0,4,4
Suffolk,LIMRX,F,0,0,0,0,0,8,8
Suffolk,LIMRX,M,0,0,0,0,0,1,1
Suffolk,LIMX,F,"1,205",847,223,109,101,573,"3,058"
Suffolk,LIMX,M,987,758,141,12,15,31,"1,944"
Suffolk,LIX,F,0,0,0,0,0,183,183
Suffolk,LIX,M,0,0,0,0,0,36,36
Suffolk,LM,F,0,0,0,0,0,4,4
Suffolk,LMX,F,0,0,0,0,0,24,24
Suffolk,LR,F,10,4,4,3,2,3,26
Suffolk,LR,M,4,5,1,3,0,0,13
Suffolk,LRX,F,0,3,0,0,0,1,4
Suffolk,LRX,M,1,0,0,1,0,0,2
Suffolk,MG,F,1,10,3,0,1,13,28
Suffolk,MG,M,0,9,1,0,0,0,10
Suffolk,MGX,F,0,0,0,1,0,11,12
Suffolk,MGX,M,0,1,1,0,0,0,2
Suffolk,MO,F,0,1,0,0,1,2,4
Suffolk,MO,M,1,2,0,0,0,1,4
Suffolk,MOX,F,0,0,0,9,4,19,32
Suffolk,MOX,M,6,0,4,0,0,0,10
Suffolk,MRI,F,40,38,23,26,47,135,309
Suffolk,MRI,M,61,16,1,0,1,7,86
Suffolk,MRIX,F,12,18,4,8,7,20,69
Suffolk,MRIX,M,18,27,1,0,0,0,46
Suffolk,NDX,F,0,0,0,0,0,3,3
Suffolk,NO,F,0,1,0,0,0,0,1
Suffolk,NO,M,0,1,0,0,0,0,1
Suffolk,NOX,F,1,8,0,0,0,1,10
Suffolk,NRX,F,3,0,0,0,0,0,3
Suffolk,NRX,M,6,0,0,0,0,0,6
Suffolk,NS,F,0,0,0,0,0,87,87
Suffolk,OB,F,0,0,0,0,0,8,8
Suffolk,PAX,F,1,3,0,1,0,0,5
Suffolk,PAX,M,1,5,0,0,0,0,6
Suffolk,PI,F,0,0,0,0,0,5,5
Suffolk,PIX,F,0,1,0,0,1,15,17
Suffolk,PIX,M,1,2,0,0,0,1,4
Suffolk,ROTX,M,2,1,0,0,0,0,3
Suffolk,RP,F,145,133,131,93,57,309,868
Suffolk,RP,M,162,98,11,7,7,27,312
Suffolk,RPX,F,44,27,22,24,19,38,174
Suffolk,RPX,M,38,15,3,0,1,7,64
Suffolk,SA,F,0,2,0,0,0,6,8
Suffolk,SA,M,0,5,2,0,0,0,7
Suffolk,SAX,F,27,22,6,6,11,38,110
Suffolk,SAX,M,13,24,3,1,0,0,41
Suffolk,SD,F,65,42,29,10,10,159,315
Suffolk,SD,M,49,43,6,1,1,1,101
Suffolk,SDX,F,52,39,22,9,8,35,165
Suffolk,SDX,M,55,20,2,0,0,0,77
Suffolk,SGX,F,1,1,0,0,0,0,2
Suffolk,SGX,M,1,0,0,0,0,0,1
Suffolk,SH,F,1,0,0,0,1,3,5
Suffolk,SH,M,0,1,0,0,0,0,1
Suffolk,SHO,F,0,1,1,0,0,5,7
Suffolk,SHO,M,0,15,1,0,0,0,16
Suffolk,SHOX,F,0,21,4,2,3,21,51
Suffolk,SHOX,M,3,4,2,1,0,1,11
Suffolk,SHX,F,4,7,1,0,1,1,14
Suffolk,SHX,M,1,3,0,0,0,0,4
Suffolk,SM,F,127,105,42,54,48,255,631
Suffolk,SM,M,145,80,15,4,8,43,295
Suffolk,SMX,F,"1,064",744,196,184,163,"1,118","3,469"
Suffolk,SMX,M,807,539,68,5,4,128,"1,551"
Suffolk,SRWX,F,8,0,0,0,0,0,8
Suffolk,SRWX,M,1,3,0,0,0,0,4
Suffolk,SU,F,12,17,5,2,0,37,73
Suffolk,SU,M,13,14,4,1,0,2,34
Suffolk,SUX,F,20,36,2,0,0,10,68
Suffolk,SUX,M,10,15,1,0,0,0,26
Suffolk,WB,F,1,2,13,7,1,10,34
Suffolk,WB,M,3,0,0,0,1,1,5
Suffolk,WBX,F,0,1,0,0,0,28,29
Suffolk,WBX,M,1,1,0,0,0,0,2
Suffolk,WP,F,0,8,0,2,0,8,18
Suffolk,WP,M,0,3,0,0,0,0,3
Suffolk,WPX,F,0,1,1,1,0,0,3
Suffolk,WPX,M,3,0,0,0,0,0,3
Suffolk,WSX,F,0,0,0,1,0,0,1
Isles of Scilly,AA,F,1,0,0,0,0,0,1
Isles of Scilly,AA,M,1,1,0,0,0,0,2
Isles of Scilly,AAX,F,8,6,0,1,1,7,23
Isles of Scilly,AAX,M,7,6,0,0,0,1,14
Isles of Scilly,AY,F,0,0,0,0,3,2,5
Isles of Scilly,AY,M,0,1,0,0,0,0,1
Isles of Scilly,AYX,F,0,0,1,0,0,1,2
Isles of Scilly,BAX,F,0,0,1,0,0,0,1
Isles of Scilly,BBX,F,3,0,0,0,0,0,3
Isles of Scilly,BBX,M,3,0,0,0,0,0,3
Isles of Scilly,CHX,F,1,0,0,0,1,2,4
Isles of Scilly,DEV,F,3,3,0,0,0,4,10
Isles of Scilly,DEV,M,0,1,0,0,0,0,1
Isles of Scilly,DEVX,F,1,10,0,0,0,0,11
Isles of Scilly,DEVX,M,0,11,0,0,0,0,11
Isles of Scilly,DEX,F,0,0,0,0,0,1,1
Isles of Scilly,GU,F,0,0,0,0,0,1,1
Isles of Scilly,GUX,F,0,2,1,0,0,1,4
Isles of Scilly,GUX,M,1,0,0,1,0,0,2
Isles of Scilly,H,M,0,0,0,0,0,1,1
Isles of Scilly,HEX,F,5,8,1,0,1,5,20
Isles of Scilly,HEX,M,13,3,0,0,0,0,16
Isles of Scilly,HX,F,0,0,0,0,0,3,3
Isles of Scilly,JE,F,0,1,2,0,0,7,10
Isles of Scilly,JE,M,0,3,0,0,0,1,4
Isles of Scilly,LIM,F,1,0,1,0,0,1,3
Isles of Scilly,LIM,M,1,2,0,0,1,0,4
Isles of Scilly,LIMX,F,9,11,4,6,1,9,40
Isles of Scilly,LIMX,M,11,12,0,0,0,0,23
Isles of Scilly,LIX,F,0,0,0,0,0,3,3
Isles of Scilly,SD,F,0,0,0,0,4,0,4
Isles of Scilly,SDX,F,2,1,0,0,0,0,3
Isles of Scilly,SDX,M,2,2,0,0,0,0,4
Isles of Scilly,SH,F,0,2,0,2,0,0,4
Isles of Scilly,SM,F,1,0,0,0,0,0,1
Isles of Scilly,SMX,F,2,0,0,0,0,1,3
Isles of Scilly,SMX,M,2,0,0,0,0,0,2
Surrey,AA,F,148,90,66,62,48,189,603
Surrey,AA,M,152,94,11,8,6,16,287
Surrey,AAX,F,584,372,140,112,84,311,"1,603"
Surrey,AAX,M,631,277,58,4,1,17,988
Surrey,AR,F,0,1,0,0,0,0,1
Surrey,AY,F,29,33,34,25,16,107,244
Surrey,AY,M,33,14,14,2,1,0,64
Surrey,AYX,F,0,0,0,0,0,1,1
Surrey,BA,F,21,16,15,8,1,15,76
Surrey,BA,M,30,11,0,0,2,6,49
Surrey,BABX,F,0,0,0,0,0,15,15
Surrey,BARX,F,0,0,0,0,0,2,2
Surrey,BAX,F,53,28,20,15,21,179,316
Surrey,BAX,M,58,22,13,1,0,8,102
Surrey,BAZX,F,1,0,0,0,0,0,1
Surrey,BB,F,16,9,3,2,2,18,50
Surrey,BB,M,10,6,3,5,2,10,36
Surrey,BBX,F,344,269,59,42,10,118,842
Surrey,BBX,M,430,345,93,5,5,14,892
Surrey,BF,F,256,230,266,267,307,356,"1,682"
Surrey,BF,M,333,188,44,5,2,6,578
Surrey,BFX,F,290,212,223,183,8,8,924
Surrey,BFX,M,210,158,23,1,0,1,393
Surrey,BG,F,3,2,0,1,2,6,14
Surrey,BG,M,4,2,2,5,0,5,18
Surrey,BGX,F,3,8,0,0,1,3,15
Surrey,BGX,M,7,9,2,0,0,0,18
Surrey,BH,F,0,0,0,0,0,45,45
Surrey,BS,F,0,0,0,0,0,2,2
Surrey,BS,M,1,0,0,0,0,0,1
Surrey,BSH,F,11,12,4,5,8,22,62
Surrey,BSH,M,8,10,2,0,1,2,23
Surrey,BSHX,F,7,2,1,1,1,0,12
Surrey,BSHX,M,13,5,0,0,0,0,18
Surrey,BSX,F,0,0,1,6,14,2,23
Surrey,BSX,M,9,0,0,0,0,0,9
Surrey,BW,F,0,0,0,1,0,4,5
Surrey,BW,M,0,2,0,0,0,0,2
Surrey,BWX,F,3,2,0,1,0,3,9
Surrey,BWX,M,2,3,0,0,0,0,5
Surrey,CB,F,0,0,1,1,0,0,2
Surrey,CB,M,0,1,5,0,0,0,6
Surrey,CH,F,65,27,15,29,15,76,227
Surrey,CH,M,53,13,5,6,7,30,114
Surrey,CHX,F,299,225,103,41,27,555,"1,250"
Surrey,CHX,M,305,148,18,12,8,67,558
Surrey,DE,F,0,0,0,0,0,2,2
Surrey,DEV,F,11,13,0,0,0,19,43
Surrey,DEV,M,9,0,0,0,0,0,9
Surrey,DEVX,F,1,2,0,1,0,6,10
Surrey,DEVX,M,6,1,0,0,0,1,8
Surrey,DEX,F,38,26,17,32,18,66,197
Surrey,DEX,M,24,21,12,2,3,5,67
Surrey,DEXX,F,1,4,1,0,0,5,11
Surrey,DEXX,M,0,2,0,0,0,0,2
Surrey,DR,F,0,0,0,0,0,2,2
Surrey,DS,F,0,8,23,6,6,3,46
Surrey,DS,M,2,0,0,0,1,0,3
Surrey,DSX,F,0,0,5,0,2,2,9
Surrey,DV,F,0,0,0,0,0,12,12
Surrey,DV,M,0,0,0,0,0,4,4
Surrey,DVX,F,0,0,0,0,0,14,14
Surrey,DVX,M,0,0,0,0,0,5,5
Surrey,FR,F,0,0,0,0,0,"1,047","1,047"
Surrey,FR,M,0,0,0,0,0,72,72
Surrey,FRX,F,0,0,0,0,0,42,42
Surrey,FRX,M,0,0,0,0,0,18,18
Surrey,GA,F,0,0,0,0,0,3,3
Surrey,GAX,F,0,0,0,1,0,3,4
Surrey,GBX,M,1,0,0,0,0,1,2
Surrey,GEX,F,0,0,0,0,0,2,2
Surrey,GL,F,0,0,2,3,1,0,6
Surrey,GU,F,4,5,2,2,5,28,46
Surrey,GU,M,2,5,4,0,0,1,12
Surrey,GUX,F,0,0,1,0,0,3,4
Surrey,GUX,M,0,1,0,0,0,0,1
Surrey,H,F,0,0,0,0,0,38,38
Surrey,H,M,0,0,0,0,0,8,8
Surrey,HE,F,62,53,39,23,21,78,276
Surrey,HE,M,90,31,16,4,6,7,154
Surrey,HEBLX,F,0,0,0,0,0,18,18
Surrey,HER,F,0,0,0,0,0,12,12
Surrey,HERX,F,0,0,0,0,0,4,4
Surrey,HEX,F,275,180,119,70,65,372,"1,081"
Surrey,HEX,M,281,181,58,7,1,5,533
Surrey,HF,F,551,728,541,487,488,"1,001","3,796"
Surrey,HF,M,702,532,105,15,6,36,"1,396"
Surrey,HFX,F,2,0,1,2,0,16,21
Surrey,HFX,M,9,2,2,0,0,1,14
Surrey,HI,F,16,15,17,12,14,72,146
Surrey,HI,M,20,31,14,4,0,21,90
Surrey,HIX,F,3,0,0,0,0,1,4
Surrey,HIX,M,1,0,0,0,0,0,1
Surrey,HL,F,0,0,0,0,0,1,1
Surrey,HO,F,336,275,246,200,189,309,"1,555"
Surrey,HO,M,144,77,13,2,0,16,252
Surrey,HOX,F,0,0,0,0,0,2,2
Surrey,HX,F,0,0,0,0,0,122,122
Surrey,HX,M,0,0,0,0,0,20,20
Surrey,IM,F,0,1,2,0,0,2,5
Surrey,IM,M,1,2,0,0,0,0,3
Surrey,JE,F,135,74,89,101,50,291,740
Surrey,JE,M,5,2,1,1,0,1,10
Surrey,JEX,F,2,2,0,2,7,8,21
Surrey,JEX,M,1,0,0,0,0,1,2
Surrey,JY,F,7,0,0,0,0,0,7
Surrey,JY,M,5,0,0,0,0,0,5
Surrey,LH,F,2,1,0,1,1,13,18
Surrey,LH,M,5,4,0,0,1,2,12
Surrey,LHX,F,8,0,1,0,1,4,14
Surrey,LHX,M,4,1,0,0,0,0,5
Surrey,LI,F,0,0,0,0,0,21,21
Surrey,LI,M,0,0,0,0,0,12,12
Surrey,LIM,F,73,28,20,15,13,76,225
Surrey,LIM,M,70,26,12,7,4,13,132
Surrey,LIMB,F,0,0,0,0,0,1,1
Surrey,LIMBX,F,0,0,0,0,0,13,13
Surrey,LIMR,F,0,0,0,0,0,2,2
Surrey,LIMRX,F,0,0,0,0,0,3,3
Surrey,LIMX,F,561,355,103,66,61,290,"1,436"
Surrey,LIMX,M,559,326,62,5,2,10,964
Surrey,LIX,F,0,0,0,0,0,139,139
Surrey,LIX,M,0,0,0,0,0,22,22
Surrey,LMX,F,0,0,0,0,0,6,6
Surrey,MGX,F,1,7,1,0,1,3,13
Surrey,MGX,M,2,11,1,0,0,0,14
Surrey,MO,F,0,0,0,0,0,1,1
Surrey,MO,M,1,0,0,1,0,0,2
Surrey,MOX,F,0,0,1,0,0,1,2
Surrey,MOX,M,1,2,8,0,0,0,11
Surrey,MRI,F,0,0,0,0,0,2,2
Surrey,MRIX,F,0,0,0,0,1,2,3
Surrey,MRIX,M,0,3,1,0,0,0,4
Surrey,NO,F,0,0,0,0,0,4,4
Surrey,NO,M,1,0,0,0,0,0,1
Surrey,NS,F,0,0,0,0,0,68,68
Surrey,PI,F,0,1,0,0,0,1,2
Surrey,PI,M,0,0,1,0,0,4,5
Surrey,PIX,F,52,49,4,4,4,35,148
Surrey,PIX,M,45,45,1,0,0,2,93
Surrey,RO,F,0,0,0,0,0,1,1
Surrey,RP,F,0,0,0,0,0,2,2
Surrey,RP,M,1,0,0,0,0,0,1
Surrey,RPX,F,0,0,0,4,0,3,7
Surrey,RWFR,F,0,0,0,0,0,1,1
Surrey,SA,F,0,0,0,0,0,8,8
Surrey,SA,M,0,0,0,0,0,1,1
Surrey,SAX,F,3,4,3,4,2,18,34
Surrey,SAX,M,4,4,1,2,0,7,18
Surrey,SB,F,0,1,1,0,0,5,7
Surrey,SBX,F,0,0,2,0,0,0,2
Surrey,SBX,M,0,0,1,0,0,0,1
Surrey,SD,F,22,9,1,8,5,27,72
Surrey,SD,M,18,6,0,0,0,2,26
Surrey,SDX,F,35,33,10,8,4,30,120
Surrey,SDX,M,31,11,1,1,0,0,44
Surrey,SH,F,0,2,0,0,1,8,11
Surrey,SH,M,3,2,0,1,0,0,6
Surrey,SHO,F,0,11,7,7,11,66,102
Surrey,SHO,M,0,17,0,0,1,3,21
Surrey,SHOX,F,1,0,2,0,3,19,25
Surrey,SHOX,M,0,1,0,0,0,3,4
Surrey,SHX,F,0,0,0,1,0,1,2
Surrey,SHX,M,0,0,0,0,0,1,1
Surrey,SM,F,30,17,11,4,5,50,117
Surrey,SM,M,25,4,1,2,2,13,47
Surrey,SMX,F,226,259,97,51,59,333,"1,025"
Surrey,SMX,M,297,220,78,4,1,41,641
Surrey,SOB,F,0,0,1,2,4,29,36
Surrey,SOBX,F,0,0,0,2,0,0,2
Surrey,SOBX,M,0,0,0,0,0,1,1
Surrey,SRW,F,0,1,0,0,0,0,1
Surrey,SRWX,F,0,0,2,2,3,1,8
Surrey,SRWX,M,9,0,4,0,0,0,13
Surrey,STX,F,0,0,0,0,0,4,4
Surrey,STX,M,0,1,0,0,0,0,1
Surrey,SU,F,82,99,44,44,36,160,465
Surrey,SU,M,101,102,25,7,0,9,244
Surrey,SUX,F,73,43,44,24,25,119,328
Surrey,SUX,M,82,51,16,1,1,9,160
Surrey,WB,F,0,0,0,0,0,7,7
Surrey,WB,M,0,0,0,0,0,1,1
Surrey,WBX,F,1,1,0,0,2,2,6
Surrey,WG,F,0,2,0,0,0,0,2
Surrey,WP,F,0,1,4,2,1,3,11
Surrey,WP,M,0,0,1,0,0,0,1
Surrey,WPX,F,0,0,0,2,1,3,6
Surrey,WPX,M,0,1,1,0,0,0,2
Surrey,WS,F,2,1,0,0,0,0,3
Surrey,WS,M,4,1,0,0,0,0,5
Surrey,WSX,F,10,2,4,0,0,0,16
Surrey,WSX,M,12,0,0,0,0,0,12
Surrey,ZE,M,0,0,0,0,0,1,1
East Sussex,AA,F,62,62,25,36,11,100,296
East Sussex,AA,M,94,80,22,7,13,23,239
East Sussex,AAX,F,846,571,212,134,80,395,"2,238"
East Sussex,AAX,M,884,556,83,6,1,17,"1,547"
East Sussex,AUX,M,0,0,0,0,0,1,1
East Sussex,AY,F,50,75,68,52,9,94,348
East Sussex,AY,M,12,18,12,2,0,1,45
East Sussex,AYX,F,1,0,2,1,0,5,9
East Sussex,AYX,M,1,0,2,0,0,0,3
East Sussex,BA,F,10,7,9,3,2,19,50
East Sussex,BA,M,6,5,3,1,0,19,34
East Sussex,BABX,F,0,0,0,0,0,2,2
East Sussex,BARX,F,0,0,0,0,0,1,1
East Sussex,BAX,F,233,190,80,38,26,155,722
East Sussex,BAX,M,222,197,50,3,1,21,494
East Sussex,BAZX,F,3,0,0,0,0,0,3
East Sussex,BB,F,33,24,6,4,2,52,121
East Sussex,BB,M,22,14,5,4,0,10,55
East Sussex,BBX,F,376,262,153,102,83,302,"1,278"
East Sussex,BBX,M,334,231,113,7,1,26,712
East Sussex,BF,F,318,338,324,175,246,366,"1,767"
East Sussex,BF,M,403,191,67,13,2,0,676
East Sussex,BFX,F,31,21,11,18,20,34,135
East Sussex,BFX,M,66,22,6,0,0,0,94
East Sussex,BG,F,6,3,2,4,1,5,21
East Sussex,BG,M,4,1,3,0,1,0,9
East Sussex,BGX,F,0,0,1,1,0,0,2
East Sussex,BH,F,1,0,0,0,0,23,24
East Sussex,BH,M,1,0,0,0,0,2,3
East Sussex,BHX,F,0,0,0,0,0,23,23
East Sussex,BRX,M,1,1,0,0,0,0,2
East Sussex,BS,F,0,0,0,1,0,1,2
East Sussex,BSH,F,25,10,5,11,2,29,82
East Sussex,BSH,M,23,18,0,1,2,2,46
East Sussex,BSHO,F,0,0,0,0,0,8,8
East Sussex,BSHO,M,0,0,0,0,0,1,1
East Sussex,BSHX,F,6,12,4,0,0,7,29
East Sussex,BSHX,M,4,7,1,0,0,0,12
East Sussex,BSX,F,0,0,1,1,0,2,4
East Sussex,BSX,M,4,0,0,0,0,0,4
East Sussex,BU,F,1,0,0,1,0,3,5
East Sussex,BU,M,2,0,0,0,0,0,2
East Sussex,BW,F,39,48,43,49,28,110,317
East Sussex,BW,M,50,46,5,1,0,5,107
East Sussex,BWX,F,55,11,8,4,6,27,111
East Sussex,BWX,M,64,15,1,0,0,2,82
East Sussex,BX,F,0,0,0,0,0,1,1
East Sussex,CAX,F,0,0,0,0,0,1,1
East Sussex,CB,F,0,4,0,0,0,14,18
East Sussex,CB,M,0,0,2,0,0,0,2
East Sussex,CD,F,0,3,0,0,0,0,3
East Sussex,CD,M,0,2,0,0,0,0,2
East Sussex,CH,F,56,29,37,31,19,163,335
East Sussex,CH,M,48,46,14,11,9,22,150
East Sussex,CHIX,F,0,0,0,0,0,1,1
East Sussex,CHX,F,601,442,129,98,91,676,"2,037"
East Sussex,CHX,M,598,447,63,9,3,56,"1,176"
East Sussex,DEV,F,1,8,0,1,0,13,23
East Sussex,DEV,M,0,0,2,0,0,1,3
East Sussex,DEVX,F,16,16,5,0,1,5,43
East Sussex,DEVX,M,16,4,1,0,0,0,21
East Sussex,DEX,F,31,26,23,24,12,71,187
East Sussex,DEX,M,24,31,11,1,0,5,72
East Sussex,DEXX,F,2,11,1,2,0,3,19
East Sussex,DEXX,M,2,3,1,0,0,0,6
East Sussex,DS,F,1,4,0,9,0,0,14
East Sussex,DS,M,8,11,0,0,0,0,19
East Sussex,DSHO,M,1,0,0,0,0,0,1
East Sussex,DSX,F,1,0,3,1,6,4,15
East Sussex,DV,F,0,0,0,0,0,35,35
East Sussex,DV,M,0,0,0,0,0,8,8
East Sussex,DVX,F,0,0,0,0,0,27,27
East Sussex,DVX,M,0,0,0,0,0,7,7
East Sussex,FE,F,0,0,1,0,0,0,1
East Sussex,FR,F,0,0,0,0,0,"1,498","1,498"
East Sussex,FR,M,0,0,0,0,0,59,59
East Sussex,FRX,F,0,0,0,0,0,59,59
East Sussex,FRX,M,0,0,0,0,0,10,10
East Sussex,GAX,F,0,0,0,0,0,3,3
East Sussex,GAX,M,0,8,0,0,0,0,8
East Sussex,GBX,M,0,0,1,0,0,0,1
East Sussex,GEX,F,1,0,0,0,2,2,5
East Sussex,GL,F,2,1,0,1,0,2,6
East Sussex,GL,M,0,1,0,0,0,0,1
East Sussex,GU,F,36,35,51,59,42,217,440
East Sussex,GU,M,13,18,1,3,1,2,38
East Sussex,GUX,F,1,5,4,1,2,4,17
East Sussex,GUX,M,1,3,0,0,0,0,4
East Sussex,GY,F,2,0,0,0,0,0,2
East Sussex,GY,M,1,0,0,0,0,0,1
East Sussex,H,F,0,0,0,0,0,38,38
East Sussex,H,M,0,0,0,0,0,3,3
East Sussex,HE,F,44,28,27,10,9,53,171
East Sussex,HE,M,39,37,12,2,9,8,107
East Sussex,HEBLX,F,0,0,0,0,0,8,8
East Sussex,HERX,F,0,0,0,0,0,14,14
East Sussex,HERX,M,0,0,0,0,0,1,1
East Sussex,HEX,F,233,171,104,58,57,373,996
East Sussex,HEX,M,221,170,72,2,1,4,470
East Sussex,HF,F,976,"1,067","1,197","1,049",985,"1,605","6,879"
East Sussex,HF,M,"1,128",534,354,31,2,18,"2,067"
East Sussex,HFX,F,92,71,70,17,17,87,354
East Sussex,HFX,M,99,34,28,4,0,0,165
East Sussex,HI,F,6,4,6,5,3,46,70
East Sussex,HI,M,4,5,1,1,0,15,26
East Sussex,HIX,F,3,1,1,0,0,8,13
East Sussex,HIX,M,0,2,0,0,0,0,2
East Sussex,HO,F,145,90,98,94,76,164,667
East Sussex,HO,M,100,7,25,10,0,2,144
East Sussex,HOX,F,8,0,0,1,1,15,25
East Sussex,HOX,M,9,1,18,1,0,1,30
East Sussex,HX,F,0,0,0,0,0,123,123
East Sussex,HX,M,0,0,0,0,0,21,21
East Sussex,IM,F,0,0,1,1,0,2,4
East Sussex,IM,M,2,1,0,0,0,0,3
East Sussex,IMX,F,2,3,0,1,0,0,6
East Sussex,IMX,M,2,2,0,0,0,0,4
East Sussex,JE,F,80,58,62,30,43,199,472
East Sussex,JE,M,30,25,9,3,1,9,77
East Sussex,JEX,F,72,48,27,15,15,28,205
East Sussex,JEX,M,23,1,0,0,0,6,30
East Sussex,JY,F,5,0,0,0,0,0,5
East Sussex,KE,F,0,0,0,0,0,1,1
East Sussex,LH,F,19,7,6,8,11,27,78
East Sussex,LH,M,13,7,8,1,1,2,32
East Sussex,LHX,F,4,2,2,0,1,15,24
East Sussex,LHX,M,8,4,0,0,0,1,13
East Sussex,LI,F,0,0,0,0,0,50,50
East Sussex,LI,M,0,0,0,0,0,12,12
East Sussex,LIM,F,148,111,55,46,32,125,517
East Sussex,LIM,M,145,80,27,10,10,40,312
East Sussex,LIM X,F,0,0,0,0,0,3,3
East Sussex,LIM X,M,0,0,0,0,0,1,1
East Sussex,LIMBX,F,0,0,0,0,0,15,15
East Sussex,LIMBX,M,0,0,0,0,0,1,1
East Sussex,LIMR,F,0,0,0,0,0,9,9
East Sussex,LIMR,M,0,0,0,0,0,4,4
East Sussex,LIMRX,F,0,0,0,0,0,16,16
East Sussex,LIMRX,M,0,0,0,0,0,1,1
East Sussex,LIMX,F,"1,164",840,236,157,202,811,"3,410"
East Sussex,LIMX,M,"1,068",896,152,11,5,14,"2,146"
East Sussex,LIX,F,0,0,0,0,0,251,251
East Sussex,LIX,M,0,0,0,0,0,38,38
East Sussex,LM,F,0,0,0,0,0,3,3
East Sussex,LMX,F,0,0,0,0,0,3,3
East Sussex,MG,F,3,2,3,2,1,10,21
East Sussex,MG,M,4,0,1,0,0,0,5
East Sussex,MGX,F,14,5,2,0,0,11,32
East Sussex,MGX,M,13,8,1,0,0,1,23
East Sussex,MO,F,10,5,4,4,8,35,66
East Sussex,MO,M,6,11,1,0,0,2,20
East Sussex,MOX,F,17,15,14,7,8,32,93
East Sussex,MOX,M,10,5,15,0,0,0,30
East Sussex,MRI,F,4,7,3,2,9,30,55
East Sussex,MRI,M,3,4,0,0,0,0,7
East Sussex,MRIX,F,4,1,2,9,10,4,30
East Sussex,MRIX,M,8,4,4,0,0,0,16
East Sussex,NO,F,0,0,0,0,0,1,1
East Sussex,NRX,F,3,0,0,0,0,1,4
East Sussex,NRX,M,6,0,0,0,0,0,6
East Sussex,NS,F,0,0,0,0,0,203,203
East Sussex,NS,M,0,0,0,0,0,2,2
East Sussex,OEX,F,2,2,0,0,0,2,6
East Sussex,OEX,M,1,0,0,0,0,0,1
East Sussex,PI,F,0,1,0,0,0,2,3
East Sussex,PI,M,0,3,0,0,1,1,5
East Sussex,PIX,F,17,10,1,10,4,29,71
East Sussex,PIX,M,22,4,0,0,0,0,26
East Sussex,ROTX,M,0,1,0,0,0,0,1
East Sussex,RP,F,0,0,0,1,0,1,2
East Sussex,RPX,F,0,0,0,0,0,2,2
East Sussex,RPX,M,0,1,0,0,0,0,1
East Sussex,SA,F,0,2,0,5,5,4,16
East Sussex,SA,M,0,0,1,0,0,1,2
East Sussex,SAX,F,19,35,7,15,15,89,180
East Sussex,SAX,M,18,24,0,0,0,2,44
East Sussex,SD,F,50,45,23,19,17,75,229
East Sussex,SD,M,41,20,2,2,2,8,75
East Sussex,SDX,F,83,39,21,19,24,34,220
East Sussex,SDX,M,84,39,0,2,0,0,125
East Sussex,SH,F,1,1,2,0,2,2,8
East Sussex,SH,M,1,2,0,2,0,0,5
East Sussex,SHO,F,5,1,2,15,18,25,66
East Sussex,SHO,M,3,0,0,0,0,1,4
East Sussex,SHOX,F,5,28,4,2,3,21,63
East Sussex,SHOX,M,5,22,1,0,0,0,28
East Sussex,SHX,F,2,0,0,0,0,3,5
East Sussex,SHX,M,0,1,0,0,0,1,2
East Sussex,SM,F,68,95,23,34,42,146,408
East Sussex,SM,M,73,94,5,8,9,36,225
East Sussex,SMX,F,949,692,256,303,248,"1,442","3,890"
East Sussex,SMX,M,856,728,102,17,2,71,"1,776"
East Sussex,SRW,F,2,0,0,0,0,0,2
East Sussex,SRW,M,2,0,0,0,0,0,2
East Sussex,SRWX,F,4,1,0,0,0,0,5
East Sussex,SRWX,M,20,5,1,0,0,0,26
East Sussex,ST,M,0,1,0,0,0,0,1
East Sussex,SU,F,434,380,258,227,237,809,"2,345"
East Sussex,SU,M,456,367,56,18,14,52,963
East Sussex,SUX,F,477,367,160,120,112,469,"1,705"
East Sussex,SUX,M,524,412,71,5,3,31,"1,046"
East Sussex,WB,F,4,14,7,9,10,36,80
East Sussex,WB,M,9,9,0,1,0,5,24
East Sussex,WBX,F,0,3,0,0,1,19,23
East Sussex,WP,F,3,1,3,1,5,12,25
East Sussex,WP,M,7,3,0,2,0,2,14
East Sussex,WPX,F,2,0,0,2,0,2,6
East Sussex,WS,F,0,0,0,0,0,2,2
East Sussex,WS,M,0,0,0,0,0,1,1
East Sussex,WSX,F,1,4,0,0,0,0,5
East Sussex,WSX,M,2,0,0,0,0,0,2
East Sussex,YK,F,1,0,2,0,2,0,5
East Sussex,YK,M,0,1,1,0,0,0,2
West Sussex,AA,F,125,97,36,24,35,209,526
West Sussex,AA,M,130,108,52,10,4,26,330
West Sussex,AAX,F,684,648,260,215,133,539,"2,479"
West Sussex,AAX,M,669,612,201,13,3,22,"1,520"
West Sussex,AY,F,9,7,13,10,10,56,105
West Sussex,AY,M,10,0,1,1,0,0,12
West Sussex,AYX,F,31,1,1,4,5,3,45
West Sussex,AYX,M,0,0,1,0,0,1,2
West Sussex,BA,F,3,0,1,1,0,16,21
West Sussex,BA,M,7,5,3,3,2,7,27
West Sussex,BABX,F,0,0,0,0,0,1,1
West Sussex,BAX,F,132,39,16,23,12,122,344
West Sussex,BAX,M,122,50,37,0,1,9,219
West Sussex,BAZ,F,0,0,0,0,0,1,1
West Sussex,BAZ X,F,0,0,0,0,0,1,1
West Sussex,BAZX,F,3,0,0,0,0,1,4
West Sussex,BAZX,M,9,0,0,0,0,0,9
West Sussex,BB,F,11,7,8,4,6,42,78
West Sussex,BB,M,21,13,2,3,0,26,65
West Sussex,BBX,F,431,336,82,87,73,291,"1,300"
West Sussex,BBX,M,534,386,106,4,0,70,"1,100"
West Sussex,BF,F,335,330,256,349,299,406,"1,975"
West Sussex,BF,M,171,210,111,2,1,0,495
West Sussex,BFX,F,336,28,186,48,43,35,676
West Sussex,BFX,M,291,91,50,31,0,0,463
West Sussex,BG,F,9,5,6,7,3,25,55
West Sussex,BG,M,10,14,6,6,0,4,40
West Sussex,BGX,F,6,1,4,0,3,4,18
West Sussex,BGX,M,12,3,1,0,0,1,17
West Sussex,BH,F,25,0,0,0,0,19,44
West Sussex,BH,M,0,0,0,0,0,1,1
West Sussex,BHX,F,0,0,0,0,0,18,18
West Sussex,BI,F,0,0,0,0,0,1,1
West Sussex,BI,M,3,1,0,0,0,0,4
West Sussex,BS,F,0,2,14,4,1,7,28
West Sussex,BS,M,2,0,1,0,0,0,3
West Sussex,BSH,F,6,8,4,17,7,11,53
West Sussex,BSH,M,10,5,0,2,0,0,17
West Sussex,BSHX,F,0,2,0,2,0,1,5
West Sussex,BSHX,M,0,2,1,0,0,0,3
West Sussex,BSX,F,43,63,48,83,101,79,417
West Sussex,BSX,M,47,23,25,0,0,1,96
West Sussex,BU,F,0,0,0,0,0,1,1
West Sussex,BW,F,9,3,7,5,3,19,46
West Sussex,BW,M,9,5,4,0,0,3,21
West Sussex,BWB,F,0,0,0,0,0,1,1
West Sussex,BWX,F,2,0,0,0,0,5,7
West Sussex,BWX,M,0,1,1,0,0,0,2
West Sussex,CB,F,9,3,1,4,0,3,20
West Sussex,CB,M,2,1,1,0,0,0,4
West Sussex,CH,F,79,58,27,34,31,197,426
West Sussex,CH,M,73,43,21,9,2,49,197
West Sussex,CHX,F,388,339,121,72,50,534,"1,504"
West Sussex,CHX,M,417,355,96,12,4,88,972
West Sussex,DEV,F,2,0,0,0,0,3,5
West Sussex,DEV,M,1,0,0,0,0,0,1
West Sussex,DEVX,F,3,5,0,0,0,5,13
West Sussex,DEVX,M,7,6,7,0,0,0,20
West Sussex,DEX,F,21,31,23,15,7,81,178
West Sussex,DEX,M,24,23,6,3,4,11,71
West Sussex,DEXX,F,2,2,2,1,0,3,10
West Sussex,DEXX,M,0,1,0,1,1,0,3
West Sussex,DRX,F,0,0,7,0,0,0,7
West Sussex,DS,F,13,11,33,27,18,18,120
West Sussex,DS,M,5,3,1,0,0,0,9
West Sussex,DSHO,F,1,0,0,0,0,0,1
West Sussex,DSX,F,0,2,23,2,24,4,55
West Sussex,DSX,M,0,0,3,0,0,0,3
West Sussex,DV,M,0,0,0,0,0,2,2
West Sussex,DVX,F,0,0,0,0,0,2,2
West Sussex,DVX,M,0,0,0,0,0,6,6
West Sussex,FR,F,0,0,0,0,0,"2,535","2,535"
West Sussex,FR,M,0,0,0,0,0,138,138
West Sussex,FRX,F,0,0,0,0,0,83,83
West Sussex,FRX,M,0,0,0,0,0,18,18
West Sussex,GA,F,3,1,2,5,4,13,28
West Sussex,GA,M,7,7,2,0,0,2,18
West Sussex,GAX,F,0,0,0,0,0,4,4
West Sussex,GAX,M,1,1,1,0,0,0,3
West Sussex,GBX,F,0,1,0,0,0,0,1
West Sussex,GBX,M,1,1,0,0,0,0,2
West Sussex,GE,F,0,0,0,0,0,6,6
West Sussex,GEX,F,9,1,0,0,1,3,14
West Sussex,GEX,M,7,0,0,0,0,0,7
West Sussex,GL,F,0,2,0,0,0,3,5
West Sussex,GLX,F,0,0,0,0,0,1,1
West Sussex,GU,F,35,31,51,57,74,258,506
West Sussex,GU,M,4,1,10,0,0,0,15
West Sussex,GUX,F,2,10,2,4,0,5,23
West Sussex,GUX,M,0,1,0,0,0,0,1
West Sussex,GY,F,5,0,0,0,0,1,6
West Sussex,H,F,0,0,0,0,0,65,65
West Sussex,H,M,0,0,0,0,0,12,12
West Sussex,HE,F,90,81,62,34,33,173,473
West Sussex,HE,M,97,85,25,10,6,14,237
West Sussex,HEBL,F,0,0,0,0,0,9,9
West Sussex,HEBLX,F,0,0,0,0,0,21,21
West Sussex,HEBLX,M,0,0,0,0,0,1,1
West Sussex,HER,F,0,0,0,0,0,7,7
West Sussex,HERX,F,0,0,0,0,0,9,9
West Sussex,HERX,M,0,0,0,0,0,1,1
West Sussex,HEX,F,325,242,105,89,88,425,"1,274"
West Sussex,HEX,M,310,276,102,10,13,16,727
West Sussex,HF,F,"2,027","2,029","2,220","1,727","1,516","2,829","12,348"
West Sussex,HF,M,870,888,492,57,12,19,"2,338"
West Sussex,HFX,F,230,204,149,93,73,205,954
West Sussex,HFX,M,81,146,30,1,1,2,261
West Sussex,HI,F,14,13,12,11,7,68,125
West Sussex,HI,M,15,17,2,5,1,20,60
West Sussex,HIX,F,0,1,1,0,0,0,2
West Sussex,HO,F,254,85,90,174,136,323,"1,062"
West Sussex,HO,M,71,68,29,10,0,4,182
West Sussex,HOX,F,2,2,8,15,18,28,73
West Sussex,HOX,M,1,1,6,1,0,0,9
West Sussex,HX,F,0,0,0,0,0,156,156
West Sussex,HX,M,0,0,0,0,0,24,24
West Sussex,JE,F,13,15,80,90,29,76,303
West Sussex,JE,M,11,4,0,5,0,6,26
West Sussex,JEX,F,40,340,158,218,186,199,"1,141"
West Sussex,JEX,M,27,11,4,0,0,0,42
West Sussex,JY,F,1,0,0,0,0,0,1
West Sussex,JYX,F,5,0,0,0,0,0,5
West Sussex,LH,F,21,17,6,12,10,64,130
West Sussex,LH,M,19,11,7,4,1,0,42
West Sussex,LHX,F,6,7,4,0,0,4,21
West Sussex,LHX,M,3,2,1,0,1,0,7
West Sussex,LI,F,0,0,0,0,0,35,35
West Sussex,LI,M,0,0,0,0,0,8,8
West Sussex,LIM,F,128,77,47,19,15,117,403
West Sussex,LIM,M,153,91,17,11,3,20,295
West Sussex,LIM X,F,0,0,0,0,0,3,3
West Sussex,LIM X,M,0,0,0,0,0,3,3
West Sussex,LIMBX,F,0,0,0,0,0,4,4
West Sussex,LIMBX,M,0,0,0,0,0,1,1
West Sussex,LIMR,F,0,0,0,0,0,1,1
West Sussex,LIMR,M,0,0,0,0,0,1,1
West Sussex,LIMRX,F,0,0,0,0,0,9,9
West Sussex,LIMX,F,863,652,187,126,107,420,"2,355"
West Sussex,LIMX,M,937,677,151,10,8,18,"1,801"
West Sussex,LIX,F,0,0,0,0,0,186,186
West Sussex,LIX,M,0,0,0,0,0,68,68
West Sussex,LM,M,0,0,0,0,0,1,1
West Sussex,LMX,F,0,0,0,0,0,2,2
West Sussex,LRX,M,0,1,0,0,0,0,1
West Sussex,MG,F,5,5,4,2,5,12,33
West Sussex,MG,M,9,8,4,1,0,3,25
West Sussex,MGX,F,14,26,10,0,0,13,63
West Sussex,MGX,M,27,11,4,0,0,6,48
West Sussex,MO,F,3,0,0,1,0,2,6
West Sussex,MO,M,1,0,1,0,0,0,2
West Sussex,MOX,F,8,14,0,0,0,4,26
West Sussex,MOX,M,0,1,1,0,0,0,2
West Sussex,MRI,F,12,1,5,9,3,19,49
West Sussex,MRI,M,7,0,2,0,0,0,9
West Sussex,MRIX,F,1,12,0,4,8,12,37
West Sussex,MRIX,M,1,2,0,0,0,0,3
West Sussex,NO,F,4,3,0,0,0,0,7
West Sussex,NO,M,4,1,0,0,0,0,5
West Sussex,NOX,F,17,1,0,0,0,0,18
West Sussex,NOX,M,14,0,0,0,0,0,14
West Sussex,NS,F,0,0,0,0,0,176,176
West Sussex,NS,M,0,0,0,0,0,1,1
West Sussex,OB,M,0,0,0,0,0,1,1
West Sussex,OE,F,0,0,0,0,0,1,1
West Sussex,OEX,M,0,1,0,0,0,0,1
West Sussex,PA,M,0,0,1,0,0,0,1
West Sussex,PAX,F,2,0,0,0,0,0,2
West Sussex,PAX,M,1,0,0,0,0,0,1
West Sussex,PI,F,0,1,0,0,0,8,9
West Sussex,PI,M,0,0,0,0,0,1,1
West Sussex,PIX,F,10,27,11,6,3,17,74
West Sussex,PIX,M,17,15,0,0,0,3,35
West Sussex,ROX,F,0,0,0,0,0,1,1
West Sussex,ROX,M,0,0,0,0,0,1,1
West Sussex,RP,F,2,0,0,0,0,2,4
West Sussex,RP,M,0,0,0,0,0,1,1
West Sussex,RPX,F,17,6,12,7,2,25,69
West Sussex,RPX,M,12,6,7,1,0,1,27
West Sussex,SA,F,0,0,1,0,0,30,31
West Sussex,SA,M,0,1,0,0,0,3,4
West Sussex,SAX,F,0,3,0,7,0,19,29
West Sussex,SAX,M,0,9,0,0,0,4,13
West Sussex,SD,F,1,14,20,5,0,8,48
West Sussex,SD,M,4,11,1,2,0,3,21
West Sussex,SDX,F,70,51,26,15,13,21,196
West Sussex,SDX,M,67,76,6,1,0,0,150
West Sussex,SH,F,0,0,0,0,3,6,9
West Sussex,SHO,F,27,31,6,16,9,51,140
West Sussex,SHO,M,29,29,37,1,1,2,99
West Sussex,SHOX,F,27,27,11,13,3,19,100
West Sussex,SHOX,M,48,62,38,0,0,0,148
West Sussex,SHX,F,1,0,1,0,0,3,5
West Sussex,SHX,M,1,0,0,0,0,0,1
West Sussex,SM,F,64,64,15,29,14,102,288
West Sussex,SM,M,65,32,10,11,7,26,151
West Sussex,SMX,F,754,514,178,111,151,840,"2,548"
West Sussex,SMX,M,769,581,135,24,8,78,"1,595"
West Sussex,SOB,F,0,0,0,0,0,1,1
West Sussex,SRW,F,0,0,0,1,0,0,1
West Sussex,SRW,M,0,1,0,0,0,0,1
West Sussex,SRWX,F,43,8,13,22,13,2,101
West Sussex,SRWX,M,22,1,1,0,0,0,24
West Sussex,ST,F,27,17,5,2,6,3,60
West Sussex,ST,M,31,0,1,0,0,1,33
West Sussex,STX,F,1,2,0,3,0,0,6
West Sussex,STX,M,1,0,0,0,0,0,1
West Sussex,SU,F,259,189,129,142,61,419,"1,199"
West Sussex,SU,M,250,158,27,4,7,26,472
West Sussex,SUX,F,324,156,67,45,63,212,867
West Sussex,SUX,M,347,194,50,0,0,15,606
West Sussex,WB,F,14,3,2,1,3,46,69
West Sussex,WB,M,14,4,0,1,2,4,25
West Sussex,WBX,F,0,1,1,0,2,25,29
West Sussex,WBX,M,0,3,2,0,0,3,8
West Sussex,WP,F,2,9,2,0,2,13,28
West Sussex,WP,M,3,1,0,0,2,4,10
West Sussex,WPX,F,0,0,0,0,0,4,4
West Sussex,WPX,M,0,0,0,1,0,0,1
Warwickshire,AA,F,49,70,40,36,12,80,287
Warwickshire,AA,M,66,107,15,9,3,20,220
Warwickshire,AAX,F,497,460,134,100,90,412,"1,693"
Warwickshire,AAX,M,651,490,58,10,2,21,"1,232"
Warwickshire,AR,F,0,1,0,0,0,0,1
Warwickshire,AY,F,44,50,27,30,26,63,240
Warwickshire,AY,M,42,16,2,0,1,1,62
Warwickshire,AYX,F,0,0,0,0,1,6,7
Warwickshire,AYX,M,5,0,1,0,0,0,6
Warwickshire,BA,F,84,86,36,37,18,123,384
Warwickshire,BA,M,73,60,17,8,12,39,209
Warwickshire,BABX,F,0,0,0,0,0,3,3
Warwickshire,BAL,F,0,1,0,2,0,1,4
Warwickshire,BAL,M,0,1,0,0,0,0,1
Warwickshire,BALX,F,0,0,1,1,0,1,3
Warwickshire,BAR,F,0,0,0,0,0,5,5
Warwickshire,BAR,M,0,0,0,0,0,1,1
Warwickshire,BARX,F,0,0,0,0,0,14,14
Warwickshire,BAX,F,777,632,156,76,78,448,"2,167"
Warwickshire,BAX,M,687,510,106,3,3,40,"1,349"
Warwickshire,BAZ,F,1,1,0,1,0,1,4
Warwickshire,BAZ,M,3,0,1,4,0,1,9
Warwickshire,BAZX,F,41,22,10,4,1,26,104
Warwickshire,BAZX,M,44,18,1,0,0,0,63
Warwickshire,BB,F,72,71,33,21,9,135,341
Warwickshire,BB,M,74,72,16,6,2,29,199
Warwickshire,BBX,F,677,733,270,205,137,545,"2,567"
Warwickshire,BBX,M,766,666,224,5,5,44,"1,710"
Warwickshire,BF,F,338,387,370,400,386,639,"2,520"
Warwickshire,BF,M,665,576,124,4,10,15,"1,394"
Warwickshire,BFX,F,33,14,12,23,5,22,109
Warwickshire,BFX,M,107,55,6,1,0,1,170
Warwickshire,BG,F,6,3,3,3,4,14,33
Warwickshire,BG,M,4,5,1,0,0,0,10
Warwickshire,BGX,F,6,2,1,0,1,0,10
Warwickshire,BGX,M,11,0,0,0,0,0,11
Warwickshire,BH,F,0,0,0,0,0,84,84
Warwickshire,BHX,F,0,0,0,0,0,28,28
Warwickshire,BR,M,0,0,0,0,0,1,1
Warwickshire,BRX,M,1,0,0,0,0,0,1
Warwickshire,BS,F,3,3,2,5,1,3,17
Warwickshire,BS,M,0,1,0,0,0,0,1
Warwickshire,BSH,F,6,33,12,7,3,15,76
Warwickshire,BSH,M,20,20,3,0,0,4,47
Warwickshire,BSHX,F,15,20,6,0,2,3,46
Warwickshire,BSHX,M,6,20,1,0,0,0,27
Warwickshire,BSX,F,15,10,5,3,1,21,55
Warwickshire,BSX,M,19,17,2,0,0,0,38
Warwickshire,BU,F,47,101,56,38,14,37,293
Warwickshire,BU,M,23,35,23,2,2,5,90
Warwickshire,BW,F,11,26,19,7,13,43,119
Warwickshire,BW,M,24,8,6,0,0,3,41
Warwickshire,BWX,F,2,4,4,2,2,16,30
Warwickshire,BWX,M,6,3,2,0,0,0,11
Warwickshire,CB,F,0,0,0,0,0,5,5
Warwickshire,CH,F,212,169,79,95,51,361,967
Warwickshire,CH,M,213,158,30,9,7,47,464
Warwickshire,CHIX,F,1,0,0,0,0,0,1
Warwickshire,CHX,F,616,630,191,109,80,684,"2,310"
Warwickshire,CHX,M,712,836,190,15,8,93,"1,854"
Warwickshire,CON,F,0,0,0,0,0,1,1
Warwickshire,DE,F,0,0,0,0,0,2,2
Warwickshire,DEV,F,0,2,0,0,0,5,7
Warwickshire,DEV,M,1,5,0,0,0,0,6
Warwickshire,DEVX,F,0,0,1,0,2,5,8
Warwickshire,DEVX,M,1,3,0,0,0,0,4
Warwickshire,DEX,F,96,90,45,39,44,162,476
Warwickshire,DEX,M,100,105,16,9,4,6,240
Warwickshire,DEXX,F,2,9,1,1,1,8,22
Warwickshire,DEXX,M,1,3,0,0,0,2,6
Warwickshire,DG,M,0,0,0,0,0,1,1
Warwickshire,DRX,F,0,1,0,0,0,0,1
Warwickshire,DRX,M,3,0,0,0,0,0,3
Warwickshire,DS,F,2,3,3,1,2,15,26
Warwickshire,DS,M,4,5,0,1,0,1,11
Warwickshire,DSHO,F,0,0,0,0,0,2,2
Warwickshire,DSX,F,0,0,0,0,0,1,1
Warwickshire,DSX,M,5,1,1,0,0,0,7
Warwickshire,DV,F,0,0,0,0,0,21,21
Warwickshire,DV,M,0,0,0,0,0,1,1
Warwickshire,DVX,F,0,0,0,0,0,36,36
Warwickshire,DVX,M,0,0,0,0,0,1,1
Warwickshire,FR,F,0,0,0,0,0,"2,658","2,658"
Warwickshire,FR,M,0,0,0,0,0,120,120
Warwickshire,FRX,F,0,0,0,0,0,41,41
Warwickshire,FRX,M,0,0,0,0,0,9,9
Warwickshire,GA,F,0,0,0,0,0,5,5
Warwickshire,GAX,F,5,5,0,0,0,1,11
Warwickshire,GAX,M,2,2,0,0,0,0,4
Warwickshire,GBX,F,0,1,0,0,0,0,1
Warwickshire,GE,F,0,0,0,0,0,1,1
Warwickshire,GEX,F,0,0,1,0,2,10,13
Warwickshire,GEX,M,0,0,0,0,0,3,3
Warwickshire,GL,F,0,0,0,0,0,2,2
Warwickshire,GL,M,0,0,0,0,0,1,1
Warwickshire,GLX,F,0,0,0,0,1,2,3
Warwickshire,GU,F,43,50,40,38,33,86,290
Warwickshire,GU,M,9,0,4,0,0,0,13
Warwickshire,GUX,F,0,3,6,0,3,1,13
Warwickshire,GUX,M,0,0,1,0,0,0,1
Warwickshire,H,F,0,0,0,0,0,62,62
Warwickshire,H,M,0,0,0,0,0,2,2
Warwickshire,HE,F,73,62,42,30,29,74,310
Warwickshire,HE,M,93,93,10,9,14,17,236
Warwickshire,HEBL,F,0,0,0,0,0,7,7
Warwickshire,HEBLX,F,0,0,0,0,0,63,63
Warwickshire,HEBLX,M,0,0,0,0,0,3,3
Warwickshire,HEBR,M,0,0,0,0,0,1,1
Warwickshire,HER,F,0,0,0,0,0,6,6
Warwickshire,HERX,F,0,0,0,0,0,16,16
Warwickshire,HEX,F,506,531,230,187,165,545,"2,164"
Warwickshire,HEX,M,647,726,141,3,1,4,"1,522"
Warwickshire,HF,F,"1,775","1,761","1,501","1,504","1,239","2,656","10,436"
Warwickshire,HF,M,"1,610","1,251",404,29,21,33,"3,348"
Warwickshire,HFX,F,65,18,18,14,22,94,231
Warwickshire,HFX,M,107,41,20,1,0,2,171
Warwickshire,HI,F,22,17,21,14,20,87,181
Warwickshire,HI,M,36,18,5,1,2,7,69
Warwickshire,HIX,F,6,3,6,2,3,3,23
Warwickshire,HIX,M,5,1,1,0,0,0,7
Warwickshire,HL,F,0,0,0,0,0,4,4
Warwickshire,HO,F,207,292,148,156,174,399,"1,376"
Warwickshire,HO,M,225,198,30,0,0,10,463
Warwickshire,HOX,F,2,6,6,1,1,16,32
Warwickshire,HOX,M,11,5,0,0,0,0,16
Warwickshire,HX,F,0,0,0,0,0,239,239
Warwickshire,HX,M,0,0,0,0,0,24,24
Warwickshire,IM,F,0,0,0,0,0,3,3
Warwickshire,IM,M,3,0,0,0,0,1,4
Warwickshire,IMX,F,2,0,0,0,0,1,3
Warwickshire,IMX,M,3,0,0,0,0,0,3
Warwickshire,JE,F,10,17,5,7,14,48,101
Warwickshire,JE,M,2,0,0,0,0,0,2
Warwickshire,JEX,F,1,1,8,2,0,7,19
Warwickshire,JEX,M,0,1,0,0,0,2,3
Warwickshire,LH,F,19,27,17,14,5,58,140
Warwickshire,LH,M,34,22,7,7,2,5,77
Warwickshire,LHX,F,9,3,1,4,1,9,27
Warwickshire,LHX,M,14,6,0,0,0,0,20
Warwickshire,LI,F,0,0,0,0,0,38,38
Warwickshire,LI,M,0,0,0,0,0,13,13
Warwickshire,LIM,F,204,199,98,48,43,212,804
Warwickshire,LIM,M,236,277,94,20,7,43,677
Warwickshire,LIMB,F,0,0,0,0,0,3,3
Warwickshire,LIMBX,F,0,0,0,0,0,32,32
Warwickshire,LIMR,F,0,0,0,0,0,8,8
Warwickshire,LIMR,M,0,0,0,0,0,2,2
Warwickshire,LIMRX,F,0,0,0,0,0,26,26
Warwickshire,LIMX,F,"1,298","1,330",436,176,191,731,"4,162"
Warwickshire,LIMX,M,"1,431","1,528",385,8,13,39,"3,404"
Warwickshire,LIX,F,0,0,0,0,0,189,189
Warwickshire,LIX,M,0,0,0,0,0,53,53
Warwickshire,LM,F,0,0,0,0,0,10,10
Warwickshire,LMX,F,0,0,0,0,0,6,6
Warwickshire,LR,F,5,0,0,0,1,3,9
Warwickshire,LR,M,0,0,0,0,0,1,1
Warwickshire,LRX,F,6,0,1,0,0,0,7
Warwickshire,LRX,M,5,0,0,0,0,0,5
Warwickshire,LU,M,0,0,0,0,0,1,1
Warwickshire,LUX,F,0,3,0,8,0,0,11
Warwickshire,MA,F,0,2,0,1,0,11,14
Warwickshire,MA,M,0,0,0,0,0,1,1
Warwickshire,MARX,F,0,2,0,0,0,0,2
Warwickshire,MAX,F,1,1,2,2,5,9,20
Warwickshire,MAX,M,0,1,2,0,0,0,3
Warwickshire,MG,F,8,4,1,5,0,10,28
Warwickshire,MG,M,2,6,1,0,0,0,9
Warwickshire,MGX,F,4,1,8,0,1,3,17
Warwickshire,MGX,M,5,0,0,0,0,2,7
Warwickshire,MO,F,30,31,25,10,1,6,103
Warwickshire,MO,M,36,20,2,0,0,0,58
Warwickshire,MOX,F,3,8,4,7,6,12,40
Warwickshire,MOX,M,8,4,23,0,0,0,35
Warwickshire,MRI,F,0,0,3,1,9,52,65
Warwickshire,MRI,M,0,1,2,0,0,4,7
Warwickshire,MRIX,F,36,20,7,1,11,37,112
Warwickshire,MRIX,M,40,38,8,0,0,3,89
Warwickshire,ND,M,0,0,0,0,0,1,1
Warwickshire,NOX,M,0,1,0,0,0,0,1
Warwickshire,NRX,F,7,0,0,0,0,1,8
Warwickshire,NRX,M,13,1,0,0,0,0,14
Warwickshire,NS,F,0,0,0,0,0,165,165
Warwickshire,NS,M,0,0,0,0,0,2,2
Warwickshire,OB,M,0,0,0,0,0,1,1
Warwickshire,PA,F,0,2,0,0,0,0,2
Warwickshire,PA,M,1,0,0,0,0,0,1
Warwickshire,PAX,F,2,1,0,1,0,4,8
Warwickshire,PAX,M,3,4,0,0,0,0,7
Warwickshire,PI,F,0,1,6,1,0,1,9
Warwickshire,PI,M,0,1,2,0,0,0,3
Warwickshire,PIN,F,0,0,0,0,0,1,1
Warwickshire,PIN,M,1,0,0,0,0,0,1
Warwickshire,PIX,F,3,30,2,2,4,4,45
Warwickshire,PIX,M,5,41,3,0,0,0,49
Warwickshire,ROX,F,0,4,0,0,0,1,5
Warwickshire,ROX,M,0,1,0,0,0,1,2
Warwickshire,RP,F,5,2,0,1,0,13,21
Warwickshire,RP,M,4,0,0,1,0,0,5
Warwickshire,RPX,F,7,0,0,0,0,0,7
Warwickshire,RPX,M,13,0,0,0,0,1,14
Warwickshire,SA,F,10,18,28,3,8,12,79
Warwickshire,SA,M,18,19,8,0,1,1,47
Warwickshire,SAX,F,35,24,22,13,13,56,163
Warwickshire,SAX,M,27,44,8,1,0,2,82
Warwickshire,SBX,F,0,2,0,0,0,0,2
Warwickshire,SBX,M,0,1,0,0,0,0,1
Warwickshire,SD,F,45,33,30,19,11,54,192
Warwickshire,SD,M,41,34,5,2,0,2,84
Warwickshire,SDX,F,90,87,34,19,19,58,307
Warwickshire,SDX,M,115,98,14,0,0,1,228
Warwickshire,SH,F,4,2,1,2,1,2,12
Warwickshire,SH,M,2,4,0,0,0,0,6
Warwickshire,SHO,F,3,6,4,2,2,38,55
Warwickshire,SHO,M,7,5,0,0,0,3,15
Warwickshire,SHOX,F,0,7,2,2,4,20,35
Warwickshire,SHOX,M,9,3,0,0,0,0,12
Warwickshire,SHX,F,1,0,0,0,0,1,2
Warwickshire,SHX,M,2,0,1,0,0,1,4
Warwickshire,SM,F,158,156,101,68,49,296,828
Warwickshire,SM,M,160,147,32,6,12,46,403
Warwickshire,SMX,F,956,871,339,189,195,956,"3,506"
Warwickshire,SMX,M,968,907,201,5,20,81,"2,182"
Warwickshire,SRW,M,1,1,0,0,0,0,2
Warwickshire,SRWX,F,5,9,0,0,0,0,14
Warwickshire,SRWX,M,11,5,0,0,0,0,16
Warwickshire,STX,M,0,2,0,0,0,0,2
Warwickshire,SU,F,1,4,3,6,4,11,29
Warwickshire,SU,M,1,9,0,0,0,0,10
Warwickshire,SUX,F,0,12,1,5,2,0,20
Warwickshire,SUX,M,2,13,1,0,0,0,16
Warwickshire,WB,F,0,0,0,0,0,6,6
Warwickshire,WB,M,0,3,1,0,0,0,4
Warwickshire,WBX,F,0,0,2,0,0,1,3
Warwickshire,WBX,M,1,2,1,0,0,0,4
Warwickshire,WGX,M,0,1,0,0,0,0,1
Warwickshire,WP,F,2,5,0,3,3,12,25
Warwickshire,WP,M,4,4,0,0,1,0,9
Warwickshire,WPX,F,3,0,0,0,0,3,6
Warwickshire,WPX,M,3,1,1,0,0,0,5
Great Manchester,AA,F,56,46,33,34,29,139,337
Great Manchester,AA,M,52,13,8,5,3,19,100
Great Manchester,AAX,F,264,150,110,56,45,237,862
Great Manchester,AAX,M,220,85,29,8,7,17,366
Great Manchester,AUX,F,0,0,0,0,0,2,2
Great Manchester,AY,F,118,101,78,64,54,198,613
Great Manchester,AY,M,16,17,3,2,1,2,41
Great Manchester,AYX,F,8,3,4,10,12,11,48
Great Manchester,AYX,M,4,0,0,0,0,1,5
Great Manchester,BA,F,8,10,3,9,9,30,69
Great Manchester,BA,M,10,3,3,1,1,8,26
Great Manchester,BAL,F,0,0,0,0,0,1,1
Great Manchester,BALX,F,2,4,2,2,1,3,14
Great Manchester,BALX,M,0,1,0,0,0,0,1
Great Manchester,BARX,F,0,0,0,0,0,1,1
Great Manchester,BAX,F,198,121,21,17,26,116,499
Great Manchester,BAX,M,190,39,6,1,1,8,245
Great Manchester,BAZ,M,0,0,0,1,0,0,1
Great Manchester,BAZX,F,8,6,0,0,0,1,15
Great Manchester,BAZX,M,7,1,0,0,0,0,8
Great Manchester,BB,F,52,36,13,11,6,68,186
Great Manchester,BB,M,30,14,5,2,3,22,76
Great Manchester,BBX,F,494,428,123,79,44,275,"1,443"
Great Manchester,BBX,M,425,180,31,3,5,32,676
Great Manchester,BF,F,153,190,207,210,201,374,"1,335"
Great Manchester,BF,M,198,87,26,9,7,3,330
Great Manchester,BFX,F,18,19,19,13,10,17,96
Great Manchester,BFX,M,25,6,0,4,0,1,36
Great Manchester,BG,F,4,2,1,2,0,8,17
Great Manchester,BG,M,5,0,0,1,0,1,7
Great Manchester,BGX,F,1,0,1,0,0,2,4
Great Manchester,BH,F,1,0,0,0,0,25,26
Great Manchester,BHX,F,0,0,0,0,0,19,19
Great Manchester,BHX,M,1,0,0,0,0,0,1
Great Manchester,BLG,F,17,4,2,0,0,12,35
Great Manchester,BLG,M,6,2,1,0,1,2,12
Great Manchester,BLGX,M,2,0,0,0,0,0,2
Great Manchester,BLPX,F,0,0,0,0,0,1,1
Great Manchester,BRX,F,0,0,1,0,0,0,1
Great Manchester,BS,F,1,4,0,2,0,4,11
Great Manchester,BS,M,4,0,0,0,0,0,4
Great Manchester,BSH,F,5,9,2,4,0,3,23
Great Manchester,BSH,M,2,5,3,0,0,0,10
Great Manchester,BSHO,F,0,0,0,0,0,3,3
Great Manchester,BSHX,F,1,6,9,1,0,4,21
Great Manchester,BSHX,M,1,1,0,0,0,0,2
Great Manchester,BSX,F,11,11,9,1,5,4,41
Great Manchester,BSX,M,4,1,3,0,0,0,8
Great Manchester,BW,F,2,0,1,1,0,6,10
Great Manchester,BW,M,1,2,0,0,0,0,3
Great Manchester,BWX,F,1,0,0,1,0,2,4
Great Manchester,BX,F,0,0,0,0,0,1,1
Great Manchester,CA,F,0,0,0,0,0,1,1
Great Manchester,CAX,F,0,0,0,0,0,1,1
Great Manchester,CB,F,0,0,0,0,0,6,6
Great Manchester,CH,F,28,43,13,17,23,153,277
Great Manchester,CH,M,39,19,2,2,3,19,84
Great Manchester,CHX,F,178,177,51,38,50,237,731
Great Manchester,CHX,M,150,106,10,6,3,32,307
Great Manchester,DEV,F,0,0,0,0,0,1,1
Great Manchester,DEVX,F,0,0,0,1,0,0,1
Great Manchester,DEX,F,4,7,5,4,1,9,30
Great Manchester,DEX,M,4,7,1,0,0,2,14
Great Manchester,DEXX,M,0,0,0,0,0,1,1
Great Manchester,DRX,M,1,0,0,0,0,0,1
Great Manchester,DS,F,31,36,36,22,21,34,180
Great Manchester,DS,M,12,0,1,2,0,0,15
Great Manchester,DSHO,F,15,0,0,0,0,2,17
Great Manchester,DSHO,M,10,0,0,0,0,1,11
Great Manchester,DSX,F,4,10,10,0,0,3,27
Great Manchester,DSX,M,2,1,0,0,0,0,3
Great Manchester,FR,F,0,0,0,0,0,"1,241","1,241"
Great Manchester,FR,M,0,0,0,0,0,66,66
Great Manchester,FRX,F,0,0,0,0,0,65,65
Great Manchester,FRX,M,0,0,0,0,0,11,11
Great Manchester,GA,F,16,10,22,10,9,59,126
Great Manchester,GA,M,25,2,5,3,0,7,42
Great Manchester,GASX,F,0,2,0,0,2,3,7
Great Manchester,GASX,M,0,3,0,0,0,0,3
Great Manchester,GAX,F,10,5,0,1,6,6,28
Great Manchester,GAX,M,8,2,0,0,0,1,11
Great Manchester,GBX,F,0,0,1,0,0,0,1
Great Manchester,GBX,M,0,1,0,0,0,0,1
Great Manchester,GE,F,0,1,0,0,1,0,2
Great Manchester,GE,M,1,0,0,0,0,1,2
Great Manchester,GEX,F,0,3,0,0,0,0,3
Great Manchester,GEX,M,0,1,0,0,0,0,1
Great Manchester,GL,F,1,0,0,0,0,0,1
Great Manchester,GL,M,2,1,0,0,0,0,3
Great Manchester,GLX,F,0,0,0,0,0,1,1
Great Manchester,GUX,F,0,0,0,0,0,1,1
Great Manchester,H,F,0,0,0,0,0,35,35
Great Manchester,H,M,0,0,0,0,0,7,7
Great Manchester,HE,F,56,56,30,18,19,60,239
Great Manchester,HE,M,57,27,8,3,3,6,104
Great Manchester,HEBL,F,0,0,0,0,0,2,2
Great Manchester,HEBLX,F,0,0,0,0,0,6,6
Great Manchester,HERX,F,0,0,0,0,0,7,7
Great Manchester,HERX,M,0,0,0,0,0,1,1
Great Manchester,HEX,F,271,192,82,58,24,119,746
Great Manchester,HEX,M,153,46,12,3,0,2,216
Great Manchester,HF,F,663,670,601,640,520,"1,234","4,328"
Great Manchester,HF,M,399,137,34,51,13,15,649
Great Manchester,HFX,F,65,48,65,41,42,95,356
Great Manchester,HFX,M,36,19,2,0,0,0,57
Great Manchester,HI,F,8,11,6,9,4,29,67
Great Manchester,HI,M,11,15,4,1,1,14,46
Great Manchester,HIX,F,4,0,3,4,0,4,15
Great Manchester,HIX,M,1,1,0,1,0,0,3
Great Manchester,HO,F,169,159,162,155,127,387,"1,159"
Great Manchester,HO,M,58,19,9,5,3,4,98
Great Manchester,HOX,F,36,36,25,14,32,39,182
Great Manchester,HOX,M,11,3,0,0,0,0,14
Great Manchester,HX,F,0,0,0,0,0,73,73
Great Manchester,HX,M,0,0,0,0,0,18,18
Great Manchester,IM,M,4,2,0,0,0,0,6
Great Manchester,JE,F,53,59,109,37,17,79,354
Great Manchester,JE,M,5,5,1,3,0,0,14
Great Manchester,JEX,F,10,0,3,0,0,2,15
Great Manchester,JEX,M,0,0,0,0,0,1,1
Great Manchester,JY,F,15,0,0,0,0,1,16
Great Manchester,JY,M,1,0,0,0,0,0,1
Great Manchester,KE,F,0,0,0,0,0,2,2
Great Manchester,KEX,F,0,0,0,0,0,1,1
Great Manchester,LH,F,1,3,4,0,0,4,12
Great Manchester,LH,M,2,0,1,0,1,0,4
Great Manchester,LHX,F,1,4,0,1,0,0,6
Great Manchester,LHX,M,0,3,0,0,0,1,4
Great Manchester,LI,F,0,0,0,0,0,73,73
Great Manchester,LI,M,0,0,0,0,0,18,18
Great Manchester,LIM,F,210,205,63,55,66,213,812
Great Manchester,LIM,M,170,102,30,14,10,32,358
Great Manchester,LIMB,F,0,0,0,0,0,5,5
Great Manchester,LIMB,M,0,0,0,0,0,1,1
Great Manchester,LIMBX,F,0,0,0,0,0,11,11
Great Manchester,LIMR,F,0,0,0,0,0,7,7
Great Manchester,LIMRX,F,0,0,0,0,0,22,22
Great Manchester,LIMX,F,940,958,228,187,186,483,"2,982"
Great Manchester,LIMX,M,757,373,72,13,9,28,"1,252"
Great Manchester,LIX,F,0,0,0,0,0,189,189
Great Manchester,LIX,M,0,0,0,0,0,85,85
Great Manchester,LMX,F,0,0,0,0,0,10,10
Great Manchester,LRX,F,0,0,0,0,0,2,2
Great Manchester,LRX,M,0,0,1,0,0,1,2
Great Manchester,MAX,F,0,0,0,0,0,5,5
Great Manchester,MG,F,0,0,0,0,0,9,9
Great Manchester,MG,M,0,0,0,0,0,2,2
Great Manchester,MGX,F,0,0,0,3,1,5,9
Great Manchester,MGX,M,0,0,0,1,0,1,2
Great Manchester,MO,F,6,0,5,4,2,13,30
Great Manchester,MO,M,0,0,0,0,0,2,2
Great Manchester,MOX,F,20,12,7,0,0,1,40
Great Manchester,MOX,M,17,1,0,0,0,1,19
Great Manchester,MRI,F,2,8,1,1,0,10,22
Great Manchester,MRI,M,0,12,0,1,0,3,16
Great Manchester,MRIX,F,0,5,2,1,1,16,25
Great Manchester,MRIX,M,2,6,0,0,0,0,8
Great Manchester,NO,M,1,0,0,0,0,0,1
Great Manchester,NS,F,0,0,0,0,0,174,174
Great Manchester,PAX,F,0,1,0,0,0,0,1
Great Manchester,PI,F,0,0,0,0,0,1,1
Great Manchester,PIX,F,0,0,0,0,0,1,1
Great Manchester,PIX,M,1,0,0,0,0,0,1
Great Manchester,RP,F,35,52,20,17,5,66,195
Great Manchester,RP,M,12,3,2,0,0,4,21
Great Manchester,RPX,F,0,1,0,0,0,1,2
Great Manchester,RPX,M,0,2,0,0,0,0,2
Great Manchester,SA,F,1,3,0,1,1,8,14
Great Manchester,SA,M,0,1,3,0,1,2,7
Great Manchester,SAX,F,4,30,10,7,8,26,85
Great Manchester,SAX,M,4,8,5,0,1,9,27
Great Manchester,SDX,F,0,6,0,0,0,3,9
Great Manchester,SH,F,0,1,1,0,0,2,4
Great Manchester,SH,M,1,0,0,0,0,0,1
Great Manchester,SHO,F,4,1,3,8,5,48,69
Great Manchester,SHO,M,22,5,0,1,1,1,30
Great Manchester,SHOX,F,25,15,6,3,10,39,98
Great Manchester,SHOX,M,16,5,1,0,0,5,27
Great Manchester,SHX,F,0,0,0,0,1,0,1
Great Manchester,SHX,M,0,1,0,0,0,0,1
Great Manchester,SM,F,66,57,25,24,17,108,297
Great Manchester,SM,M,45,21,5,3,3,15,92
Great Manchester,SMX,F,228,223,77,42,44,265,879
Great Manchester,SMX,M,169,79,16,3,5,33,305
Great Manchester,SRW,F,0,0,0,19,0,1,20
Great Manchester,SRWX,F,4,5,0,0,1,1,11
Great Manchester,SRWX,M,4,0,0,0,0,0,4
Great Manchester,SUX,M,0,0,0,0,0,1,1
Great Manchester,WB,F,8,4,16,7,4,16,55
Great Manchester,WB,M,9,0,0,0,1,3,13
Great Manchester,WBX,F,17,13,3,1,5,27,66
Great Manchester,WBX,M,19,1,0,0,0,2,22
Great Manchester,WG,F,0,0,0,1,0,2,3
Great Manchester,WP,F,0,0,0,0,1,4,5
Great Manchester,WP,M,1,0,0,0,0,0,1
Great Manchester,WS,F,10,11,5,2,2,8,38
Great Manchester,WS,M,4,11,1,0,0,1,17
Great Manchester,WSX,F,6,2,0,0,0,1,9
Great Manchester,WSX,M,5,2,0,0,0,0,7
Wiltshire,AA,F,659,496,202,159,187,803,"2,506"
Wiltshire,AA,M,619,357,110,63,26,103,"1,278"
Wiltshire,AAX,F,"3,037","2,597",985,768,536,"1,692","9,615"
Wiltshire,AAX,M,"2,920","1,978",306,60,16,130,"5,410"
Wiltshire,AR,F,0,1,0,0,0,1,2
Wiltshire,AR,M,0,1,0,0,0,0,1
Wiltshire,ARX,F,1,1,0,0,0,0,2
Wiltshire,ARX,M,0,1,0,0,0,0,1
Wiltshire,AU,F,0,0,0,0,0,1,1
Wiltshire,AY,F,141,143,177,210,167,404,"1,242"
Wiltshire,AY,M,40,32,14,1,0,1,88
Wiltshire,AYX,F,53,67,32,17,31,21,221
Wiltshire,AYX,M,21,24,7,2,0,3,57
Wiltshire,BA,F,83,53,35,26,31,199,427
Wiltshire,BA,M,107,75,25,18,18,60,303
Wiltshire,BABX,F,0,0,0,0,0,7,7
Wiltshire,BABX,M,0,0,0,0,0,1,1
Wiltshire,BAR,F,0,0,0,0,0,1,1
Wiltshire,BAR,M,0,0,0,0,0,1,1
Wiltshire,BARX,F,0,0,0,0,0,17,17
Wiltshire,BARX,M,0,0,0,0,0,1,1
Wiltshire,BAWX,F,0,0,0,0,0,3,3
Wiltshire,BAX,F,"1,195",659,176,102,72,582,"2,786"
Wiltshire,BAX,M,"1,233",609,108,6,2,63,"2,021"
Wiltshire,BAZ,M,0,1,0,0,0,1,2
Wiltshire,BAZ X,F,0,0,0,0,0,1,1
Wiltshire,BAZX,F,25,39,2,4,0,6,76
Wiltshire,BAZX,M,27,15,1,0,0,0,43
Wiltshire,BB,F,47,68,34,11,18,115,293
Wiltshire,BB,M,62,44,23,1,1,44,175
Wiltshire,BBX,F,"1,111",937,329,139,122,503,"3,141"
Wiltshire,BBX,M,"1,103",880,330,6,8,103,"2,430"
Wiltshire,BF,F,"1,849","1,887","2,171","1,985","1,983","3,466","13,341"
Wiltshire,BF,M,"1,391",962,265,50,19,43,"2,730"
Wiltshire,BFX,F,231,201,146,153,132,233,"1,096"
Wiltshire,BFX,M,133,91,29,0,5,1,259
Wiltshire,BG,F,31,40,20,20,19,68,198
Wiltshire,BG,M,39,25,14,4,2,8,92
Wiltshire,BGX,F,2,9,0,2,1,9,23
Wiltshire,BGX,M,6,9,2,0,0,0,17
Wiltshire,BH,F,35,0,0,0,0,199,234
Wiltshire,BH,M,33,0,0,0,0,0,33
Wiltshire,BHX,F,4,0,0,0,0,14,18
Wiltshire,BHX,M,2,0,0,0,0,0,2
Wiltshire,BI,F,14,12,7,1,3,33,70
Wiltshire,BI,M,17,12,4,1,0,1,35
Wiltshire,BPX,F,1,0,0,0,0,0,1
Wiltshire,BR,M,1,0,0,0,0,0,1
Wiltshire,BRO,F,0,0,0,2,0,3,5
Wiltshire,BRX,F,0,0,1,0,1,0,2
Wiltshire,BRX,M,2,1,0,0,0,0,3
Wiltshire,BS,F,56,55,39,49,30,93,322
Wiltshire,BS,M,21,6,5,0,0,3,35
Wiltshire,BSH,F,48,27,32,10,15,37,169
Wiltshire,BSH,M,43,14,2,3,2,0,64
Wiltshire,BSHX,F,55,37,9,4,6,5,116
Wiltshire,BSHX,M,63,30,1,0,0,0,94
Wiltshire,BSX,F,30,14,25,20,27,62,178
Wiltshire,BSX,M,22,6,7,0,0,0,35
Wiltshire,BW,F,11,10,13,5,8,35,82
Wiltshire,BW,M,8,23,1,0,0,4,36
Wiltshire,BWX,F,5,13,17,3,0,4,42
Wiltshire,BWX,M,5,8,0,2,0,1,16
Wiltshire,BX,F,0,0,0,0,0,1,1
Wiltshire,CB,F,1,0,0,0,0,46,47
Wiltshire,CB,M,1,0,0,0,0,0,1
Wiltshire,CD,F,0,2,0,0,0,6,8
Wiltshire,CD,M,0,3,0,0,0,0,3
Wiltshire,CH,F,154,136,63,45,36,294,728
Wiltshire,CH,M,179,135,43,14,23,93,487
Wiltshire,CHI,F,0,0,0,0,0,2,2
Wiltshire,CHIX,F,0,0,0,0,0,2,2
Wiltshire,CHL,F,0,0,0,0,0,1,1
Wiltshire,CHX,F,"1,702","1,212",213,165,142,804,"4,238"
Wiltshire,CHX,M,"1,824","1,219",214,26,15,116,"3,414"
Wiltshire,DE,F,0,0,0,0,0,1,1
Wiltshire,DEV,F,73,36,30,17,33,89,278
Wiltshire,DEV,M,50,47,13,3,2,3,118
Wiltshire,DEVX,F,61,90,25,15,9,30,230
Wiltshire,DEVX,M,47,70,5,3,0,1,126
Wiltshire,DEX,F,65,49,45,42,20,116,337
Wiltshire,DEX,M,55,49,23,1,1,10,139
Wiltshire,DEXX,F,3,0,1,0,2,7,13
Wiltshire,DG,F,0,0,0,0,0,2,2
Wiltshire,DRX,F,1,0,0,0,0,0,1
Wiltshire,DRX,M,3,0,0,0,0,0,3
Wiltshire,DS,F,26,26,18,16,24,77,187
Wiltshire,DS,M,29,21,3,1,1,0,55
Wiltshire,DSX,F,2,1,6,2,3,6,20
Wiltshire,DSX,M,5,2,0,0,0,0,7
Wiltshire,DV,F,0,0,0,0,0,42,42
Wiltshire,DVX,F,0,0,0,0,0,17,17
Wiltshire,DVX,M,0,0,0,0,0,2,2
Wiltshire,FE,F,0,0,0,0,1,1,2
Wiltshire,FE,M,0,1,0,0,0,0,1
Wiltshire,FR,F,0,0,1,0,0,"10,832","10,833"
Wiltshire,FR,M,0,0,0,0,0,255,255
Wiltshire,FRX,F,0,0,0,0,0,259,259
Wiltshire,FRX,M,0,0,0,0,0,24,24
Wiltshire,GA,F,15,12,31,9,6,46,119
Wiltshire,GA,M,15,23,1,0,1,11,51
Wiltshire,GAX,F,5,9,0,0,0,1,15
Wiltshire,GAX,M,5,7,0,0,0,0,12
Wiltshire,GBX,M,1,0,0,0,0,0,1
Wiltshire,GE,F,0,3,0,0,2,0,5
Wiltshire,GE,M,3,0,0,0,1,2,6
Wiltshire,GEX,F,47,39,3,1,3,12,105
Wiltshire,GEX,M,55,25,3,1,0,0,84
Wiltshire,GL,F,11,9,10,1,7,12,50
Wiltshire,GL,M,8,9,7,0,0,1,25
Wiltshire,GLX,F,0,1,0,0,1,0,2
Wiltshire,GU,F,48,60,67,51,55,364,645
Wiltshire,GU,M,7,7,6,4,0,2,26
Wiltshire,GUX,F,2,2,1,1,1,13,20
Wiltshire,GUX,M,2,1,1,0,0,0,4
Wiltshire,GY,F,3,0,0,0,0,0,3
Wiltshire,GY,M,1,0,0,0,0,0,1
Wiltshire,H,F,0,0,0,0,0,147,147
Wiltshire,H,M,0,0,0,0,0,32,32
Wiltshire,HE,F,264,241,125,100,86,261,"1,077"
Wiltshire,HE,M,286,226,73,25,26,44,680
Wiltshire,HEBL,F,0,0,0,0,0,15,15
Wiltshire,HEBLX,F,0,0,0,0,0,210,210
Wiltshire,HEBLX,M,0,0,0,0,0,16,16
Wiltshire,HER,F,0,0,0,0,0,11,11
Wiltshire,HERX,F,0,0,0,0,0,79,79
Wiltshire,HERX,M,0,0,0,0,0,3,3
Wiltshire,HEX,F,"1,585","1,440",671,499,388,"1,535","6,118"
Wiltshire,HEX,M,"1,345","1,041",323,21,21,52,"2,803"
Wiltshire,HF,F,"5,442","5,452","5,518","5,037","4,437","8,701","34,587"
Wiltshire,HF,M,"2,513","1,435",459,82,46,28,"4,563"
Wiltshire,HFX,F,551,419,295,235,183,404,"2,087"
Wiltshire,HFX,M,324,108,32,8,4,8,484
Wiltshire,HI,F,16,42,33,47,26,157,321
Wiltshire,HI,M,29,37,12,2,9,32,121
Wiltshire,HIX,F,9,10,5,3,3,1,31
Wiltshire,HIX,M,7,6,4,0,0,2,19
Wiltshire,HL,F,0,0,0,0,0,10,10
Wiltshire,HO,F,753,578,623,668,525,851,"3,998"
Wiltshire,HO,M,157,69,39,15,2,2,284
Wiltshire,HOX,F,89,36,54,20,16,106,321
Wiltshire,HOX,M,18,6,12,1,0,0,37
Wiltshire,HX,F,0,0,0,0,0,625,625
Wiltshire,HX,M,0,0,0,0,0,89,89
Wiltshire,IM,F,1,0,0,2,0,4,7
Wiltshire,IM,M,1,2,0,0,0,0,3
Wiltshire,IMX,F,0,0,1,0,0,0,1
Wiltshire,JE,F,156,228,202,109,71,338,"1,104"
Wiltshire,JE,M,16,20,17,2,0,5,60
Wiltshire,JEX,F,178,118,129,71,85,132,713
Wiltshire,JEX,M,23,22,10,0,0,2,57
Wiltshire,JY,F,11,0,0,0,0,1,12
Wiltshire,LH,F,25,25,15,11,3,43,122
Wiltshire,LH,M,12,26,2,0,0,3,43
Wiltshire,LHX,F,3,5,3,0,1,20,32
Wiltshire,LHX,M,4,0,0,0,0,1,5
Wiltshire,LI,F,0,0,0,0,0,57,57
Wiltshire,LI,M,0,0,0,0,0,17,17
Wiltshire,LIM,F,218,213,79,85,56,231,882
Wiltshire,LIM,M,216,146,50,25,12,58,507
Wiltshire,LIMB,F,0,0,0,0,0,1,1
Wiltshire,LIMBX,F,0,0,0,0,0,69,69
Wiltshire,LIMBX,M,0,0,0,0,0,7,7
Wiltshire,LIMR,F,0,0,0,0,0,6,6
Wiltshire,LIMR,M,0,0,0,0,0,4,4
Wiltshire,LIMRX,F,0,0,0,0,0,23,23
Wiltshire,LIMRX,M,0,0,0,0,0,2,2
Wiltshire,LIMX,F,"2,079","1,498",415,230,277,"1,093","5,592"
Wiltshire,LIMX,M,"2,092","1,333",298,13,10,46,"3,792"
Wiltshire,LIX,F,0,0,0,0,0,322,322
Wiltshire,LIX,M,0,0,0,0,0,62,62
Wiltshire,LM,F,0,0,0,0,0,4,4
Wiltshire,LMX,F,0,0,0,0,0,17,17
Wiltshire,LR,F,4,0,18,0,0,0,22
Wiltshire,LU,F,2,0,0,0,5,0,7
Wiltshire,LU,M,2,6,0,0,0,0,8
Wiltshire,MA,F,0,0,0,0,0,1,1
Wiltshire,MARX,F,0,0,0,0,0,1,1
Wiltshire,MAX,M,1,0,0,0,0,0,1
Wiltshire,MG,F,0,0,0,0,0,10,10
Wiltshire,MGX,F,0,1,3,0,0,11,15
Wiltshire,MGX,M,0,0,0,1,0,4,5
Wiltshire,MO,F,8,1,15,19,8,24,75
Wiltshire,MO,M,3,19,10,0,0,0,32
Wiltshire,MOX,F,37,26,33,19,18,88,221
Wiltshire,MOX,M,59,34,18,0,0,0,111
Wiltshire,MRI,F,7,36,23,19,13,33,131
Wiltshire,MRI,M,6,19,1,1,2,37,66
Wiltshire,MRIX,F,74,77,75,67,43,165,501
Wiltshire,MRIX,M,76,53,14,0,0,2,145
Wiltshire,NDX,F,0,0,0,0,0,1,1
Wiltshire,NO,F,0,1,0,0,0,1,2
Wiltshire,NOX,F,9,2,1,0,2,0,14
Wiltshire,NOX,M,11,2,0,0,0,0,13
Wiltshire,NR,F,3,0,0,0,0,0,3
Wiltshire,NR,M,1,0,0,0,0,0,1
Wiltshire,NRX,F,9,0,0,2,0,0,11
Wiltshire,NRX,M,7,0,0,0,0,0,7
Wiltshire,NS,F,0,0,0,0,0,371,371
Wiltshire,NS,M,0,0,0,0,0,2,2
Wiltshire,OB,F,0,0,0,0,0,1,1
Wiltshire,OEX,F,0,0,1,0,0,1,2
Wiltshire,PI,F,1,1,1,0,0,6,9
Wiltshire,PI,M,1,0,1,0,0,1,3
Wiltshire,PIX,F,8,5,11,1,1,26,52
Wiltshire,PIX,M,8,2,0,0,0,8,18
Wiltshire,ROX,F,0,0,0,0,0,7,7
Wiltshire,ROX,M,0,0,0,0,0,1,1
Wiltshire,RP,F,5,3,3,14,2,3,30
Wiltshire,RP,M,11,0,0,1,0,0,12
Wiltshire,RPX,F,1,0,0,0,0,0,1
Wiltshire,RPX,M,2,1,0,0,0,0,3
Wiltshire,RWFR,F,0,0,0,0,0,4,4
Wiltshire,SA,F,2,0,0,0,0,20,22
Wiltshire,SA,M,0,0,3,0,0,8,11
Wiltshire,SAX,F,30,28,27,13,0,56,154
Wiltshire,SAX,M,31,15,0,0,0,3,49
Wiltshire,SBX,F,0,0,0,1,0,0,1
Wiltshire,SBX,M,1,0,0,0,0,0,1
Wiltshire,SD,F,111,122,129,95,114,228,799
Wiltshire,SD,M,86,63,13,4,2,6,174
Wiltshire,SDX,F,167,95,76,69,54,131,592
Wiltshire,SDX,M,177,120,19,0,0,2,318
Wiltshire,SH,F,0,2,1,0,2,6,11
Wiltshire,SHO,F,4,16,27,22,16,137,222
Wiltshire,SHO,M,12,5,2,1,0,29,49
Wiltshire,SHOX,F,26,10,11,21,12,80,160
Wiltshire,SHOX,M,14,4,0,0,1,1,20
Wiltshire,SHX,F,1,2,0,0,0,4,7
Wiltshire,SHX,M,2,1,0,0,0,0,3
Wiltshire,SM,F,199,162,83,60,61,378,943
Wiltshire,SM,M,191,150,58,22,23,98,542
Wiltshire,SMX,F,"2,399","2,175",713,414,523,"2,230","8,454"
Wiltshire,SMX,M,"2,245","1,754",454,26,24,232,"4,735"
Wiltshire,SRW,F,5,0,0,0,0,1,6
Wiltshire,SRW,M,1,1,0,0,0,0,2
Wiltshire,SRWX,F,55,3,12,11,15,6,102
Wiltshire,SRWX,M,28,2,1,1,0,1,33
Wiltshire,ST,F,1,7,0,0,0,0,8
Wiltshire,ST,M,0,0,3,1,0,0,4
Wiltshire,STX,F,68,0,0,0,0,0,68
Wiltshire,STX,M,52,2,0,0,0,0,54
Wiltshire,SU,F,25,35,24,18,34,83,219
Wiltshire,SU,M,29,25,6,0,2,6,68
Wiltshire,SUX,F,50,81,25,20,22,90,288
Wiltshire,SUX,M,67,77,15,1,0,2,162
Wiltshire,WB,F,21,13,13,8,6,42,103
Wiltshire,WB,M,23,21,2,0,1,0,47
Wiltshire,WBX,F,34,12,14,8,3,29,100
Wiltshire,WBX,M,28,14,3,1,0,0,46
Wiltshire,WG,F,1,1,3,1,0,4,10
Wiltshire,WG,M,2,0,0,0,0,0,2
Wiltshire,WGX,F,0,0,0,0,0,1,1
Wiltshire,WP,F,16,13,7,9,8,38,91
Wiltshire,WP,M,11,3,3,4,0,1,22
Wiltshire,WPX,F,0,2,1,0,0,1,4
Wiltshire,WPX,M,1,0,0,0,0,0,1
Wiltshire,WSX,M,0,1,0,0,0,0,1
Wiltshire,ZE,F,0,0,0,1,0,0,1
Wiltshire,ZE,M,0,0,0,1,0,0,1
West Midlands,AA,F,3,22,5,0,1,6,37
West Midlands,AA,M,4,18,1,0,0,2,25
West Midlands,AAX,F,70,86,27,17,21,43,264
West Midlands,AAX,M,55,36,2,0,0,0,93
West Midlands,AYX,F,0,0,0,0,0,1,1
West Midlands,BA,F,23,9,12,3,7,37,91
West Midlands,BA,M,15,6,0,1,3,8,33
West Midlands,BALX,F,0,0,0,1,0,0,1
West Midlands,BARX,F,0,0,0,0,0,5,5
West Midlands,BAX,F,172,90,51,11,17,147,488
West Midlands,BAX,M,158,122,42,1,8,18,349
West Midlands,BB,F,3,10,4,8,4,8,37
West Midlands,BB,M,8,7,1,2,1,2,21
West Midlands,BBX,F,55,70,26,27,13,100,291
West Midlands,BBX,M,22,56,6,1,0,1,86
West Midlands,BF,F,3,2,9,23,23,87,147
West Midlands,BF,M,0,5,4,0,0,0,9
West Midlands,BFX,F,0,0,0,4,0,5,9
West Midlands,BG,F,2,4,3,2,3,11,25
West Midlands,BG,M,5,2,2,0,0,0,9
West Midlands,BGX,F,0,1,0,1,1,0,3
West Midlands,BH,F,0,0,0,0,0,4,4
West Midlands,BHX,F,0,0,0,0,0,1,1
West Midlands,BR,M,1,0,0,0,0,0,1
West Midlands,BRX,F,0,0,0,0,0,1,1
West Midlands,BSH,F,1,0,1,0,1,0,3
West Midlands,BSH,M,0,0,0,0,0,1,1
West Midlands,BSHX,F,1,1,0,3,0,3,8
West Midlands,BSHX,M,0,0,1,1,0,0,2
West Midlands,BSX,F,0,0,0,0,1,0,1
West Midlands,BWX,F,0,0,0,0,2,12,14
West Midlands,CB,F,0,0,0,0,0,43,43
West Midlands,CH,F,6,2,1,0,0,32,41
West Midlands,CH,M,7,2,0,0,1,8,18
West Midlands,CHX,F,27,47,10,6,10,159,259
West Midlands,CHX,M,18,12,2,0,0,18,50
West Midlands,DEV,F,0,0,1,1,0,0,2
West Midlands,DEV,M,0,0,0,0,0,1,1
West Midlands,DEVX,F,2,12,8,2,1,4,29
West Midlands,DEVX,M,3,16,2,0,0,0,21
West Midlands,DEX,F,10,5,6,2,5,10,38
West Midlands,DEX,M,8,5,0,0,0,2,15
West Midlands,DG,F,0,0,0,0,0,2,2
West Midlands,DVX,F,0,0,0,0,0,1,1
West Midlands,FR,F,0,0,0,0,0,403,403
West Midlands,FR,M,0,0,0,0,0,18,18
West Midlands,FRX,F,0,0,0,0,0,3,3
West Midlands,GA,F,9,5,3,10,3,12,42
West Midlands,GA,M,8,0,0,0,1,1,10
West Midlands,GAX,F,1,0,2,0,0,2,5
West Midlands,GE,M,0,0,0,0,1,0,1
West Midlands,GEX,F,1,1,0,0,0,0,2
West Midlands,GEX,M,7,0,0,0,0,0,7
West Midlands,GL,F,0,0,0,0,1,3,4
West Midlands,GUX,M,2,0,0,0,0,0,2
West Midlands,H,F,0,0,0,0,0,9,9
West Midlands,H,M,0,0,0,0,0,3,3
West Midlands,HE,F,14,13,4,13,4,8,56
West Midlands,HE,M,9,6,1,2,3,6,27
West Midlands,HEBLX,F,0,0,0,0,0,14,14
West Midlands,HER,F,0,0,0,0,0,1,1
West Midlands,HERX,F,0,0,0,0,0,10,10
West Midlands,HEX,F,276,157,42,49,26,100,650
West Midlands,HEX,M,242,130,30,4,1,2,409
West Midlands,HF,F,214,168,137,110,102,289,"1,020"
West Midlands,HF,M,35,24,26,1,1,1,88
West Midlands,HFX,F,3,0,0,0,0,7,10
West Midlands,HFX,M,2,0,0,0,0,0,2
West Midlands,HI,F,1,0,0,0,0,4,5
West Midlands,HI,M,0,0,0,0,1,2,3
West Midlands,HIX,F,0,0,0,0,0,2,2
West Midlands,HIX,M,0,0,0,0,0,4,4
West Midlands,HL,F,0,0,0,0,0,2,2
West Midlands,HO,F,106,142,201,158,114,119,840
West Midlands,HO,M,79,10,1,0,0,0,90
West Midlands,HOX,F,0,0,0,0,0,1,1
West Midlands,HOX,M,1,1,0,0,0,0,2
West Midlands,HX,F,0,0,0,0,0,54,54
West Midlands,HX,M,0,0,0,0,0,4,4
West Midlands,IM,F,3,0,0,2,0,3,8
West Midlands,IM,M,2,1,0,0,0,0,3
West Midlands,JE,F,17,12,17,15,12,31,104
West Midlands,JE,M,1,0,0,0,0,4,5
West Midlands,JEX,F,0,1,1,0,0,1,3
West Midlands,JEX,M,1,1,0,0,0,0,2
West Midlands,LHX,F,0,2,0,1,0,0,3
West Midlands,LI,F,0,0,0,0,0,8,8
West Midlands,LI,M,0,0,0,0,0,2,2
West Midlands,LIM,F,15,9,6,24,21,37,112
West Midlands,LIM,M,26,12,4,1,3,6,52
West Midlands,LIMB,M,0,0,0,0,0,1,1
West Midlands,LIMBX,F,0,0,0,0,0,3,3
West Midlands,LIMR,F,0,0,0,0,0,1,1
West Midlands,LIMRX,F,0,0,0,0,0,2,2
West Midlands,LIMRX,M,0,0,0,0,0,1,1
West Midlands,LIMX,F,289,160,56,37,54,148,744
West Midlands,LIMX,M,191,145,17,1,0,6,360
West Midlands,LIX,F,0,0,0,0,0,31,31
West Midlands,LIX,M,0,0,0,0,0,3,3
West Midlands,LR,F,3,1,1,2,1,2,10
West Midlands,LR,M,0,0,0,0,1,0,1
West Midlands,LRX,F,6,4,4,6,2,7,29
West Midlands,LRX,M,3,0,0,0,0,1,4
West Midlands,MG,F,9,12,12,1,2,34,70
West Midlands,MG,M,6,8,4,0,0,0,18
West Midlands,MGX,F,1,2,1,0,0,10,14
West Midlands,MGX,M,1,1,0,0,0,0,2
West Midlands,MO,F,0,0,0,0,1,0,1
West Midlands,MOX,F,1,0,1,0,0,7,9
West Midlands,MRI,F,0,0,0,0,0,9,9
West Midlands,MRIX,F,0,0,0,0,0,1,1
West Midlands,NS,F,0,0,0,0,0,21,21
West Midlands,PA,F,0,0,0,0,0,2,2
West Midlands,PAX,F,0,0,0,1,0,4,5
West Midlands,PIX,F,8,1,0,3,0,4,16
West Midlands,PIX,M,1,0,0,1,0,1,3
West Midlands,RP,F,0,1,1,0,0,2,4
West Midlands,SA,F,3,0,0,0,0,3,6
West Midlands,SA,M,1,2,0,0,0,0,3
West Midlands,SAX,F,19,2,6,7,5,5,44
West Midlands,SAX,M,21,0,0,0,0,0,21
West Midlands,SD,F,0,0,0,0,0,1,1
West Midlands,SD,M,6,5,0,1,0,0,12
West Midlands,SDX,F,0,4,0,1,0,0,5
West Midlands,SDX,M,1,0,0,0,0,0,1
West Midlands,SH,F,0,0,1,0,0,1,2
West Midlands,SH,M,1,0,0,0,0,0,1
West Midlands,SHO,M,0,1,0,0,0,0,1
West Midlands,SHOX,F,0,1,0,0,0,2,3
West Midlands,SHOX,M,2,13,0,0,0,0,15
West Midlands,SHX,M,1,0,0,0,0,0,1
West Midlands,SM,F,15,17,5,2,5,39,83
West Midlands,SM,M,13,10,0,1,1,5,30
West Midlands,SMX,F,116,126,49,39,35,148,513
West Midlands,SMX,M,116,96,4,3,2,12,233
West Midlands,SU,F,0,1,16,0,0,0,17
West Midlands,WB,F,0,0,0,0,0,1,1
West Midlands,WBX,F,0,1,0,0,0,2,3
West Midlands,WG,F,8,3,2,3,2,5,23
West Midlands,WG,M,6,6,0,0,1,1,14
West Midlands,WGX,F,0,1,0,0,0,0,1
South Yorkshire,AA,F,52,54,19,11,13,73,222
South Yorkshire,AA,M,78,75,20,5,5,16,199
South Yorkshire,AAX,F,323,286,107,73,53,201,"1,043"
South Yorkshire,AAX,M,356,415,140,0,0,13,924
South Yorkshire,AY,F,64,69,44,71,61,146,455
South Yorkshire,AY,M,44,23,3,1,0,1,72
South Yorkshire,AYX,F,4,4,3,4,16,10,41
South Yorkshire,AYX,M,0,2,0,0,0,0,2
South Yorkshire,BA,F,24,16,6,3,3,55,107
South Yorkshire,BA,M,22,11,7,6,1,16,63
South Yorkshire,BAB,F,0,0,0,0,0,1,1
South Yorkshire,BAR,F,0,0,0,0,0,1,1
South Yorkshire,BARX,F,0,0,0,0,0,7,7
South Yorkshire,BAWX,F,0,0,0,0,0,1,1
South Yorkshire,BAX,F,351,253,64,26,58,280,"1,032"
South Yorkshire,BAX,M,353,161,17,2,1,21,555
South Yorkshire,BAZ,F,1,1,0,0,0,0,2
South Yorkshire,BAZ,M,0,1,0,0,0,0,1
South Yorkshire,BAZX,F,0,1,2,0,0,0,3
South Yorkshire,BAZX,M,1,3,1,0,0,0,5
South Yorkshire,BB,F,102,50,18,12,5,82,269
South Yorkshire,BB,M,110,69,13,9,4,19,224
South Yorkshire,BBX,F,767,543,144,118,98,352,"2,022"
South Yorkshire,BBX,M,786,428,38,0,0,18,"1,270"
South Yorkshire,BF,F,173,231,250,228,229,610,"1,721"
South Yorkshire,BF,M,413,242,53,3,1,10,722
South Yorkshire,BFX,F,27,28,26,12,17,32,142
South Yorkshire,BFX,M,65,30,4,2,0,1,102
South Yorkshire,BG,F,0,0,0,0,0,1,1
South Yorkshire,BGX,F,0,0,1,0,0,0,1
South Yorkshire,BH,F,2,0,0,0,0,41,43
South Yorkshire,BH,M,10,0,0,0,0,3,13
South Yorkshire,BHX,F,0,0,0,0,0,3,3
South Yorkshire,BI,M,1,0,0,0,0,0,1
South Yorkshire,BP,F,0,0,0,0,1,0,1
South Yorkshire,BRX,M,1,1,0,0,0,0,2
South Yorkshire,BS,F,6,1,0,0,0,4,11
South Yorkshire,BS,M,2,0,0,0,0,0,2
South Yorkshire,BSH,F,0,0,0,0,0,1,1
South Yorkshire,BSH,M,0,4,0,0,0,0,4
South Yorkshire,BSHX,F,0,8,1,0,1,4,14
South Yorkshire,BSHX,M,5,16,0,1,0,0,22
South Yorkshire,BSX,F,5,8,3,0,0,9,25
South Yorkshire,BSX,M,8,10,0,0,0,0,18
South Yorkshire,BW,M,0,1,0,0,0,0,1
South Yorkshire,BWX,M,2,0,0,0,0,1,3
South Yorkshire,BX,F,0,0,0,0,0,1,1
South Yorkshire,CA,F,0,0,0,0,0,3,3
South Yorkshire,CAX,F,0,0,0,0,0,3,3
South Yorkshire,CB,F,4,2,6,8,5,34,59
South Yorkshire,CB,M,1,0,0,0,0,0,1
South Yorkshire,CD,F,0,0,0,0,0,2,2
South Yorkshire,CH,F,114,119,11,14,42,226,526
South Yorkshire,CH,M,110,54,8,4,3,15,194
South Yorkshire,CHIX,F,0,0,0,0,0,1,1
South Yorkshire,CHX,F,329,338,48,59,42,317,"1,133"
South Yorkshire,CHX,M,315,365,40,0,0,36,756
South Yorkshire,DE,F,0,0,0,0,0,1,1
South Yorkshire,DEVX,F,0,0,1,0,0,0,1
South Yorkshire,DEX,F,26,27,9,13,12,61,148
South Yorkshire,DEX,M,37,24,17,8,4,10,100
South Yorkshire,DEXX,F,0,0,0,0,0,1,1
South Yorkshire,DS,F,0,1,0,0,1,6,8
South Yorkshire,DS,M,1,0,1,0,0,0,2
South Yorkshire,DSHO,M,1,0,0,0,0,0,1
South Yorkshire,DSX,F,4,8,1,0,0,2,15
South Yorkshire,DSX,M,1,1,0,0,0,0,2
South Yorkshire,DV,F,0,0,0,0,0,4,4
South Yorkshire,DVX,F,0,0,0,0,0,1,1
South Yorkshire,FR,F,0,0,0,0,0,"1,609","1,609"
South Yorkshire,FR,M,0,0,0,0,0,52,52
South Yorkshire,FRX,F,0,0,0,0,0,60,60
South Yorkshire,FRX,M,0,0,0,0,0,4,4
South Yorkshire,GA,F,0,1,0,0,4,3,8
South Yorkshire,GA,M,0,0,0,0,0,1,1
South Yorkshire,GASX,M,0,1,0,0,0,0,1
South Yorkshire,GAX,F,0,0,0,0,1,4,5
South Yorkshire,GAX,M,1,2,0,0,0,0,3
South Yorkshire,GB,F,0,0,0,1,0,0,1
South Yorkshire,GE,F,1,0,0,0,0,4,5
South Yorkshire,GEX,M,0,10,0,0,0,0,10
South Yorkshire,GL,F,2,3,1,0,1,10,17
South Yorkshire,GL,M,7,5,1,0,0,0,13
South Yorkshire,GU,F,0,0,0,0,0,8,8
South Yorkshire,GUX,F,0,4,0,0,0,3,7
South Yorkshire,H,F,0,0,0,0,0,33,33
South Yorkshire,H,M,0,0,0,0,0,5,5
South Yorkshire,HE,F,34,35,22,10,8,22,131
South Yorkshire,HE,M,60,47,8,1,1,1,118
South Yorkshire,HEBL,F,0,0,0,0,0,7,7
South Yorkshire,HEBLX,F,0,0,0,0,0,19,19
South Yorkshire,HER,F,0,0,0,0,0,7,7
South Yorkshire,HERX,F,0,0,0,0,0,17,17
South Yorkshire,HERX,M,0,0,0,0,0,1,1
South Yorkshire,HEX,F,125,161,52,46,48,200,632
South Yorkshire,HEX,M,193,259,72,9,0,2,535
South Yorkshire,HF,F,"1,121","1,068","1,067","1,053",806,"1,632","6,747"
South Yorkshire,HF,M,"1,255",566,66,10,2,8,"1,907"
South Yorkshire,HFX,F,105,67,65,87,69,170,563
South Yorkshire,HFX,M,122,49,3,1,0,0,175
South Yorkshire,HI,F,17,8,8,13,10,51,107
South Yorkshire,HI,M,11,9,1,3,1,2,27
South Yorkshire,HIX,F,0,0,0,0,0,2,2
South Yorkshire,HIX,M,1,1,1,0,0,0,3
South Yorkshire,HL,M,0,0,0,0,0,1,1
South Yorkshire,HO,F,106,129,176,97,68,248,824
South Yorkshire,HO,M,189,94,16,4,2,1,306
South Yorkshire,HOX,F,3,8,2,2,3,11,29
South Yorkshire,HOX,M,11,3,0,0,0,0,14
South Yorkshire,HX,F,0,0,0,0,0,87,87
South Yorkshire,HX,M,0,0,0,0,0,9,9
South Yorkshire,IM,F,0,0,0,0,0,2,2
South Yorkshire,JE,F,111,145,131,125,105,198,815
South Yorkshire,JE,M,2,1,2,0,0,2,7
South Yorkshire,JEX,F,17,2,1,3,3,8,34
South Yorkshire,JEX,M,4,1,0,0,0,1,6
South Yorkshire,JY,F,32,0,0,0,0,0,32
South Yorkshire,KE,F,0,0,0,0,1,0,1
South Yorkshire,LH,F,8,6,10,4,6,13,47
South Yorkshire,LH,M,9,4,2,1,0,1,17
South Yorkshire,LHX,F,4,6,0,0,0,14,24
South Yorkshire,LHX,M,3,6,0,0,0,0,9
South Yorkshire,LI,F,0,0,0,0,0,46,46
South Yorkshire,LI,M,0,0,0,0,0,17,17
South Yorkshire,LIM,F,290,196,70,68,38,165,827
South Yorkshire,LIM,M,257,186,31,16,10,45,545
South Yorkshire,LIMB,F,0,0,0,0,0,17,17
South Yorkshire,LIMBX,F,0,0,0,0,0,26,26
South Yorkshire,LIMBX,M,0,0,0,0,0,1,1
South Yorkshire,LIMR,F,0,0,0,0,0,24,24
South Yorkshire,LIMR,M,0,0,0,0,0,4,4
South Yorkshire,LIMRX,F,0,0,0,0,0,30,30
South Yorkshire,LIMX,F,"1,692","1,355",359,217,192,695,"4,510"
South Yorkshire,LIMX,M,"1,744","1,218",111,8,6,17,"3,104"
South Yorkshire,LIX,F,0,0,0,0,0,256,256
South Yorkshire,LIX,M,0,0,0,0,0,59,59
South Yorkshire,LM,F,0,0,0,0,0,4,4
South Yorkshire,LMX,F,0,0,0,0,0,9,9
South Yorkshire,LR,F,3,0,3,0,0,7,13
South Yorkshire,LR,M,8,3,0,0,0,1,12
South Yorkshire,LRX,F,0,1,0,1,0,0,2
South Yorkshire,LUX,F,0,3,0,0,0,0,3
South Yorkshire,LUX,M,0,20,0,0,0,0,20
South Yorkshire,MAR,F,0,0,0,0,0,1,1
South Yorkshire,MARX,F,0,0,0,0,0,1,1
South Yorkshire,MG,F,0,1,0,0,0,3,4
South Yorkshire,MGX,F,9,7,0,1,0,12,29
South Yorkshire,MGX,M,4,3,0,0,0,4,11
South Yorkshire,MO,F,0,0,2,0,0,1,3
South Yorkshire,MO,M,1,0,0,0,0,0,1
South Yorkshire,MOX,F,0,6,0,6,20,46,78
South Yorkshire,MOX,M,14,5,0,0,0,0,19
South Yorkshire,MRI,F,29,44,22,0,4,5,104
South Yorkshire,MRI,M,69,27,1,0,0,0,97
South Yorkshire,MRIX,F,18,23,12,21,6,3,83
South Yorkshire,MRIX,M,19,4,1,0,0,0,24
South Yorkshire,NRX,F,6,0,0,0,0,0,6
South Yorkshire,NRX,M,1,0,0,0,0,0,1
South Yorkshire,NS,F,0,0,0,0,0,80,80
South Yorkshire,OE,F,0,0,0,0,0,1,1
South Yorkshire,PAX,F,0,0,0,0,0,1,1
South Yorkshire,PAX,M,2,1,0,0,0,0,3
South Yorkshire,PI,F,3,6,0,0,0,3,12
South Yorkshire,PI,M,0,2,0,0,0,0,2
South Yorkshire,PIX,F,14,16,3,2,0,5,40
South Yorkshire,PIX,M,17,16,2,0,0,0,35
South Yorkshire,RP,F,6,1,3,8,3,29,50
South Yorkshire,RP,M,2,1,1,0,0,1,5
South Yorkshire,RPX,F,1,0,13,1,4,30,49
South Yorkshire,RPX,M,3,0,1,0,0,0,4
South Yorkshire,RWFR,F,0,0,0,0,0,10,10
South Yorkshire,SA,F,38,30,0,19,17,132,236
South Yorkshire,SA,M,32,10,2,3,3,10,60
South Yorkshire,SAX,F,1,6,4,0,0,98,109
South Yorkshire,SAX,M,2,3,1,0,0,6,12
South Yorkshire,SD,F,2,2,0,0,0,14,18
South Yorkshire,SD,M,0,2,0,0,0,0,2
South Yorkshire,SDX,F,3,0,4,2,5,13,27
South Yorkshire,SDX,M,3,6,0,0,0,0,9
South Yorkshire,SH,F,6,2,12,5,2,1,28
South Yorkshire,SH,M,7,2,0,1,0,0,10
South Yorkshire,SHO,F,1,1,3,4,4,27,40
South Yorkshire,SHO,M,11,6,0,0,0,2,19
South Yorkshire,SHOX,F,12,8,5,0,2,9,36
South Yorkshire,SHOX,M,20,32,1,0,0,0,53
South Yorkshire,SHX,F,1,0,0,0,0,0,1
South Yorkshire,SM,F,65,47,23,8,6,120,269
South Yorkshire,SM,M,57,50,2,3,0,17,129
South Yorkshire,SMX,F,308,334,95,57,37,354,"1,185"
South Yorkshire,SMX,M,425,288,43,1,0,15,772
South Yorkshire,SRW,F,0,0,0,1,0,0,1
South Yorkshire,SRW,M,2,0,0,0,0,0,2
South Yorkshire,SRWX,F,16,28,15,18,5,0,82
South Yorkshire,SRWX,M,22,22,1,0,0,0,45
South Yorkshire,ST,F,19,4,0,1,0,4,28
South Yorkshire,ST,M,11,0,3,1,0,0,15
South Yorkshire,STX,F,29,17,3,0,0,5,54
South Yorkshire,STX,M,5,0,0,0,0,0,5
South Yorkshire,SU,F,7,3,0,1,0,8,19
South Yorkshire,SU,M,5,8,0,0,0,2,15
South Yorkshire,WB,F,1,0,0,4,1,11,17
South Yorkshire,WB,M,0,0,0,1,0,0,1
South Yorkshire,WBX,F,1,1,0,2,1,14,19
South Yorkshire,WBX,M,3,6,0,0,0,0,9
South Yorkshire,WP,F,0,0,0,0,1,1,2
North Yorkshire,AA,F,656,594,348,219,202,996,"3,015"
North Yorkshire,AA,M,715,651,136,39,24,104,"1,669"
North Yorkshire,AAX,F,"2,391","2,266",855,535,656,"3,002","9,705"
North Yorkshire,AAX,M,"2,706","2,428",563,26,22,145,"5,890"
North Yorkshire,AR,F,1,0,0,1,0,0,2
North Yorkshire,ARX,F,2,0,0,0,0,1,3
North Yorkshire,ARX,M,1,0,0,0,0,0,1
North Yorkshire,AY,F,145,127,146,179,110,493,"1,200"
North Yorkshire,AY,M,70,67,31,1,1,9,179
North Yorkshire,AYX,F,18,30,21,16,11,34,130
North Yorkshire,AYX,M,15,24,3,1,0,1,44
North Yorkshire,BA,F,212,266,96,54,61,393,"1,082"
North Yorkshire,BA,M,244,208,58,29,17,127,683
North Yorkshire,BAB,F,0,0,0,0,0,3,3
North Yorkshire,BABX,F,0,0,0,0,0,20,20
North Yorkshire,BABX,M,0,0,0,0,0,1,1
North Yorkshire,BAL,F,1,0,0,1,1,1,4
North Yorkshire,BAL,M,7,4,4,0,0,0,15
North Yorkshire,BALX,F,1,2,3,0,0,3,9
North Yorkshire,BALX,M,7,23,4,0,0,0,34
North Yorkshire,BAR,F,0,0,0,0,0,5,5
North Yorkshire,BARX,F,0,0,0,0,0,23,23
North Yorkshire,BARX,M,0,0,0,0,0,2,2
North Yorkshire,BAW,F,0,0,0,0,0,1,1
North Yorkshire,BAWX,F,0,0,0,0,0,3,3
North Yorkshire,BAX,F,"2,203","2,223",487,279,321,"1,554","7,067"
North Yorkshire,BAX,M,"2,258","1,960",271,27,15,154,"4,685"
North Yorkshire,BAZ,F,32,10,2,10,7,18,79
North Yorkshire,BAZ,M,19,8,6,1,2,1,37
North Yorkshire,BAZ X,F,0,0,0,0,0,1,1
North Yorkshire,BAZ X,M,0,0,0,0,0,1,1
North Yorkshire,BAZX,F,91,103,35,15,7,25,276
North Yorkshire,BAZX,M,107,67,5,0,0,1,180
North Yorkshire,BB,F,559,565,248,157,129,784,"2,442"
North Yorkshire,BB,M,709,588,170,50,38,239,"1,794"
North Yorkshire,BBX,F,"5,770","5,388","1,593",923,804,"3,362","17,840"
North Yorkshire,BBX,M,"7,079","5,184",937,57,45,275,"13,577"
North Yorkshire,BF,F,"1,542","1,543","2,035","2,102","2,205","3,584","13,011"
North Yorkshire,BF,M,"1,915","1,836",849,69,43,19,"4,731"
North Yorkshire,BFX,F,256,270,246,253,296,487,"1,808"
North Yorkshire,BFX,M,334,245,86,20,11,9,705
North Yorkshire,BG,F,32,35,12,26,12,35,152
North Yorkshire,BG,M,33,24,3,4,3,2,69
North Yorkshire,BGX,F,14,7,21,5,7,9,63
North Yorkshire,BGX,M,21,3,0,1,0,0,25
North Yorkshire,BH,F,35,0,0,0,0,469,504
North Yorkshire,BH,M,28,0,0,0,0,9,37
North Yorkshire,BHX,F,9,0,0,0,0,175,184
North Yorkshire,BHX,M,6,0,0,0,0,1,7
North Yorkshire,BI,F,3,1,3,8,0,0,15
North Yorkshire,BI,M,0,0,1,0,0,0,1
North Yorkshire,BLG,F,1,18,0,0,8,68,95
North Yorkshire,BLG,M,2,8,4,2,0,0,16
North Yorkshire,BLGX,F,0,0,0,0,0,3,3
North Yorkshire,BR,F,0,1,0,0,0,0,1
North Yorkshire,BR,M,0,0,0,0,0,1,1
North Yorkshire,BRX,F,1,1,2,0,0,1,5
North Yorkshire,BRX,M,1,2,0,0,0,0,3
North Yorkshire,BS,F,8,11,9,9,7,33,77
North Yorkshire,BS,M,14,32,6,0,2,1,55
North Yorkshire,BSH,F,217,132,119,83,59,187,797
North Yorkshire,BSH,M,206,158,28,7,6,14,419
North Yorkshire,BSHO,F,0,0,0,0,0,8,8
North Yorkshire,BSHO,M,0,0,0,0,0,1,1
North Yorkshire,BSHX,F,64,61,24,5,12,32,198
North Yorkshire,BSHX,M,77,51,3,0,0,1,132
North Yorkshire,BSX,F,61,61,32,21,30,31,236
North Yorkshire,BSX,M,60,44,13,1,0,3,121
North Yorkshire,BU,F,23,30,28,25,16,61,183
North Yorkshire,BU,M,30,37,10,1,0,8,86
North Yorkshire,BW,F,15,7,13,15,10,49,109
North Yorkshire,BW,M,8,15,1,1,1,3,29
North Yorkshire,BWX,F,1,5,7,4,4,37,58
North Yorkshire,BWX,M,3,7,3,0,0,0,13
North Yorkshire,BX,F,0,0,0,0,0,2,2
North Yorkshire,CA,F,0,0,0,0,0,3,3
North Yorkshire,CAX,F,0,0,0,0,0,53,53
North Yorkshire,CAX,M,0,0,0,0,0,4,4
North Yorkshire,CB,F,6,3,0,0,0,117,126
North Yorkshire,CB,M,5,5,1,0,0,0,11
North Yorkshire,CD,F,0,3,0,0,1,2,6
North Yorkshire,CD,M,0,2,0,0,0,0,2
North Yorkshire,CH,F,570,630,270,174,157,"1,157","2,958"
North Yorkshire,CH,M,703,541,144,43,35,191,"1,657"
North Yorkshire,CHIX,F,0,2,0,0,0,9,11
North Yorkshire,CHIX,M,0,1,0,0,0,2,3
North Yorkshire,CHL,M,1,1,0,0,0,0,2
North Yorkshire,CHX,F,"2,581","3,908",620,358,332,"2,283","10,082"
North Yorkshire,CHX,M,"3,004","4,003",787,40,34,198,"8,066"
North Yorkshire,CON,F,0,0,0,0,0,3,3
North Yorkshire,CON,M,0,0,0,0,0,3,3
North Yorkshire,DE,F,0,0,0,0,0,1,1
North Yorkshire,DEV,F,4,2,1,8,1,15,31
North Yorkshire,DEV,M,1,3,1,0,0,0,5
North Yorkshire,DEVX,F,2,12,3,4,0,16,37
North Yorkshire,DEVX,M,0,10,8,0,0,0,18
North Yorkshire,DEX,F,154,122,88,89,67,239,759
North Yorkshire,DEX,M,160,156,21,6,9,24,376
North Yorkshire,DEXX,F,12,7,2,1,1,5,28
North Yorkshire,DEXX,M,9,2,1,0,0,0,12
North Yorkshire,DG,M,0,0,0,0,0,1,1
North Yorkshire,DR,F,0,0,0,0,1,0,1
North Yorkshire,DRX,F,0,0,0,0,1,0,1
North Yorkshire,DS,F,28,45,32,16,15,94,230
North Yorkshire,DS,M,29,29,3,3,0,1,65
North Yorkshire,DSHO,F,3,0,0,0,0,8,11
North Yorkshire,DSHO,M,5,0,0,0,0,0,5
North Yorkshire,DSX,F,6,0,7,3,3,16,35
North Yorkshire,DSX,M,13,5,2,1,0,0,21
North Yorkshire,DV,F,0,0,0,0,0,18,18
North Yorkshire,DVX,F,0,0,0,0,0,18,18
North Yorkshire,DVX,M,0,0,0,0,0,1,1
North Yorkshire,FE,F,0,0,0,0,0,1,1
North Yorkshire,FR,F,0,0,0,0,1,"14,741","14,742"
North Yorkshire,FR,M,0,0,0,0,0,520,520
North Yorkshire,FRX,F,0,0,0,0,0,734,734
North Yorkshire,FRX,M,0,0,0,0,0,57,57
North Yorkshire,GA,F,17,35,30,25,15,86,208
North Yorkshire,GA,M,14,41,15,2,0,0,72
North Yorkshire,GAS,F,5,9,1,6,0,15,36
North Yorkshire,GAS,M,13,1,0,1,0,0,15
North Yorkshire,GASX,F,2,1,0,2,2,3,10
North Yorkshire,GASX,M,2,7,1,0,0,0,10
North Yorkshire,GAX,F,7,11,14,8,7,106,153
North Yorkshire,GAX,M,5,25,7,3,0,1,41
North Yorkshire,GB,M,2,0,0,0,0,0,2
North Yorkshire,GBX,F,4,1,0,0,0,1,6
North Yorkshire,GBX,M,4,0,0,0,0,0,4
North Yorkshire,GE,F,5,11,2,1,4,18,41
North Yorkshire,GE,M,4,8,6,0,0,4,22
North Yorkshire,GEX,F,88,18,21,2,7,72,208
North Yorkshire,GEX,M,82,24,10,0,0,2,118
North Yorkshire,GL,F,0,0,0,0,2,1,3
North Yorkshire,GL,M,1,0,0,0,0,0,1
North Yorkshire,GLX,F,0,0,0,1,0,0,1
North Yorkshire,GU,F,45,54,45,37,21,33,235
North Yorkshire,GU,M,41,2,2,1,0,2,48
North Yorkshire,GUX,F,0,0,0,0,0,2,2
North Yorkshire,H,F,0,0,0,0,0,240,240
North Yorkshire,H,M,0,0,0,0,0,24,24
North Yorkshire,HE,F,111,153,80,82,79,408,913
North Yorkshire,HE,M,152,212,44,14,7,23,452
North Yorkshire,HEBL,F,0,0,0,0,0,11,11
North Yorkshire,HEBLX,F,0,0,0,0,0,64,64
North Yorkshire,HER,F,0,0,0,0,0,20,20
North Yorkshire,HERX,F,0,0,0,0,0,35,35
North Yorkshire,HEX,F,677,808,405,279,291,"1,321","3,781"
North Yorkshire,HEX,M,907,"1,050",369,23,8,19,"2,376"
North Yorkshire,HF,F,"12,041","11,820","12,282","10,650","9,326","17,079","73,198"
North Yorkshire,HF,M,"8,258","5,573","1,868",307,199,164,"16,369"
North Yorkshire,HFX,F,942,864,932,953,834,"1,713","6,238"
North Yorkshire,HFX,M,859,518,171,19,12,23,"1,602"
North Yorkshire,HI,F,111,116,76,97,81,308,789
North Yorkshire,HI,M,126,119,82,58,24,35,444
North Yorkshire,HIX,F,4,5,1,3,0,13,26
North Yorkshire,HIX,M,4,6,4,1,1,1,17
North Yorkshire,HL,F,0,0,0,0,0,16,16
North Yorkshire,HO,F,"2,140","1,965","2,135","2,021","1,664","3,209","13,134"
North Yorkshire,HO,M,"1,126",660,252,90,35,55,"2,218"
North Yorkshire,HOX,F,71,81,88,118,134,259,751
North Yorkshire,HOX,M,62,49,22,2,2,3,140
North Yorkshire,HX,F,0,0,0,0,0,389,389
North Yorkshire,HX,M,0,0,0,0,0,45,45
North Yorkshire,IM,F,0,0,0,0,0,5,5
North Yorkshire,IMX,F,1,1,0,1,0,1,4
North Yorkshire,JE,F,213,216,138,214,155,377,"1,313"
North Yorkshire,JE,M,72,6,8,2,2,3,93
North Yorkshire,JEX,F,175,130,86,35,16,45,487
North Yorkshire,JEX,M,38,29,7,1,5,1,81
North Yorkshire,JY,F,21,0,0,0,0,5,26
North Yorkshire,JY,M,10,0,0,0,0,0,10
North Yorkshire,JYX,F,4,0,0,0,0,0,4
North Yorkshire,JYX,M,1,0,0,0,0,0,1
North Yorkshire,KE,F,0,2,0,0,0,8,10
North Yorkshire,KE,M,0,0,0,0,0,1,1
North Yorkshire,KEX,F,0,0,0,0,0,1,1
North Yorkshire,LH,F,58,57,36,35,32,111,329
North Yorkshire,LH,M,81,35,12,10,1,5,144
North Yorkshire,LHX,F,14,13,11,5,4,14,61
North Yorkshire,LHX,M,32,18,3,0,0,0,53
North Yorkshire,LI,F,0,0,0,0,0,647,647
North Yorkshire,LI,M,0,0,0,0,0,177,177
North Yorkshire,LIM,F,"2,395","2,395",805,608,545,"2,462","9,210"
North Yorkshire,LIM,M,"2,613","2,050",477,204,163,477,"5,984"
North Yorkshire,LIM X,F,0,0,0,0,0,9,9
North Yorkshire,LIMB,F,0,0,0,0,0,46,46
North Yorkshire,LIMB,M,0,0,0,0,0,2,2
North Yorkshire,LIMBX,F,0,0,0,0,0,437,437
North Yorkshire,LIMBX,M,0,0,0,0,0,15,15
North Yorkshire,LIMR,F,0,0,0,0,0,100,100
North Yorkshire,LIMR,M,0,0,0,0,0,25,25
North Yorkshire,LIMRX,F,0,0,0,0,0,251,251
North Yorkshire,LIMRX,M,0,0,0,0,0,10,10
North Yorkshire,LIMX,F,"14,251","15,971","3,977","2,200","2,191","9,391","47,981"
North Yorkshire,LIMX,M,"15,297","14,862","2,728",184,66,269,"33,406"
North Yorkshire,LIX,F,0,0,0,0,0,"3,040","3,040"
North Yorkshire,LIX,M,0,0,0,0,0,605,605
North Yorkshire,LM,F,0,0,0,0,0,63,63
North Yorkshire,LM,M,0,0,0,0,0,9,9
North Yorkshire,LMX,F,0,0,0,0,0,115,115
North Yorkshire,LMX,M,0,0,0,0,0,3,3
North Yorkshire,LR,F,7,2,3,12,1,18,43
North Yorkshire,LR,M,8,3,1,0,1,0,13
North Yorkshire,LRX,F,13,12,3,0,3,11,42
North Yorkshire,LRX,M,17,6,0,0,0,0,23
North Yorkshire,LU,F,1,11,1,2,18,34,67
North Yorkshire,LU,M,1,28,0,0,1,0,30
North Yorkshire,LUX,F,0,1,0,0,0,2,3
North Yorkshire,LUX,M,0,3,1,0,0,0,4
North Yorkshire,MA,F,0,0,0,0,0,2,2
North Yorkshire,MALX,F,0,0,0,0,0,1,1
North Yorkshire,MAR,F,3,1,0,1,0,3,8
North Yorkshire,MAR,M,0,1,0,1,0,1,3
North Yorkshire,MARX,F,5,0,0,0,0,12,17
North Yorkshire,MARX,M,3,1,0,0,0,2,6
North Yorkshire,MAX,F,0,0,0,0,1,1,2
North Yorkshire,MG,F,2,4,7,2,4,40,59
North Yorkshire,MG,M,5,0,5,1,0,3,14
North Yorkshire,MGX,F,1,4,0,3,3,6,17
North Yorkshire,MGX,M,3,6,1,0,0,1,11
North Yorkshire,MO,F,3,9,11,4,6,11,44
North Yorkshire,MO,M,30,35,9,2,0,1,77
North Yorkshire,MOX,F,50,72,37,11,5,28,203
North Yorkshire,MOX,M,105,95,31,1,0,0,232
North Yorkshire,MRI,F,20,17,20,21,27,68,173
North Yorkshire,MRI,M,31,21,15,3,0,4,74
North Yorkshire,MRIX,F,31,19,21,28,47,133,279
North Yorkshire,MRIX,M,65,52,30,0,1,1,149
North Yorkshire,NO,F,0,0,4,0,0,1,5
North Yorkshire,NO,M,0,1,0,0,0,0,1
North Yorkshire,NOX,F,0,1,0,0,3,6,10
North Yorkshire,NOX,M,0,3,0,0,0,0,3
North Yorkshire,NR,F,3,0,0,0,0,0,3
North Yorkshire,NR,M,3,0,0,0,0,0,3
North Yorkshire,NRX,F,64,4,3,0,0,0,71
North Yorkshire,NRX,M,31,1,0,0,0,1,33
North Yorkshire,NS,F,0,0,0,0,0,664,664
North Yorkshire,OB,F,0,0,0,0,0,9,9
North Yorkshire,OE,F,0,0,0,0,0,5,5
North Yorkshire,OEX,M,1,0,1,0,0,0,2
North Yorkshire,OO,F,0,0,0,0,0,1,1
North Yorkshire,OO,M,0,0,0,0,0,1,1
North Yorkshire,PA,F,20,12,5,1,2,8,48
North Yorkshire,PA,M,13,4,4,1,0,1,23
North Yorkshire,PAX,F,35,28,5,7,1,9,85
North Yorkshire,PAX,M,38,26,1,1,0,1,67
North Yorkshire,PI,F,1,14,1,0,0,33,49
North Yorkshire,PI,M,0,6,2,2,0,7,17
North Yorkshire,PIX,F,57,61,7,5,8,34,172
North Yorkshire,PIX,M,61,55,4,1,1,1,123
North Yorkshire,RE,F,0,0,0,1,0,0,1
North Yorkshire,RO,F,0,0,0,0,0,2,2
North Yorkshire,ROX,F,0,1,3,0,0,2,6
North Yorkshire,ROX,M,2,0,0,0,0,0,2
North Yorkshire,RP,F,1,2,4,1,0,5,13
North Yorkshire,RP,M,1,1,0,0,0,0,2
North Yorkshire,RPX,F,5,0,0,0,0,4,9
North Yorkshire,RPX,M,2,0,0,0,0,0,2
North Yorkshire,RWFR,F,0,0,0,0,0,1,1
North Yorkshire,SA,F,87,83,25,27,25,201,448
North Yorkshire,SA,M,94,107,7,4,1,15,228
North Yorkshire,SAX,F,144,251,99,87,42,378,"1,001"
North Yorkshire,SAX,M,166,139,16,2,2,12,337
North Yorkshire,SBX,F,0,2,0,2,2,0,6
North Yorkshire,SBX,M,0,1,0,0,0,0,1
North Yorkshire,SD,F,84,94,77,64,56,208,583
North Yorkshire,SD,M,103,88,15,5,3,5,219
North Yorkshire,SDX,F,41,55,15,10,18,97,236
North Yorkshire,SDX,M,60,58,5,1,1,1,126
North Yorkshire,SG,F,0,0,2,0,0,0,2
North Yorkshire,SG,M,1,0,0,0,0,0,1
North Yorkshire,SH,F,1,0,1,0,1,2,5
North Yorkshire,SH,M,3,1,0,0,0,0,4
North Yorkshire,SHO,F,25,21,18,21,17,149,251
North Yorkshire,SHO,M,43,33,32,1,0,7,116
North Yorkshire,SHOX,F,74,54,25,19,16,109,297
North Yorkshire,SHOX,M,51,69,20,0,0,2,142
North Yorkshire,SHX,F,1,4,2,1,0,11,19
North Yorkshire,SHX,M,0,0,1,0,0,1,2
North Yorkshire,SM,F,456,477,182,118,125,729,"2,087"
North Yorkshire,SM,M,607,364,74,34,21,122,"1,222"
North Yorkshire,SMX,F,"2,174","2,528",726,579,487,"3,277","9,771"
North Yorkshire,SMX,M,"3,075","2,402",426,41,19,191,"6,154"
North Yorkshire,SRW,F,13,4,1,1,0,1,20
North Yorkshire,SRW,M,7,4,1,0,0,0,12
North Yorkshire,SRWX,F,114,20,15,6,15,10,180
North Yorkshire,SRWX,M,92,16,8,0,1,1,118
North Yorkshire,ST,F,32,21,15,9,9,5,91
North Yorkshire,ST,M,40,24,10,11,4,5,94
North Yorkshire,STX,F,549,506,337,265,164,95,"1,916"
North Yorkshire,STX,M,576,453,74,2,0,0,"1,105"
North Yorkshire,SU,F,0,0,0,0,3,4,7
North Yorkshire,SU,M,0,7,0,0,0,0,7
North Yorkshire,SUX,F,13,2,5,2,3,19,44
North Yorkshire,SUX,M,9,7,1,0,0,1,18
North Yorkshire,VA,F,0,0,0,0,0,2,2
North Yorkshire,WAX,M,1,0,0,0,0,0,1
North Yorkshire,WB,F,27,15,17,31,5,37,132
North Yorkshire,WB,M,21,25,19,1,0,1,67
North Yorkshire,WBX,F,11,19,17,6,14,73,140
North Yorkshire,WBX,M,9,39,14,0,0,2,64
North Yorkshire,WG,F,4,10,3,6,2,17,42
North Yorkshire,WG,M,7,6,0,0,1,0,14
North Yorkshire,WGX,F,1,1,0,0,0,0,2
North Yorkshire,WGX,M,1,1,0,0,0,0,2
North Yorkshire,WP,F,10,0,2,3,2,17,34
North Yorkshire,WP,M,3,4,2,1,0,4,14
North Yorkshire,WPX,M,0,1,0,0,0,0,1
North Yorkshire,WS,M,0,1,0,0,0,1,2
North Yorkshire,WSX,F,0,2,11,0,6,35,54
North Yorkshire,WSX,M,0,10,5,0,0,0,15
North Yorkshire,YK,F,1,0,0,1,0,2,4
North Yorkshire,YK,M,0,0,0,0,2,1,3
West Yorkshire,AA,F,152,144,63,66,57,294,776
West Yorkshire,AA,M,176,99,13,13,7,25,333
West Yorkshire,AAX,F,485,478,237,185,137,797,"2,319"
West Yorkshire,AAX,M,462,307,24,8,5,35,841
West Yorkshire,AN,F,0,0,0,0,0,1,1
West Yorkshire,AY,F,16,18,50,37,29,222,372
West Yorkshire,AY,M,4,8,12,0,0,9,33
West Yorkshire,AYX,F,6,0,2,2,1,23,34
West Yorkshire,AYX,M,4,4,3,2,0,2,15
West Yorkshire,BA,F,20,24,6,6,6,53,115
West Yorkshire,BA,M,19,19,14,11,7,20,90
West Yorkshire,BABX,F,0,0,0,0,0,6,6
West Yorkshire,BAL,F,4,0,0,0,0,0,4
West Yorkshire,BAL,M,0,0,1,0,0,1,2
West Yorkshire,BALX,F,11,18,0,0,0,0,29
West Yorkshire,BALX,M,2,2,0,0,0,0,4
West Yorkshire,BARX,F,0,0,0,0,0,4,4
West Yorkshire,BAWX,F,0,0,0,0,0,1,1
West Yorkshire,BAX,F,558,403,106,118,92,484,"1,761"
West Yorkshire,BAX,M,601,243,34,1,3,40,922
West Yorkshire,BAZ,F,0,1,0,0,0,2,3
West Yorkshire,BAZX,F,3,3,1,1,0,1,9
West Yorkshire,BAZX,M,2,2,0,0,0,0,4
West Yorkshire,BB,F,145,157,83,50,39,175,649
West Yorkshire,BB,M,152,119,41,16,6,57,391
West Yorkshire,BBX,F,"1,351","1,104",460,289,272,972,"4,448"
West Yorkshire,BBX,M,"1,513",814,126,14,4,89,"2,560"
West Yorkshire,BF,F,382,499,594,576,571,969,"3,591"
West Yorkshire,BF,M,357,278,121,23,14,10,803
West Yorkshire,BFX,F,63,25,40,32,25,99,284
West Yorkshire,BFX,M,72,17,11,5,0,6,111
West Yorkshire,BG,F,9,4,5,5,3,23,49
West Yorkshire,BG,M,8,7,2,1,0,1,19
West Yorkshire,BGX,F,4,11,3,1,1,7,27
West Yorkshire,BGX,M,4,3,0,1,0,0,8
West Yorkshire,BH,F,0,0,0,0,0,155,155
West Yorkshire,BHX,F,0,0,0,0,0,15,15
West Yorkshire,BLG,F,16,10,14,2,0,27,69
West Yorkshire,BLG,M,14,0,0,0,0,0,14
West Yorkshire,BLGX,F,0,0,0,0,0,1,1
West Yorkshire,BLP,F,0,0,0,0,0,1,1
West Yorkshire,BR,F,0,0,1,0,0,0,1
West Yorkshire,BRX,F,1,1,0,0,0,0,2
West Yorkshire,BRX,M,2,1,0,0,0,0,3
West Yorkshire,BS,F,0,0,0,1,0,0,1
West Yorkshire,BS,M,0,0,1,0,0,0,1
West Yorkshire,BSH,F,30,12,13,11,2,37,105
West Yorkshire,BSH,M,20,9,0,1,1,1,32
West Yorkshire,BSHX,F,38,20,6,1,0,2,67
West Yorkshire,BSHX,M,39,20,0,0,0,0,59
West Yorkshire,BSX,F,0,2,3,17,8,11,41
West Yorkshire,BSX,M,1,5,3,2,0,0,11
West Yorkshire,BU,F,0,0,0,0,0,2,2
West Yorkshire,BU,M,0,0,0,0,0,1,1
West Yorkshire,BW,F,0,0,0,1,1,6,8
West Yorkshire,BW,M,0,3,1,0,0,0,4
West Yorkshire,BWX,F,0,0,0,0,1,2,3
West Yorkshire,CAX,F,0,0,0,0,0,9,9
West Yorkshire,CAX,M,0,0,0,0,0,3,3
West Yorkshire,CB,F,17,3,3,4,0,50,77
West Yorkshire,CB,M,8,7,0,2,0,0,17
West Yorkshire,CD,F,0,0,0,0,0,9,9
West Yorkshire,CH,F,142,171,91,97,76,435,"1,012"
West Yorkshire,CH,M,157,110,25,11,14,71,388
West Yorkshire,CHL,F,0,0,1,0,0,0,1
West Yorkshire,CHLX,M,0,0,1,0,0,0,1
West Yorkshire,CHX,F,725,661,146,98,129,778,"2,537"
West Yorkshire,CHX,M,590,347,65,6,3,89,"1,100"
West Yorkshire,CON,F,0,0,0,0,0,3,3
West Yorkshire,DEV,F,0,0,0,0,0,1,1
West Yorkshire,DEVX,F,0,1,0,0,0,3,4
West Yorkshire,DEX,F,44,32,36,36,12,59,219
West Yorkshire,DEX,M,40,35,4,1,2,10,92
West Yorkshire,DEXX,F,2,5,1,1,1,1,11
West Yorkshire,DEXX,M,2,3,0,0,0,0,5
West Yorkshire,DS,F,23,3,19,23,17,31,116
West Yorkshire,DS,M,13,2,2,0,0,0,17
West Yorkshire,DSHO,F,0,0,0,0,0,5,5
West Yorkshire,DSHO,M,1,0,0,0,0,0,1
West Yorkshire,DSX,F,9,0,2,5,9,15,40
West Yorkshire,DSX,M,2,0,0,0,0,0,2
West Yorkshire,DV,F,0,0,0,0,0,9,9
West Yorkshire,DVX,F,0,0,0,0,0,2,2
West Yorkshire,DVX,M,0,0,0,0,0,1,1
West Yorkshire,FR,F,0,0,0,0,0,"3,202","3,202"
West Yorkshire,FR,M,0,0,0,0,0,109,109
West Yorkshire,FRX,F,0,1,0,0,0,160,161
West Yorkshire,FRX,M,0,0,0,0,0,18,18
West Yorkshire,GA,F,0,1,1,11,5,47,65
West Yorkshire,GA,M,0,0,1,0,0,1,2
West Yorkshire,GAS,F,1,0,0,0,0,5,6
West Yorkshire,GAS,M,0,0,1,0,0,1,2
West Yorkshire,GASX,F,12,12,3,3,2,1,33
West Yorkshire,GASX,M,7,3,1,0,0,0,11
West Yorkshire,GAX,F,1,7,11,9,3,42,73
West Yorkshire,GAX,M,4,11,0,1,2,0,18
West Yorkshire,GBX,F,0,1,0,0,0,1,2
West Yorkshire,GBX,M,1,0,0,0,0,0,1
West Yorkshire,GE,F,0,0,1,0,0,0,1
West Yorkshire,GE,M,0,1,0,0,0,0,1
West Yorkshire,GEX,F,1,4,1,1,4,3,14
West Yorkshire,GEX,M,1,5,0,0,0,0,6
West Yorkshire,GL,F,5,3,2,4,2,5,21
West Yorkshire,GL,M,3,3,0,0,0,1,7
West Yorkshire,GLX,F,0,0,0,0,1,0,1
West Yorkshire,GLX,M,0,1,0,0,0,0,1
West Yorkshire,GU,F,0,0,0,3,6,2,11
West Yorkshire,GUX,F,1,0,1,0,0,0,2
West Yorkshire,GUX,M,0,1,0,0,0,0,1
West Yorkshire,H,F,0,0,0,0,0,71,71
West Yorkshire,H,M,0,0,0,0,0,5,5
West Yorkshire,HE,F,38,57,28,29,23,73,248
West Yorkshire,HE,M,60,38,9,5,5,2,119
West Yorkshire,HEBL,F,0,0,0,0,0,4,4
West Yorkshire,HEBLX,F,0,0,0,0,0,41,41
West Yorkshire,HER,F,0,0,0,0,0,3,3
West Yorkshire,HERX,F,0,0,0,0,0,19,19
West Yorkshire,HERX,M,0,0,0,0,0,2,2
West Yorkshire,HEX,F,259,216,100,63,63,279,980
West Yorkshire,HEX,M,401,235,18,1,0,15,670
West Yorkshire,HF,F,"1,618","1,602","1,718","1,516","1,314","2,588","10,356"
West Yorkshire,HF,M,"1,047",795,238,29,13,28,"2,150"
West Yorkshire,HFX,F,53,43,70,81,58,129,434
West Yorkshire,HFX,M,80,60,11,2,0,2,155
West Yorkshire,HI,F,50,55,56,53,35,201,450
West Yorkshire,HI,M,51,63,59,30,9,31,243
West Yorkshire,HIX,F,12,3,1,1,0,9,26
West Yorkshire,HIX,M,8,1,2,4,0,2,17
West Yorkshire,HL,F,0,0,0,0,0,6,6
West Yorkshire,HLX,F,0,0,0,0,0,1,1
West Yorkshire,HO,F,411,345,295,365,299,542,"2,257"
West Yorkshire,HO,M,247,117,43,7,2,9,425
West Yorkshire,HOX,F,9,6,2,5,10,32,64
West Yorkshire,HOX,M,8,8,2,1,0,1,20
West Yorkshire,HX,F,0,0,0,0,0,160,160
West Yorkshire,HX,M,0,0,0,0,0,19,19
West Yorkshire,IM,F,6,4,3,3,4,12,32
West Yorkshire,IM,M,5,2,1,1,0,0,9
West Yorkshire,IMX,F,0,0,0,1,0,0,1
West Yorkshire,JE,F,9,9,8,8,12,45,91
West Yorkshire,JE,M,1,1,2,0,0,1,5
West Yorkshire,JEX,F,58,14,11,2,4,12,101
West Yorkshire,JEX,M,3,19,2,0,0,0,24
West Yorkshire,KE,F,0,2,0,3,1,10,16
West Yorkshire,KE,M,5,2,0,0,0,0,7
West Yorkshire,LH,F,29,31,22,18,13,46,159
West Yorkshire,LH,M,16,15,1,0,0,6,38
West Yorkshire,LHX,F,29,61,10,5,4,7,116
West Yorkshire,LHX,M,8,8,0,0,0,2,18
West Yorkshire,LI,F,0,0,0,0,0,129,129
West Yorkshire,LI,M,0,0,0,0,0,33,33
West Yorkshire,LIM,F,629,521,198,168,165,560,"2,241"
West Yorkshire,LIM,M,605,391,92,60,32,111,"1,291"
West Yorkshire,LIM X,F,0,0,0,0,0,2,2
West Yorkshire,LIMB,F,0,0,0,0,0,18,18
West Yorkshire,LIMB,M,0,0,0,0,0,1,1
West Yorkshire,LIMBX,F,0,0,0,0,0,98,98
West Yorkshire,LIMBX,M,0,0,0,0,0,1,1
West Yorkshire,LIMR,F,0,0,0,0,0,54,54
West Yorkshire,LIMR,M,0,0,0,0,0,10,10
West Yorkshire,LIMRX,F,0,0,0,0,0,83,83
West Yorkshire,LIMRX,M,0,0,0,0,0,3,3
West Yorkshire,LIMX,F,"2,897","2,632",820,619,474,"1,873","9,315"
West Yorkshire,LIMX,M,"2,974","1,892",357,42,19,75,"5,359"
West Yorkshire,LIX,F,0,0,0,0,0,655,655
West Yorkshire,LIX,M,0,0,0,0,0,142,142
West Yorkshire,LM,F,0,0,0,0,0,12,12
West Yorkshire,LM,M,0,0,0,0,0,2,2
West Yorkshire,LMX,F,0,0,0,0,0,19,19
West Yorkshire,LMX,M,0,0,0,0,0,2,2
West Yorkshire,LR,F,4,0,2,0,1,4,11
West Yorkshire,LR,M,0,2,2,0,0,0,4
West Yorkshire,LRX,F,0,0,0,1,0,2,3
West Yorkshire,LRX,M,1,0,0,0,0,0,1
West Yorkshire,LU,F,0,3,0,0,0,4,7
West Yorkshire,LU,M,0,0,1,0,0,0,1
West Yorkshire,LUX,F,0,0,0,0,0,4,4
West Yorkshire,LUX,M,0,0,0,0,0,1,1
West Yorkshire,MAR,F,0,0,0,0,1,3,4
West Yorkshire,MAR,M,0,0,0,0,0,1,1
West Yorkshire,MARX,F,0,1,0,0,0,2,3
West Yorkshire,MAX,F,0,0,0,0,0,4,4
West Yorkshire,MG,F,0,0,0,0,0,2,2
West Yorkshire,MGX,F,0,0,0,0,0,4,4
West Yorkshire,MGX,M,1,0,0,0,0,0,1
West Yorkshire,MO,F,13,9,7,3,7,14,53
West Yorkshire,MO,M,8,4,3,0,1,0,16
West Yorkshire,MOX,F,21,13,5,7,3,9,58
West Yorkshire,MOX,M,10,8,0,1,0,0,19
West Yorkshire,MRI,F,58,59,48,66,59,133,423
West Yorkshire,MRI,M,26,19,14,0,0,0,59
West Yorkshire,MRIX,F,17,17,9,21,21,34,119
West Yorkshire,MRIX,M,18,22,3,0,2,0,45
West Yorkshire,NO,F,0,0,0,0,0,1,1
West Yorkshire,NOX,F,0,0,0,0,0,3,3
West Yorkshire,NOX,M,0,1,0,0,0,4,5
West Yorkshire,NRX,F,4,0,4,0,0,0,8
West Yorkshire,NRX,M,5,0,0,0,0,0,5
West Yorkshire,NS,F,0,0,0,0,0,292,292
West Yorkshire,OB,F,0,0,0,0,0,1,1
West Yorkshire,OE,F,0,0,0,0,0,1,1
West Yorkshire,PA,F,2,2,1,1,1,6,13
West Yorkshire,PA,M,0,0,1,1,0,2,4
West Yorkshire,PAX,F,23,20,3,5,4,13,68
West Yorkshire,PAX,M,19,10,0,0,0,0,29
West Yorkshire,PI,F,0,1,0,2,1,9,13
West Yorkshire,PI,M,1,0,0,0,0,1,2
West Yorkshire,PINX,M,0,0,0,0,0,1,1
West Yorkshire,PIX,F,23,23,2,1,0,16,65
West Yorkshire,PIX,M,20,16,2,0,0,5,43
West Yorkshire,RO,M,0,0,0,0,0,1,1
West Yorkshire,ROX,F,0,0,0,0,0,1,1
West Yorkshire,RP,F,12,9,4,2,5,14,46
West Yorkshire,RP,M,12,12,2,0,1,0,27
West Yorkshire,RPX,F,6,11,2,0,1,5,25
West Yorkshire,RPX,M,9,5,0,0,0,0,14
West Yorkshire,RWFR,F,1,0,0,0,0,2,3
West Yorkshire,SA,F,16,11,17,23,8,32,107
West Yorkshire,SA,M,16,2,4,0,0,7,29
West Yorkshire,SAX,F,69,55,11,15,34,87,271
West Yorkshire,SAX,M,65,38,1,0,0,5,109
West Yorkshire,SB,F,0,0,0,0,0,1,1
West Yorkshire,SBX,M,1,0,0,0,0,0,1
West Yorkshire,SD,F,42,46,22,10,10,62,192
West Yorkshire,SD,M,52,17,2,1,1,3,76
West Yorkshire,SDX,F,22,14,13,3,1,19,72
West Yorkshire,SDX,M,8,8,3,0,0,0,19
West Yorkshire,SH,F,3,2,2,5,0,8,20
West Yorkshire,SH,M,6,8,1,0,0,1,16
West Yorkshire,SHO,F,14,8,8,11,8,79,128
West Yorkshire,SHO,M,24,30,4,1,0,6,65
West Yorkshire,SHOX,F,39,39,15,4,11,90,198
West Yorkshire,SHOX,M,49,17,4,0,0,1,71
West Yorkshire,SHX,F,0,1,0,0,0,2,3
West Yorkshire,SHX,M,1,0,0,0,0,0,1
West Yorkshire,SM,F,141,130,77,63,41,251,703
West Yorkshire,SM,M,143,72,28,15,12,29,299
West Yorkshire,SMX,F,645,656,232,154,206,903,"2,796"
West Yorkshire,SMX,M,654,461,80,6,4,55,"1,260"
West Yorkshire,SRW,F,5,1,1,0,1,1,9
West Yorkshire,SRW,M,1,0,0,0,0,0,1
West Yorkshire,SRWX,F,12,5,10,7,6,5,45
West Yorkshire,SRWX,M,10,4,1,0,0,0,15
West Yorkshire,ST,F,38,9,1,0,13,0,61
West Yorkshire,ST,M,21,4,0,1,0,0,26
West Yorkshire,STX,F,15,45,2,2,0,0,64
West Yorkshire,STX,M,22,8,0,0,0,0,30
West Yorkshire,SU,F,3,4,2,1,0,6,16
West Yorkshire,SU,M,1,1,0,0,0,0,2
West Yorkshire,SUX,F,1,0,0,0,2,3,6
West Yorkshire,SUX,M,1,2,0,0,0,2,5
West Yorkshire,VA,F,6,3,4,3,5,9,30
West Yorkshire,VA,M,1,2,1,1,0,1,6
West Yorkshire,WB,F,1,2,2,0,1,9,15
West Yorkshire,WB,M,0,2,0,0,0,0,2
West Yorkshire,WBX,F,3,1,5,3,0,11,23
West Yorkshire,WBX,M,1,3,0,0,0,0,4
West Yorkshire,WGX,F,0,0,1,0,0,0,1
West Yorkshire,WGX,M,0,0,1,0,0,0,1
West Yorkshire,WP,F,9,6,2,2,3,8,30
West Yorkshire,WP,M,4,5,0,0,0,0,9
West Yorkshire,WPX,F,5,4,3,3,0,1,16
West Yorkshire,WPX,M,3,0,1,0,0,0,4
West Yorkshire,WS,M,0,1,0,0,0,1,2
West Yorkshire,WSX,F,0,35,0,0,1,2,38
West Yorkshire,WSX,M,0,1,0,0,0,0,1
North Yorkshire,AA,F,22,34,23,15,21,70,185
North Yorkshire,AA,M,46,33,17,2,1,6,105
North Yorkshire,AAX,F,144,164,42,18,30,111,509
North Yorkshire,AAX,M,185,100,12,0,0,6,303
North Yorkshire,AR,F,1,0,0,0,0,0,1
North Yorkshire,AY,F,0,0,1,0,0,7,8
North Yorkshire,AY,M,22,2,1,0,0,0,25
North Yorkshire,AYX,F,1,1,0,3,0,1,6
North Yorkshire,AYX,M,0,1,2,0,0,0,3
North Yorkshire,BA,F,18,20,9,3,9,32,91
North Yorkshire,BA,M,8,9,5,0,1,11,34
North Yorkshire,BARX,F,0,0,0,0,0,1,1
North Yorkshire,BARX,M,0,0,0,0,0,1,1
North Yorkshire,BAX,F,106,140,30,14,16,68,374
North Yorkshire,BAX,M,136,99,16,2,3,7,263
North Yorkshire,BAZ,M,0,1,0,0,1,0,2
North Yorkshire,BAZX,F,7,5,2,0,0,0,14
North Yorkshire,BAZX,M,4,4,1,0,0,0,9
North Yorkshire,BB,F,23,39,30,11,9,36,148
North Yorkshire,BB,M,26,20,3,4,1,7,61
North Yorkshire,BBX,F,228,296,122,43,26,107,822
North Yorkshire,BBX,M,256,175,62,5,2,12,512
North Yorkshire,BF,F,31,29,47,39,40,91,277
North Yorkshire,BF,M,294,244,145,6,1,2,692
North Yorkshire,BFX,F,2,0,1,0,1,6,10
North Yorkshire,BFX,M,79,45,29,1,0,0,154
North Yorkshire,BG,F,2,0,0,1,0,2,5
North Yorkshire,BG,M,1,0,0,1,0,0,2
North Yorkshire,BGX,F,0,0,0,0,0,1,1
North Yorkshire,BGX,M,1,1,0,0,0,0,2
North Yorkshire,BH,F,0,0,0,0,0,3,3
North Yorkshire,BH,M,1,0,0,0,0,2,3
North Yorkshire,BHX,F,0,0,0,0,0,1,1
North Yorkshire,BLG,F,0,0,0,0,10,1,11
North Yorkshire,BR,F,0,0,0,0,1,0,1
North Yorkshire,BR,M,0,0,1,0,0,0,1
North Yorkshire,BRX,F,0,0,0,0,1,0,1
North Yorkshire,BS,M,0,2,0,0,0,0,2
North Yorkshire,BSH,F,3,3,3,2,3,3,17
North Yorkshire,BSH,M,4,0,0,0,1,0,5
North Yorkshire,BSHX,F,1,2,1,0,1,1,6
North Yorkshire,BSHX,M,1,3,0,0,0,0,4
North Yorkshire,BSX,F,0,0,0,0,2,1,3
North Yorkshire,BSX,M,1,15,6,0,0,0,22
North Yorkshire,BW,F,7,2,3,0,2,5,19
North Yorkshire,BW,M,0,0,1,0,0,0,1
North Yorkshire,CB,F,0,1,0,0,0,0,1
North Yorkshire,CH,F,26,57,11,6,5,65,170
North Yorkshire,CH,M,19,26,12,4,1,14,76
North Yorkshire,CHIX,F,0,0,0,0,0,1,1
North Yorkshire,CHX,F,224,463,61,35,16,196,995
North Yorkshire,CHX,M,133,163,84,1,1,11,393
North Yorkshire,DEVX,F,0,2,1,0,0,0,3
North Yorkshire,DEX,F,10,8,8,9,5,9,49
North Yorkshire,DEX,M,13,6,6,2,0,4,31
North Yorkshire,DEXX,F,0,0,1,1,0,1,3
North Yorkshire,DEXX,M,1,0,0,0,0,0,1
North Yorkshire,DS,F,37,42,49,33,23,87,271
North Yorkshire,DS,M,1,1,0,0,0,1,3
North Yorkshire,DSHO,F,11,0,0,0,0,8,19
North Yorkshire,DSX,F,0,0,0,0,0,1,1
North Yorkshire,DSX,M,1,0,1,0,0,0,2
North Yorkshire,FR,F,0,0,0,0,0,348,348
North Yorkshire,FR,M,0,0,0,0,0,71,71
North Yorkshire,FRX,F,0,0,0,0,0,16,16
North Yorkshire,FRX,M,0,0,0,0,0,12,12
North Yorkshire,GA,F,1,0,0,1,0,1,3
North Yorkshire,GA,M,2,0,0,0,0,0,2
North Yorkshire,GASX,F,3,0,0,0,0,0,3
North Yorkshire,GASX,M,3,0,0,0,0,0,3
North Yorkshire,GAX,F,2,4,0,1,7,2,16
North Yorkshire,GAX,M,2,1,0,0,0,0,3
North Yorkshire,GE,M,0,1,0,0,0,0,1
North Yorkshire,GEX,F,0,3,0,0,0,0,3
North Yorkshire,GU,M,0,12,0,0,0,0,12
North Yorkshire,H,F,0,0,0,0,0,12,12
North Yorkshire,HE,F,3,2,1,0,1,10,17
North Yorkshire,HE,M,5,4,1,2,1,1,14
North Yorkshire,HEBL,F,0,0,0,0,0,3,3
North Yorkshire,HEBLX,F,0,0,0,0,0,8,8
North Yorkshire,HER,F,0,0,0,0,0,6,6
North Yorkshire,HERX,F,0,0,0,0,0,4,4
North Yorkshire,HEX,F,101,54,23,11,15,68,272
North Yorkshire,HEX,M,112,61,14,0,0,1,188
North Yorkshire,HF,F,238,218,263,226,158,356,"1,459"
North Yorkshire,HF,M,"1,317",639,262,39,2,3,"2,262"
North Yorkshire,HFX,F,3,1,0,3,1,15,23
North Yorkshire,HFX,M,67,51,16,2,0,2,138
North Yorkshire,HI,F,7,3,0,4,1,22,37
North Yorkshire,HI,M,4,2,0,1,1,1,9
North Yorkshire,HIX,F,1,1,3,2,0,1,8
North Yorkshire,HIX,M,3,0,0,1,0,1,5
North Yorkshire,HL,F,0,0,0,0,0,1,1
North Yorkshire,HO,F,1,2,4,12,17,60,96
North Yorkshire,HO,M,190,97,29,3,0,16,335
North Yorkshire,HOX,F,1,0,0,0,0,6,7
North Yorkshire,HOX,M,3,4,1,1,0,0,9
North Yorkshire,HX,F,0,0,0,0,0,23,23
North Yorkshire,HX,M,0,0,0,0,0,2,2
North Yorkshire,IM,F,2,1,1,1,1,3,9
North Yorkshire,IM,M,1,0,0,1,0,0,2
North Yorkshire,JE,F,92,76,57,55,62,213,555
North Yorkshire,JE,M,26,0,0,2,0,0,28
North Yorkshire,JEX,F,0,0,0,0,2,2,4
North Yorkshire,JEX,M,5,1,0,1,0,0,7
North Yorkshire,KEX,F,0,0,0,0,0,1,1
North Yorkshire,LH,F,3,2,1,9,1,3,19
North Yorkshire,LH,M,3,2,0,0,0,0,5
North Yorkshire,LHX,F,1,3,2,0,0,2,8
North Yorkshire,LHX,M,0,3,1,0,0,2,6
North Yorkshire,LI,F,0,0,0,0,0,29,29
North Yorkshire,LI,M,0,0,0,0,0,9,9
North Yorkshire,LIM,F,93,155,50,13,29,60,400
North Yorkshire,LIM,M,118,94,35,5,3,22,277
North Yorkshire,LIMBX,F,0,0,0,0,0,12,12
North Yorkshire,LIMBX,M,0,0,0,0,0,1,1
North Yorkshire,LIMR,M,0,0,0,0,0,1,1
North Yorkshire,LIMRX,F,0,0,0,0,0,10,10
North Yorkshire,LIMRX,M,0,0,0,0,0,1,1
North Yorkshire,LIMX,F,836,"1,217",285,97,91,344,"2,870"
North Yorkshire,LIMX,M,831,855,251,10,3,11,"1,961"
North Yorkshire,LIX,F,0,0,0,0,0,91,91
North Yorkshire,LIX,M,0,0,0,0,0,29,29
North Yorkshire,LMX,F,0,0,0,0,0,3,3
North Yorkshire,LRX,F,1,1,1,0,0,0,3
North Yorkshire,LRX,M,1,0,0,0,0,0,1
North Yorkshire,MGX,F,0,0,0,0,0,3,3
North Yorkshire,MGX,M,4,0,0,0,0,0,4
North Yorkshire,MO,F,0,0,2,0,0,0,2
North Yorkshire,MO,M,2,5,0,0,0,0,7
North Yorkshire,MOX,F,1,2,3,1,0,0,7
North Yorkshire,MOX,M,8,4,1,0,0,0,13
North Yorkshire,MRI,M,1,6,0,0,0,0,7
North Yorkshire,MRIX,F,3,0,0,2,3,2,10
North Yorkshire,MRIX,M,30,14,1,0,0,2,47
North Yorkshire,NOX,M,1,0,0,0,0,0,1
North Yorkshire,NRX,M,5,0,1,0,0,0,6
North Yorkshire,NS,F,0,0,0,0,0,24,24
North Yorkshire,NS,M,0,0,0,0,0,1,1
North Yorkshire,PAX,F,1,2,0,0,0,0,3
North Yorkshire,PAX,M,0,1,0,0,0,0,1
North Yorkshire,PI,F,0,0,0,1,0,0,1
North Yorkshire,PIX,F,2,0,0,1,0,5,8
North Yorkshire,PIX,M,0,2,0,0,0,0,2
North Yorkshire,ROX,F,0,1,0,0,1,0,2
North Yorkshire,RP,F,1,0,3,2,1,2,9
North Yorkshire,RP,M,3,0,1,0,0,0,4
North Yorkshire,SA,F,0,0,3,1,7,28,39
North Yorkshire,SA,M,0,4,0,0,0,4,8
North Yorkshire,SAX,F,0,2,14,9,11,26,62
North Yorkshire,SAX,M,4,4,1,0,1,1,11
North Yorkshire,SD,F,12,1,1,0,0,6,20
North Yorkshire,SD,M,0,1,1,0,0,0,2
North Yorkshire,SDX,F,3,13,1,0,2,1,20
North Yorkshire,SDX,M,1,4,0,0,0,0,5
North Yorkshire,SH,F,0,0,1,0,0,0,1
North Yorkshire,SH,M,0,1,0,0,0,0,1
North Yorkshire,SHO,F,7,2,0,1,3,45,58
North Yorkshire,SHO,M,50,7,2,2,0,1,62
North Yorkshire,SHOX,F,0,3,0,0,1,4,8
North Yorkshire,SHOX,M,4,3,3,2,0,0,12
North Yorkshire,SM,F,51,82,16,9,16,76,250
North Yorkshire,SM,M,33,27,6,5,1,15,87
North Yorkshire,SMX,F,185,271,70,32,58,179,795
North Yorkshire,SMX,M,190,164,29,3,0,18,404
North Yorkshire,SRWX,F,4,4,5,1,0,0,14
North Yorkshire,SRWX,M,27,5,1,1,0,0,34
North Yorkshire,ST,M,1,0,0,0,0,0,1
North Yorkshire,STX,F,4,6,0,0,0,0,10
North Yorkshire,STX,M,35,6,0,0,0,0,41
North Yorkshire,SU,F,0,0,0,0,0,1,1
North Yorkshire,SUX,F,1,0,0,0,0,1,2
North Yorkshire,WB,F,0,0,1,0,0,0,1
North Yorkshire,WB,M,0,1,2,0,0,0,3
North Yorkshire,WBX,F,1,4,4,0,0,1,10
North Yorkshire,WBX,M,1,0,2,0,0,0,3
North Yorkshire,WP,F,1,0,0,0,1,0,2
North Yorkshire,WP,M,1,0,1,0,0,0,2
North Yorkshire,WPX,M,0,2,0,0,0,0,2
North Yorkshire,WSX,F,0,0,0,0,0,1,1
North Yorkshire,WW,F,0,1,0,0,0,0,1
East Yorks & Humberside,AA,F,94,85,46,28,58,145,456
East Yorks & Humberside,AA,M,103,47,5,8,5,8,176
East Yorks & Humberside,AAX,F,328,301,141,94,91,643,"1,598"
East Yorks & Humberside,AAX,M,378,304,29,2,1,27,741
East Yorks & Humberside,AM,F,0,1,0,0,0,0,1
East Yorks & Humberside,AY,F,0,0,2,0,0,7,9
East Yorks & Humberside,AY,M,2,0,1,0,0,0,3
East Yorks & Humberside,AYX,F,1,0,0,1,0,1,3
East Yorks & Humberside,AYX,M,0,1,1,0,0,0,2
East Yorks & Humberside,BA,F,62,49,28,20,16,135,310
East Yorks & Humberside,BA,M,74,26,3,8,6,25,142
East Yorks & Humberside,BAB,F,0,0,0,0,0,1,1
East Yorks & Humberside,BABX,F,0,0,0,0,0,4,4
East Yorks & Humberside,BAL,M,0,0,0,0,0,1,1
East Yorks & Humberside,BALX,F,0,1,0,0,0,0,1
East Yorks & Humberside,BALX,M,0,1,0,0,0,0,1
East Yorks & Humberside,BARX,F,0,0,0,0,0,5,5
East Yorks & Humberside,BAWX,F,0,0,0,0,0,3,3
East Yorks & Humberside,BAX,F,536,420,95,105,94,361,"1,611"
East Yorks & Humberside,BAX,M,583,418,34,1,3,30,"1,069"
East Yorks & Humberside,BAZ,F,0,1,0,0,0,2,3
East Yorks & Humberside,BAZ,M,0,1,0,0,0,0,1
East Yorks & Humberside,BAZX,F,6,5,12,4,0,0,27
East Yorks & Humberside,BAZX,M,9,11,0,0,0,0,20
East Yorks & Humberside,BB,F,80,69,30,9,14,104,306
East Yorks & Humberside,BB,M,125,88,6,9,1,27,256
East Yorks & Humberside,BBX,F,722,684,195,134,122,622,"2,479"
East Yorks & Humberside,BBX,M,"1,243",796,71,6,3,44,"2,163"
East Yorks & Humberside,BF,F,209,178,165,194,245,406,"1,397"
East Yorks & Humberside,BF,M,401,161,34,17,2,7,622
East Yorks & Humberside,BFX,F,30,14,12,16,18,31,121
East Yorks & Humberside,BFX,M,83,27,1,1,1,1,114
East Yorks & Humberside,BG,F,6,1,0,2,1,12,22
East Yorks & Humberside,BG,M,8,2,1,0,0,1,12
East Yorks & Humberside,BGX,F,0,0,0,0,1,0,1
East Yorks & Humberside,BH,F,0,0,0,0,0,64,64
East Yorks & Humberside,BHX,F,0,0,0,0,0,2,2
East Yorks & Humberside,BHX,M,4,0,0,0,0,0,4
East Yorks & Humberside,BLG,F,0,0,0,0,0,1,1
East Yorks & Humberside,BLPX,F,0,0,0,0,0,1,1
East Yorks & Humberside,BR,F,0,0,1,0,0,0,1
East Yorks & Humberside,BRX,F,1,1,0,0,0,1,3
East Yorks & Humberside,BS,F,3,2,2,7,0,0,14
East Yorks & Humberside,BS,M,9,3,3,0,0,2,17
East Yorks & Humberside,BSH,F,8,17,10,8,3,5,51
East Yorks & Humberside,BSH,M,11,12,5,0,0,3,31
East Yorks & Humberside,BSHX,F,7,16,4,0,2,3,32
East Yorks & Humberside,BSHX,M,9,6,0,0,0,0,15
East Yorks & Humberside,BSX,F,4,11,5,3,8,6,37
East Yorks & Humberside,BSX,M,19,10,0,0,0,0,29
East Yorks & Humberside,BW,F,3,0,0,0,1,5,9
East Yorks & Humberside,BW,M,1,0,0,0,0,0,1
East Yorks & Humberside,BWX,F,1,2,0,0,0,6,9
East Yorks & Humberside,BX,F,0,0,0,0,0,6,6
East Yorks & Humberside,CAX,F,0,0,0,0,0,2,2
East Yorks & Humberside,CB,F,2,1,0,0,0,21,24
East Yorks & Humberside,CB,M,1,0,0,0,0,0,1
East Yorks & Humberside,CD,F,0,1,0,0,0,0,1
East Yorks & Humberside,CD,M,1,0,0,0,0,0,1
East Yorks & Humberside,CH,F,164,111,68,58,55,353,809
East Yorks & Humberside,CH,M,162,108,29,12,10,52,373
East Yorks & Humberside,CHX,F,834,983,158,118,107,766,"2,966"
East Yorks & Humberside,CHX,M,951,957,88,6,3,91,"2,096"
East Yorks & Humberside,CON,F,0,0,0,0,0,4,4
East Yorks & Humberside,CON,M,0,0,0,0,0,1,1
East Yorks & Humberside,DEV,F,0,0,0,0,0,1,1
East Yorks & Humberside,DEVX,F,1,3,5,2,0,0,11
East Yorks & Humberside,DEVX,M,0,16,3,0,0,0,19
East Yorks & Humberside,DEX,F,27,27,24,15,9,55,157
East Yorks & Humberside,DEX,M,32,23,7,3,0,7,72
East Yorks & Humberside,DEXX,F,1,1,2,0,0,0,4
East Yorks & Humberside,DS,F,10,15,14,2,0,2,43
East Yorks & Humberside,DS,M,1,1,1,0,0,1,4
East Yorks & Humberside,DSX,F,0,2,2,0,0,0,4
East Yorks & Humberside,DSX,M,1,0,0,0,0,1,2
East Yorks & Humberside,DV,F,0,0,0,0,0,7,7
East Yorks & Humberside,DVX,F,0,0,0,0,0,14,14
East Yorks & Humberside,DVX,M,0,0,0,0,0,3,3
East Yorks & Humberside,FR,F,0,0,0,1,0,"1,264","1,265"
East Yorks & Humberside,FR,M,0,0,0,0,0,66,66
East Yorks & Humberside,FRX,F,0,0,0,0,0,50,50
East Yorks & Humberside,FRX,M,0,0,0,0,0,13,13
East Yorks & Humberside,GA,F,5,4,5,1,5,12,32
East Yorks & Humberside,GA,M,2,5,3,0,0,0,10
East Yorks & Humberside,GAX,F,0,13,12,14,13,46,98
East Yorks & Humberside,GAX,M,1,4,0,0,0,0,5
East Yorks & Humberside,GBX,F,0,2,1,0,0,0,3
East Yorks & Humberside,GE,F,1,5,0,0,1,0,7
East Yorks & Humberside,GE,M,2,6,0,0,0,0,8
East Yorks & Humberside,GEX,F,0,4,0,0,2,1,7
East Yorks & Humberside,GEX,M,1,7,0,0,0,0,8
East Yorks & Humberside,GU,F,2,0,0,0,4,0,6
East Yorks & Humberside,GU,M,1,0,0,0,0,0,1
East Yorks & Humberside,H,F,0,0,0,0,0,27,27
East Yorks & Humberside,H,M,0,0,0,0,0,3,3
East Yorks & Humberside,HE,F,34,27,23,21,11,21,137
East Yorks & Humberside,HE,M,21,11,8,0,0,2,42
East Yorks & Humberside,HEBL,F,0,0,0,0,0,2,2
East Yorks & Humberside,HEBLX,F,0,0,0,0,0,11,11
East Yorks & Humberside,HER,F,0,0,0,0,0,2,2
East Yorks & Humberside,HERX,F,0,0,0,0,0,14,14
East Yorks & Humberside,HEX,F,133,150,83,72,52,205,695
East Yorks & Humberside,HEX,M,159,137,26,4,3,6,335
East Yorks & Humberside,HF,F,791,789,814,643,545,"1,351","4,933"
East Yorks & Humberside,HF,M,"1,526",830,187,57,57,47,"2,704"
East Yorks & Humberside,HFX,F,28,27,97,77,72,139,440
East Yorks & Humberside,HFX,M,54,65,10,2,1,2,134
East Yorks & Humberside,HI,F,15,18,12,10,15,86,156
East Yorks & Humberside,HI,M,21,11,4,3,4,7,50
East Yorks & Humberside,HIX,F,5,1,0,0,1,4,11
East Yorks & Humberside,HIX,M,1,2,0,0,0,0,3
East Yorks & Humberside,HL,F,0,0,0,0,0,4,4
East Yorks & Humberside,HL,M,0,0,0,0,0,1,1
East Yorks & Humberside,HO,F,167,157,143,146,131,140,884
East Yorks & Humberside,HO,M,192,59,11,8,1,2,273
East Yorks & Humberside,HOX,F,2,0,3,0,2,2,9
East Yorks & Humberside,HOX,M,6,2,1,1,0,1,11
East Yorks & Humberside,HX,F,0,0,0,0,0,83,83
East Yorks & Humberside,HX,M,0,0,0,0,0,4,4
East Yorks & Humberside,IM,F,0,0,0,0,0,1,1
East Yorks & Humberside,JE,F,67,45,26,17,25,51,231
East Yorks & Humberside,JE,M,4,4,1,0,0,0,9
East Yorks & Humberside,JEX,F,0,3,0,1,0,2,6
East Yorks & Humberside,JEX,M,5,4,0,0,0,0,9
East Yorks & Humberside,JY,F,8,0,0,0,0,0,8
East Yorks & Humberside,JY,M,2,0,0,0,0,0,2
East Yorks & Humberside,LH,F,9,11,1,4,9,9,43
East Yorks & Humberside,LH,M,4,4,1,3,0,1,13
East Yorks & Humberside,LHX,F,14,4,5,0,2,8,33
East Yorks & Humberside,LHX,M,11,2,0,0,0,0,13
East Yorks & Humberside,LI,F,0,0,0,0,0,221,221
East Yorks & Humberside,LI,M,0,0,0,0,0,55,55
East Yorks & Humberside,LIM,F,630,615,207,173,247,783,"2,655"
East Yorks & Humberside,LIM,M,730,488,72,49,37,88,"1,464"
East Yorks & Humberside,LIM X,F,0,0,0,0,0,1,1
East Yorks & Humberside,LIMB,F,0,0,0,0,0,8,8
East Yorks & Humberside,LIMBX,F,0,0,0,0,0,78,78
East Yorks & Humberside,LIMBX,M,0,0,0,0,0,4,4
East Yorks & Humberside,LIMR,F,0,0,0,0,0,37,37
East Yorks & Humberside,LIMR,M,0,0,0,0,0,4,4
East Yorks & Humberside,LIMRX,F,0,0,0,0,0,59,59
East Yorks & Humberside,LIMRX,M,0,0,0,0,0,1,1
East Yorks & Humberside,LIMX,F,"2,728","2,813",720,405,399,"1,551","8,616"
East Yorks & Humberside,LIMX,M,"3,388","2,520",204,11,6,39,"6,168"
East Yorks & Humberside,LIX,F,0,0,0,0,0,438,438
East Yorks & Humberside,LIX,M,0,0,0,0,0,95,95
East Yorks & Humberside,LM,F,0,0,0,0,0,13,13
East Yorks & Humberside,LM,M,0,0,0,0,0,1,1
East Yorks & Humberside,LMX,F,0,0,0,0,0,10,10
East Yorks & Humberside,LR,F,0,7,0,1,1,8,17
East Yorks & Humberside,LR,M,2,0,0,0,0,0,2
East Yorks & Humberside,LRX,F,11,7,2,0,0,9,29
East Yorks & Humberside,LRX,M,5,0,0,0,0,0,5
East Yorks & Humberside,MG,F,0,0,0,0,0,5,5
East Yorks & Humberside,MGX,F,0,0,0,3,0,2,5
East Yorks & Humberside,MGX,M,7,0,0,0,0,0,7
East Yorks & Humberside,MO,M,2,16,1,0,0,0,19
East Yorks & Humberside,MOX,F,20,2,2,0,1,0,25
East Yorks & Humberside,MOX,M,40,11,2,0,0,0,53
East Yorks & Humberside,MRI,F,3,1,2,1,0,7,14
East Yorks & Humberside,MRI,M,9,10,3,0,0,0,22
East Yorks & Humberside,MRIX,F,15,20,18,16,20,33,122
East Yorks & Humberside,MRIX,M,12,10,4,0,0,0,26
East Yorks & Humberside,NO,F,0,0,0,0,0,1,1
East Yorks & Humberside,NOX,F,0,0,0,0,0,1,1
East Yorks & Humberside,NOX,M,0,0,0,0,0,1,1
East Yorks & Humberside,NRX,M,4,0,0,0,0,0,4
East Yorks & Humberside,NS,F,0,0,0,0,0,185,185
East Yorks & Humberside,PA,F,5,5,1,1,0,3,15
East Yorks & Humberside,PA,M,4,2,0,0,0,1,7
East Yorks & Humberside,PAX,F,16,27,3,4,0,12,62
East Yorks & Humberside,PAX,M,22,28,0,0,0,0,50
East Yorks & Humberside,PI,F,9,1,6,4,5,16,41
East Yorks & Humberside,PI,M,4,3,1,0,0,3,11
East Yorks & Humberside,PIX,F,3,3,1,3,11,52,73
East Yorks & Humberside,PIX,M,6,1,2,0,0,3,12
East Yorks & Humberside,ROX,F,1,0,0,3,0,1,5
East Yorks & Humberside,RP,F,37,22,8,10,6,58,141
East Yorks & Humberside,RP,M,22,13,0,0,0,3,38
East Yorks & Humberside,RWFR,F,0,0,0,0,0,1,1
East Yorks & Humberside,SA,F,0,0,2,0,0,18,20
East Yorks & Humberside,SA,M,0,7,2,0,1,4,14
East Yorks & Humberside,SAX,F,58,69,40,51,46,129,393
East Yorks & Humberside,SAX,M,69,26,0,0,0,0,95
East Yorks & Humberside,SBX,F,0,0,0,1,2,0,3
East Yorks & Humberside,SD,F,22,23,10,14,15,31,115
East Yorks & Humberside,SD,M,34,119,17,0,1,1,172
East Yorks & Humberside,SDX,F,48,47,12,8,22,29,166
East Yorks & Humberside,SDX,M,49,57,8,0,0,0,114
East Yorks & Humberside,SGX,M,1,0,0,0,0,0,1
East Yorks & Humberside,SH,F,2,1,2,1,0,2,8
East Yorks & Humberside,SH,M,1,1,1,0,0,0,3
East Yorks & Humberside,SHO,F,3,8,18,6,3,14,52
East Yorks & Humberside,SHO,M,28,12,9,0,0,1,50
East Yorks & Humberside,SHOX,F,2,3,0,2,0,4,11
East Yorks & Humberside,SHOX,M,15,4,1,1,0,0,21
East Yorks & Humberside,SHX,F,2,1,0,0,0,1,4
East Yorks & Humberside,SM,F,130,93,49,53,53,414,792
East Yorks & Humberside,SM,M,166,114,16,5,6,39,346
East Yorks & Humberside,SMX,F,640,529,207,161,214,"1,114","2,865"
East Yorks & Humberside,SMX,M,930,660,56,18,4,51,"1,719"
East Yorks & Humberside,SRWX,F,0,0,0,1,2,0,3
East Yorks & Humberside,SRWX,M,6,1,0,0,0,0,7
East Yorks & Humberside,ST,F,120,76,65,15,14,27,317
East Yorks & Humberside,ST,M,120,12,7,2,3,1,145
East Yorks & Humberside,STX,F,180,82,86,26,16,12,402
East Yorks & Humberside,STX,M,180,199,0,0,0,0,379
East Yorks & Humberside,SU,F,0,5,1,1,0,5,12
East Yorks & Humberside,SU,M,4,2,0,0,0,1,7
East Yorks & Humberside,SUX,F,0,2,0,3,1,1,7
East Yorks & Humberside,SUX,M,3,0,0,0,0,0,3
East Yorks & Humberside,WB,F,0,0,0,0,0,5,5
East Yorks & Humberside,WB,M,0,0,2,0,0,0,2
East Yorks & Humberside,WBX,F,0,5,0,2,0,0,7
East Yorks & Humberside,WBX,M,0,5,1,0,0,1,7
East Yorks & Humberside,WP,F,5,3,1,0,1,8,18
East Yorks & Humberside,WP,M,3,2,2,0,0,0,7
East Yorks & Humberside,WPX,F,0,0,0,0,0,2,2
East Yorks & Humberside,WSX,F,0,5,0,0,3,0,8
East Yorks & Humberside,WSX,M,3,0,0,0,0,0,3
Powys,AA,F,130,90,79,73,79,394,845
Powys,AA,M,101,53,12,11,3,25,205
Powys,AAX,F,602,372,255,249,205,"1,131","2,814"
Powys,AAX,M,488,204,43,2,0,30,767
Powys,ARX,F,0,0,0,0,0,1,1
Powys,AY,F,24,19,33,28,29,72,205
Powys,AY,M,2,3,1,0,0,0,6
Powys,AYX,F,2,1,3,1,0,2,9
Powys,BA,F,99,60,23,17,18,133,350
Powys,BA,M,86,30,15,13,9,50,203
Powys,BABX,F,0,0,0,0,0,15,15
Powys,BALX,F,0,1,0,0,0,0,1
Powys,BAR,F,0,0,0,0,0,3,3
Powys,BARX,F,0,0,0,0,0,27,27
Powys,BAW,F,0,0,0,0,0,1,1
Powys,BAWX,F,0,0,0,0,0,8,8
Powys,BAX,F,936,610,194,134,156,779,"2,809"
Powys,BAX,M,877,454,71,4,2,24,"1,432"
Powys,BAZ,F,0,0,8,0,0,1,9
Powys,BAZX,F,0,1,2,1,0,2,6
Powys,BB,F,188,162,129,153,123,711,"1,466"
Powys,BB,M,160,64,32,23,14,57,350
Powys,BBX,F,"1,801","1,487",975,987,865,"3,564","9,679"
Powys,BBX,M,"1,570",861,154,6,6,77,"2,674"
Powys,BF,F,426,425,614,696,581,"1,135","3,877"
Powys,BF,M,326,221,67,11,7,9,641
Powys,BFX,F,23,33,103,28,17,57,261
Powys,BFX,M,33,8,3,0,0,0,44
Powys,BG,F,3,8,2,7,0,20,40
Powys,BG,M,3,7,3,0,0,0,13
Powys,BGX,F,0,0,0,0,3,7,10
Powys,BGX,M,0,0,0,0,0,1,1
Powys,BH,F,9,0,0,0,0,236,245
Powys,BH,M,16,0,0,0,0,1,17
Powys,BHX,F,0,0,0,0,0,9,9
Powys,BLG,F,0,0,0,0,0,25,25
Powys,BPX,F,1,0,0,0,0,0,1
Powys,BR,M,0,0,1,0,0,0,1
Powys,BRX,F,0,0,1,0,0,1,2
Powys,BS,F,0,0,0,3,2,17,22
Powys,BS,M,2,6,2,0,0,0,10
Powys,BSH,F,25,10,7,8,13,27,90
Powys,BSH,M,15,10,3,3,1,0,32
Powys,BSHX,F,12,26,13,4,2,12,69
Powys,BSHX,M,17,13,2,0,0,0,32
Powys,BSX,F,1,2,2,8,6,43,62
Powys,BSX,M,8,12,2,0,0,0,22
Powys,BU,F,15,29,0,2,8,59,113
Powys,BU,M,26,23,0,0,2,0,51
Powys,BW,F,15,2,15,12,11,48,103
Powys,BW,M,14,9,1,2,0,2,28
Powys,BWB,F,0,0,0,0,0,1,1
Powys,BWB,M,0,1,0,0,0,0,1
Powys,BWX,F,9,3,2,1,0,17,32
Powys,BWX,M,7,0,0,0,0,1,8
Powys,CAX,F,0,0,0,0,0,2,2
Powys,CB,F,0,0,0,0,0,131,131
Powys,CD,F,0,0,0,0,0,11,11
Powys,CH,F,533,420,184,119,125,"1,211","2,592"
Powys,CH,M,583,429,161,112,99,567,"1,951"
Powys,CHIX,F,0,0,0,0,0,2,2
Powys,CHIX,M,1,0,0,0,0,1,2
Powys,CHL,F,0,2,0,0,0,0,2
Powys,CHL,M,1,1,0,0,0,0,2
Powys,CHX,F,"9,912","5,690",953,536,505,"4,743","22,339"
Powys,CHX,M,"10,645","5,236",642,62,23,765,"17,373"
Powys,DE,F,0,0,0,0,0,1,1
Powys,DEV,F,10,5,13,2,2,19,51
Powys,DEV,M,3,9,6,0,1,1,20
Powys,DEVX,F,7,7,3,1,1,9,28
Powys,DEVX,M,10,5,0,0,0,0,15
Powys,DEX,F,47,34,30,28,15,91,245
Powys,DEX,M,32,47,6,1,2,6,94
Powys,DEXX,F,4,2,6,1,1,5,19
Powys,DEXX,M,3,2,1,0,0,1,7
Powys,DR,F,0,1,13,15,0,28,57
Powys,DRX,F,0,0,5,0,0,0,5
Powys,DS,F,1,0,5,3,2,31,42
Powys,DS,M,2,2,1,0,0,0,5
Powys,DSX,F,0,0,1,0,0,1,2
Powys,DSX,M,3,2,0,0,0,0,5
Powys,DV,F,0,0,0,0,0,15,15
Powys,DVX,F,0,0,0,0,0,7,7
Powys,DVX,M,0,0,0,0,0,3,3
Powys,EFBX,F,0,0,0,0,0,1,1
Powys,FR,F,0,0,0,0,0,"4,256","4,256"
Powys,FR,M,0,0,0,0,0,29,29
Powys,FRX,F,0,0,0,0,0,93,93
Powys,FRX,M,0,0,0,0,0,4,4
Powys,GA,F,11,20,23,8,10,74,146
Powys,GA,M,8,5,0,0,1,10,24
Powys,GASX,F,4,5,0,0,2,1,12
Powys,GAX,F,0,0,1,1,0,2,4
Powys,GAX,M,0,1,0,0,0,0,1
Powys,GB,F,1,0,0,0,0,0,1
Powys,GB,M,1,0,0,0,0,0,1
Powys,GE,F,0,0,0,0,0,6,6
Powys,GE,M,0,2,0,0,0,0,2
Powys,GEX,F,1,0,1,2,2,12,18
Powys,GEX,M,1,6,0,0,0,0,7
Powys,GL,F,1,3,0,1,3,0,8
Powys,GL,M,2,0,0,0,0,0,2
Powys,GLX,F,0,0,0,0,0,2,2
Powys,GU,F,2,0,1,1,1,10,15
Powys,GUX,F,0,0,0,0,0,2,2
Powys,H,F,0,0,0,0,0,514,514
Powys,H,M,0,0,0,0,0,22,22
Powys,HE,F,281,175,186,179,158,452,"1,431"
Powys,HE,M,269,134,48,10,13,21,495
Powys,HEBL,F,0,0,0,0,0,35,35
Powys,HEBLX,F,0,0,0,0,0,399,399
Powys,HEBLX,M,0,0,0,0,0,3,3
Powys,HER,F,0,0,0,0,0,25,25
Powys,HERX,F,0,0,0,0,0,89,89
Powys,HEX,F,781,741,552,699,761,"4,250","7,784"
Powys,HEX,M,556,407,86,2,2,5,"1,058"
Powys,HF,F,"2,967","2,690","2,588","2,264","1,980","3,745","16,234"
Powys,HF,M,"1,239",638,79,19,0,14,"1,989"
Powys,HFX,F,66,60,78,83,63,250,600
Powys,HFX,M,21,17,2,0,0,0,40
Powys,HI,F,22,21,14,14,13,56,140
Powys,HI,M,18,12,3,1,0,13,47
Powys,HIX,F,5,0,2,0,2,12,21
Powys,HIX,M,6,0,1,1,0,0,8
Powys,HL,M,0,0,0,0,0,3,3
Powys,HO,F,355,322,295,241,254,532,"1,999"
Powys,HO,M,80,33,19,7,7,7,153
Powys,HOX,F,7,5,7,10,11,35,75
Powys,HOX,M,4,2,1,0,0,0,7
Powys,HX,F,0,0,0,0,0,"1,588","1,588"
Powys,HX,M,0,0,0,0,0,25,25
Powys,IM,F,0,0,0,0,0,1,1
Powys,IMX,F,0,0,0,0,0,1,1
Powys,IMX,M,0,0,0,0,0,1,1
Powys,JE,F,32,35,25,28,19,98,237
Powys,JE,M,8,0,0,1,0,2,11
Powys,JEX,F,12,40,2,18,92,6,170
Powys,JEX,M,3,5,2,0,0,0,10
Powys,JY,F,16,0,0,0,0,0,16
Powys,JY,M,7,0,0,0,0,0,7
Powys,KEX,F,0,0,2,0,0,0,2
Powys,LH,F,12,12,10,10,8,31,83
Powys,LH,M,13,15,6,2,1,3,40
Powys,LHX,F,5,3,4,1,0,13,26
Powys,LHX,M,3,6,4,0,0,1,14
Powys,LI,F,0,0,0,0,0,"1,089","1,089"
Powys,LI,M,0,0,0,0,0,163,163
Powys,LIM,F,"2,412","1,719",837,774,732,"2,945","9,419"
Powys,LIM,M,"2,361","1,038",182,147,98,417,"4,243"
Powys,LIM X,F,0,0,0,0,0,85,85
Powys,LIM X,M,0,0,0,0,0,8,8
Powys,LIMB,F,0,0,0,0,0,71,71
Powys,LIMB,M,0,0,0,0,0,2,2
Powys,LIMBX,F,0,0,0,0,0,680,680
Powys,LIMBX,M,0,0,0,0,0,2,2
Powys,LIMR,F,0,0,0,0,0,146,146
Powys,LIMR,M,0,0,0,0,0,6,6
Powys,LIMRX,F,0,0,0,0,0,310,310
Powys,LIMRX,M,0,0,0,0,0,7,7
Powys,LIMX,F,"11,913","8,064","3,082","2,755","2,979","12,513","41,306"
Powys,LIMX,M,"11,780","5,923",927,66,24,160,"18,880"
Powys,LIX,F,0,0,0,0,0,"3,745","3,745"
Powys,LIX,M,0,0,0,0,0,294,294
Powys,LM,F,0,0,0,0,0,24,24
Powys,LM,M,0,0,0,0,0,4,4
Powys,LMX,F,0,0,0,0,0,43,43
Powys,LR,F,1,0,0,0,0,1,2
Powys,LR,M,0,0,1,1,0,1,3
Powys,LRX,F,19,20,27,13,19,4,102
Powys,LRX,M,34,10,0,0,0,1,45
Powys,LU,F,10,6,11,15,1,22,65
Powys,LU,M,7,0,0,0,0,0,7
Powys,LUX,F,1,0,1,2,0,2,6
Powys,LUX,M,0,1,0,0,0,0,1
Powys,MARX,F,0,0,0,1,0,2,3
Powys,MG,F,22,11,7,5,8,24,77
Powys,MG,M,21,10,1,0,0,1,33
Powys,MGX,F,10,7,1,2,6,16,42
Powys,MGX,M,5,6,0,0,0,0,11
Powys,MO,F,1,3,0,1,6,4,15
Powys,MO,M,5,4,2,1,0,0,12
Powys,MOX,F,58,44,14,1,1,3,121
Powys,MOX,M,57,20,2,0,0,0,79
Powys,MRI,F,14,15,6,11,4,24,74
Powys,MRI,M,31,34,6,0,0,1,72
Powys,MRIX,F,60,36,14,24,40,109,283
Powys,MRIX,M,59,55,13,3,0,0,130
Powys,ND,F,0,0,0,0,0,1,1
Powys,NO,F,7,1,0,0,0,0,8
Powys,NO,M,3,0,0,0,0,0,3
Powys,NOX,F,5,10,16,22,15,16,84
Powys,NOX,M,5,0,0,0,0,0,5
Powys,NRX,F,7,0,0,0,0,0,7
Powys,NS,F,0,0,0,0,0,762,762
Powys,NS,M,0,0,0,0,0,6,6
Powys,PAX,F,0,0,2,0,3,5,10
Powys,PI,F,2,1,1,3,2,6,15
Powys,PI,M,5,1,0,0,2,3,11
Powys,PIX,F,83,55,8,6,4,31,187
Powys,PIX,M,66,34,4,1,0,0,105
Powys,ROTX,F,0,0,0,0,0,2,2
Powys,ROX,F,0,0,0,0,0,11,11
Powys,ROX,M,0,0,1,0,0,0,1
Powys,RP,F,1,0,1,0,3,26,31
Powys,RP,M,2,5,1,0,0,0,8
Powys,RPX,F,2,0,1,0,3,9,15
Powys,RPX,M,2,2,0,0,0,0,4
Powys,RWFR,F,0,0,0,0,0,1,1
Powys,SA,F,85,92,41,18,48,126,410
Powys,SA,M,85,115,5,2,4,9,220
Powys,SAX,F,199,183,93,108,124,599,"1,306"
Powys,SAX,M,179,91,12,0,0,14,296
Powys,SD,F,51,32,18,29,29,131,290
Powys,SD,M,38,17,5,3,0,3,66
Powys,SDX,F,33,25,9,9,7,49,132
Powys,SDX,M,34,17,1,0,0,0,52
Powys,SH,F,4,2,3,2,2,5,18
Powys,SH,M,2,0,0,0,0,1,3
Powys,SHO,F,9,8,10,5,3,48,83
Powys,SHO,M,7,11,3,0,0,2,23
Powys,SHOX,F,11,13,3,3,12,62,104
Powys,SHOX,M,6,4,1,0,0,2,13
Powys,SHX,F,0,0,1,1,0,4,6
Powys,SHX,M,2,0,2,0,0,0,4
Powys,SM,F,91,106,74,70,63,236,640
Powys,SM,M,115,49,19,9,10,24,226
Powys,SMX,F,548,558,283,291,298,"1,548","3,526"
Powys,SMX,M,647,414,89,3,1,30,"1,184"
Powys,SOB,F,0,0,0,0,0,1,1
Powys,SRW,F,8,7,1,0,1,0,17
Powys,SRW,M,11,3,1,0,0,0,15
Powys,SRWX,F,21,10,5,1,0,0,37
Powys,SRWX,M,9,2,0,0,0,0,11
Powys,ST,F,19,22,9,9,0,1,60
Powys,ST,M,11,8,2,0,0,0,21
Powys,STX,F,0,0,10,0,0,8,18
Powys,SU,F,0,0,0,0,0,1,1
Powys,SUX,F,0,9,0,0,0,3,12
Powys,SUX,M,0,10,0,0,0,0,10
Powys,WB,F,548,453,328,385,338,"1,918","3,970"
Powys,WB,M,514,420,90,25,4,61,"1,114"
Powys,WBX,F,98,94,46,67,84,418,807
Powys,WBX,M,104,95,11,0,1,14,225
Powys,WGX,F,0,1,0,0,0,0,1
Powys,WP,F,2,2,0,3,1,8,16
Powys,WP,M,2,3,2,0,0,0,7
Powys,WPX,F,0,0,0,0,0,1,1
Powys,WS,F,0,3,0,2,0,6,11
Powys,WS,M,1,1,1,0,0,1,4
Powys,WSX,F,17,5,25,30,29,99,205
Powys,WSX,M,9,4,0,0,0,4,17
Powys,WW,F,0,0,0,0,0,4,4
Powys,WWX,F,0,0,0,0,0,2,2
Powys,WWX,M,0,0,1,0,0,0,1
Powys,ZE,F,0,0,0,0,0,3,3
Gwynedd,AA,F,54,73,39,26,18,72,282
Gwynedd,AA,M,39,60,9,3,6,15,132
Gwynedd,AAX,F,296,265,132,124,99,390,"1,306"
Gwynedd,AAX,M,258,243,30,5,1,11,548
Gwynedd,AM,F,0,0,0,0,0,1,1
Gwynedd,ARX,F,0,1,0,0,0,0,1
Gwynedd,ARX,M,1,1,0,0,0,0,2
Gwynedd,AY,F,48,59,55,40,28,113,343
Gwynedd,AY,M,16,11,1,0,1,3,32
Gwynedd,AYX,F,0,2,0,3,2,11,18
Gwynedd,AYX,M,1,2,0,0,0,1,4
Gwynedd,BA,F,25,31,9,4,14,59,142
Gwynedd,BA,M,15,28,10,3,2,18,76
Gwynedd,BAB,F,0,0,0,0,0,2,2
Gwynedd,BABX,F,0,0,0,0,0,18,18
Gwynedd,BABX,M,0,0,0,0,0,2,2
Gwynedd,BALX,M,0,0,1,0,0,0,1
Gwynedd,BARX,F,0,0,0,0,0,7,7
Gwynedd,BAWX,F,0,0,0,0,0,1,1
Gwynedd,BAX,F,367,304,120,76,77,357,"1,301"
Gwynedd,BAX,M,358,287,67,3,3,16,734
Gwynedd,BAZ,M,0,0,0,0,1,0,1
Gwynedd,BAZX,F,6,7,4,0,0,1,18
Gwynedd,BAZX,M,14,3,0,0,0,0,17
Gwynedd,BB,F,138,152,95,81,65,401,932
Gwynedd,BB,M,129,140,63,8,3,32,375
Gwynedd,BBX,F,"1,260","1,017",573,451,441,"1,547","5,289"
Gwynedd,BBX,M,"1,317","1,100",236,11,3,49,"2,716"
Gwynedd,BF,F,462,478,669,620,650,"1,019","3,898"
Gwynedd,BF,M,358,446,238,27,10,21,"1,100"
Gwynedd,BFX,F,32,43,67,104,58,58,362
Gwynedd,BFX,M,35,56,28,4,1,1,125
Gwynedd,BG,F,1,1,0,1,0,2,5
Gwynedd,BG,M,0,1,0,0,0,0,1
Gwynedd,BGX,F,3,0,0,2,0,3,8
Gwynedd,BGX,M,1,1,0,0,0,0,2
Gwynedd,BH,F,1,0,0,0,0,111,112
Gwynedd,BH,M,0,0,0,0,0,2,2
Gwynedd,BHX,F,0,0,0,0,0,18,18
Gwynedd,BLG,F,0,1,0,0,0,1,2
Gwynedd,BLGX,F,0,0,0,0,0,1,1
Gwynedd,BP,F,0,0,0,0,1,0,1
Gwynedd,BR,F,1,0,0,0,0,0,1
Gwynedd,BRX,F,0,0,0,1,0,1,2
Gwynedd,BRX,M,0,0,1,0,0,0,1
Gwynedd,BS,F,1,3,10,1,1,17,33
Gwynedd,BS,M,1,3,1,0,0,0,5
Gwynedd,BSH,F,27,20,6,6,5,6,70
Gwynedd,BSH,M,22,12,1,0,1,1,37
Gwynedd,BSHX,F,9,12,1,0,0,1,23
Gwynedd,BSHX,M,6,14,0,0,0,0,20
Gwynedd,BSX,F,0,1,0,4,2,16,23
Gwynedd,BSX,M,2,4,6,0,0,0,12
Gwynedd,BU,F,1,0,0,0,0,0,1
Gwynedd,BU,M,0,0,0,1,0,2,3
Gwynedd,BW,F,1,0,0,2,0,7,10
Gwynedd,BW,M,1,0,0,1,0,3,5
Gwynedd,BWB,F,0,1,1,0,0,3,5
Gwynedd,BWB,M,2,0,0,0,0,0,2
Gwynedd,BWX,F,1,1,0,0,0,10,12
Gwynedd,BWX,M,0,4,0,0,0,0,4
Gwynedd,BX,F,0,0,0,0,0,3,3
Gwynedd,BX,M,0,0,0,0,0,1,1
Gwynedd,CAX,F,0,0,0,0,0,2,2
Gwynedd,CB,F,1,0,10,3,1,101,116
Gwynedd,CB,M,1,0,5,0,0,0,6
Gwynedd,CD,F,0,0,0,0,1,5,6
Gwynedd,CH,F,673,642,183,153,105,901,"2,657"
Gwynedd,CH,M,668,615,142,91,86,342,"1,944"
Gwynedd,CHIX,F,2,0,0,0,0,0,2
Gwynedd,CHIX,M,5,0,0,0,0,0,5
Gwynedd,CHL,F,1,0,0,0,0,0,1
Gwynedd,CHL,M,1,1,0,0,0,0,2
Gwynedd,CHLX,F,3,0,0,0,0,0,3
Gwynedd,CHLX,M,1,0,0,0,0,0,1
Gwynedd,CHX,F,"6,250","4,441",758,372,329,"2,541","14,691"
Gwynedd,CHX,M,"6,404","4,847",554,56,24,339,"12,224"
Gwynedd,DEV,F,0,0,1,0,0,1,2
Gwynedd,DEVX,F,0,1,0,0,0,2,3
Gwynedd,DEX,F,15,23,13,18,12,43,124
Gwynedd,DEX,M,23,19,5,1,1,14,63
Gwynedd,DEXX,F,1,3,1,0,0,2,7
Gwynedd,DEXX,M,0,1,0,0,0,1,2
Gwynedd,DS,F,0,0,0,4,3,2,9
Gwynedd,DSX,F,0,0,0,2,0,1,3
Gwynedd,DSX,M,0,1,0,0,0,0,1
Gwynedd,FR,F,0,0,0,0,0,"3,476","3,476"
Gwynedd,FR,M,0,0,0,0,0,133,133
Gwynedd,FRX,F,0,0,0,0,0,121,121
Gwynedd,FRX,M,0,0,0,0,0,16,16
Gwynedd,GA,F,0,0,0,0,0,3,3
Gwynedd,GA,M,0,1,0,0,0,0,1
Gwynedd,GAX,F,0,1,1,0,0,3,5
Gwynedd,GAX,M,0,1,2,0,0,0,3
Gwynedd,GB,M,0,1,0,0,0,0,1
Gwynedd,GBX,F,0,1,0,1,0,0,2
Gwynedd,GBX,M,0,1,1,0,0,1,3
Gwynedd,GEX,F,0,4,0,0,3,8,15
Gwynedd,GEX,M,0,2,0,0,0,0,2
Gwynedd,GL,F,0,0,0,1,0,0,1
Gwynedd,GL,M,1,0,0,0,0,0,1
Gwynedd,GLX,F,0,0,0,0,0,4,4
Gwynedd,GU,F,0,0,2,3,0,7,12
Gwynedd,GUX,F,0,0,1,0,1,0,2
Gwynedd,GUX,M,0,1,0,0,0,1,2
Gwynedd,H,F,0,0,0,0,0,203,203
Gwynedd,H,M,0,0,0,0,0,9,9
Gwynedd,HE,F,55,58,31,18,37,155,354
Gwynedd,HE,M,46,43,14,3,7,9,122
Gwynedd,HEBL,F,0,0,0,0,0,7,7
Gwynedd,HEBLX,F,0,0,0,0,0,123,123
Gwynedd,HEBLX,M,0,0,0,0,0,2,2
Gwynedd,HER,F,0,0,0,0,0,21,21
Gwynedd,HER,M,0,0,0,0,0,1,1
Gwynedd,HERX,F,0,0,0,0,0,86,86
Gwynedd,HEX,F,502,412,331,273,348,"1,363","3,229"
Gwynedd,HEX,M,499,412,64,7,4,13,999
Gwynedd,HF,F,"1,585","1,364","1,799","1,578","1,488","3,421","11,235"
Gwynedd,HF,M,818,857,395,65,19,82,"2,236"
Gwynedd,HFX,F,48,64,75,38,75,125,425
Gwynedd,HFX,M,60,48,21,2,0,4,135
Gwynedd,HI,F,5,9,14,3,5,27,63
Gwynedd,HI,M,7,8,4,3,3,9,34
Gwynedd,HIX,F,3,1,0,0,0,15,19
Gwynedd,HIX,M,2,0,0,0,0,2,4
Gwynedd,HL,F,0,0,0,0,0,3,3
Gwynedd,HO,F,142,187,142,132,152,342,"1,097"
Gwynedd,HO,M,66,60,21,8,6,8,169
Gwynedd,HOX,F,2,0,4,8,15,30,59
Gwynedd,HOX,M,2,0,0,0,0,0,2
Gwynedd,HX,F,0,0,0,0,0,740,740
Gwynedd,HX,M,0,0,0,0,0,38,38
Gwynedd,IMX,F,0,0,0,0,0,1,1
Gwynedd,JE,F,225,245,219,480,313,95,"1,577"
Gwynedd,JE,M,34,15,2,10,2,1,64
Gwynedd,JEX,F,99,54,58,46,18,6,281
Gwynedd,JEX,M,21,42,2,0,0,0,65
Gwynedd,LH,F,1,0,4,0,0,11,16
Gwynedd,LH,M,2,0,1,0,0,0,3
Gwynedd,LHX,F,3,10,0,0,1,8,22
Gwynedd,LHX,M,5,6,1,0,0,0,12
Gwynedd,LI,F,0,0,0,0,0,475,475
Gwynedd,LI,M,0,0,0,0,0,97,97
Gwynedd,LIM,F,"1,255","1,130",577,550,482,"1,839","5,833"
Gwynedd,LIM,M,"1,210",995,224,91,62,268,"2,850"
Gwynedd,LIMB,F,0,0,0,0,0,33,33
Gwynedd,LIMB,M,0,0,0,0,0,1,1
Gwynedd,LIMBX,F,0,0,0,0,0,421,421
Gwynedd,LIMBX,M,0,0,0,0,0,10,10
Gwynedd,LIMR,F,0,0,0,0,0,48,48
Gwynedd,LIMR,M,0,0,0,0,0,4,4
Gwynedd,LIMRX,F,0,0,0,0,0,134,134
Gwynedd,LIMRX,M,0,0,0,0,0,5,5
Gwynedd,LIMX,F,"6,682","4,935","2,085","1,813","1,841","6,370","23,726"
Gwynedd,LIMX,M,"6,677","5,659",948,93,36,177,"13,590"
Gwynedd,LIX,F,0,0,0,0,0,"2,108","2,108"
Gwynedd,LIX,M,0,0,0,0,0,316,316
Gwynedd,LM,F,0,0,0,0,0,15,15
Gwynedd,LM,M,0,0,0,0,0,9,9
Gwynedd,LMX,F,0,0,0,0,0,33,33
Gwynedd,LRX,F,1,0,1,0,0,0,2
Gwynedd,LRX,M,1,0,0,0,0,0,1
Gwynedd,LU,M,0,5,0,0,0,0,5
Gwynedd,MAX,F,0,0,0,0,0,1,1
Gwynedd,MG,F,1,1,0,0,0,2,4
Gwynedd,MG,M,0,0,2,0,2,2,6
Gwynedd,MGX,F,1,1,10,5,1,18,36
Gwynedd,MGX,M,1,0,0,0,0,0,1
Gwynedd,MO,F,13,8,6,5,9,23,64
Gwynedd,MO,M,5,12,5,4,2,0,28
Gwynedd,MOX,F,124,59,39,12,12,19,265
Gwynedd,MOX,M,137,48,17,0,0,0,202
Gwynedd,MRI,F,5,28,30,27,18,43,151
Gwynedd,MRI,M,17,26,4,3,1,4,55
Gwynedd,MRIX,F,23,9,15,7,20,129,203
Gwynedd,MRIX,M,24,24,4,0,3,12,67
Gwynedd,NOX,F,0,0,0,0,0,2,2
Gwynedd,NRX,F,2,0,0,0,0,0,2
Gwynedd,NS,F,0,0,0,0,0,635,635
Gwynedd,NS,M,0,0,0,0,0,2,2
Gwynedd,OEX,F,0,0,1,0,0,0,1
Gwynedd,PA,F,0,0,0,0,0,1,1
Gwynedd,PAX,F,0,0,0,2,2,2,6
Gwynedd,PAX,M,0,1,0,0,0,0,1
Gwynedd,PI,F,3,2,2,1,0,10,18
Gwynedd,PI,M,0,1,0,1,0,3,5
Gwynedd,PIX,F,2,3,1,3,4,22,35
Gwynedd,PIX,M,3,1,2,1,0,2,9
Gwynedd,ROX,F,0,0,0,0,0,1,1
Gwynedd,RP,F,0,0,0,0,0,1,1
Gwynedd,RPX,F,1,0,3,0,0,4,8
Gwynedd,RWFR,F,0,0,0,0,0,1,1
Gwynedd,SA,F,28,24,14,28,10,110,214
Gwynedd,SA,M,37,22,5,3,2,17,86
Gwynedd,SAX,F,264,277,146,129,91,381,"1,288"
Gwynedd,SAX,M,274,231,38,7,0,8,558
Gwynedd,SD,F,0,5,2,0,0,4,11
Gwynedd,SD,M,0,1,0,0,0,0,1
Gwynedd,SDX,F,0,1,9,17,13,10,50
Gwynedd,SDX,M,0,12,0,1,0,1,14
Gwynedd,SH,F,4,2,2,4,1,2,15
Gwynedd,SH,M,0,6,0,0,0,0,6
Gwynedd,SHO,F,3,3,11,2,7,59,85
Gwynedd,SHO,M,5,7,1,0,0,2,15
Gwynedd,SHOX,F,0,23,19,14,1,19,76
Gwynedd,SHOX,M,3,32,4,0,0,1,40
Gwynedd,SHX,F,0,0,0,3,1,1,5
Gwynedd,SHX,M,1,1,0,0,0,0,2
Gwynedd,SM,F,68,91,21,47,30,275,532
Gwynedd,SM,M,67,98,16,5,3,46,235
Gwynedd,SMX,F,509,464,254,233,191,"1,205","2,856"
Gwynedd,SMX,M,523,622,107,6,4,72,"1,334"
Gwynedd,SOB,F,0,0,0,0,1,0,1
Gwynedd,SOB,M,1,0,0,0,0,0,1
Gwynedd,SOBX,F,1,0,0,0,0,1,2
Gwynedd,SRW,F,11,11,1,0,1,0,24
Gwynedd,SRW,M,14,5,0,0,0,1,20
Gwynedd,SRWX,F,23,8,7,6,0,2,46
Gwynedd,SRWX,M,17,14,0,0,0,1,32
Gwynedd,ST,F,43,73,22,20,0,1,159
Gwynedd,ST,M,41,57,7,9,1,2,117
Gwynedd,STX,F,350,240,128,112,50,15,895
Gwynedd,STX,M,389,183,3,0,1,1,577
Gwynedd,SU,F,0,0,2,0,0,1,3
Gwynedd,SU,M,1,0,0,0,0,0,1
Gwynedd,WA,F,14,24,10,6,10,13,77
Gwynedd,WA,M,9,14,7,0,0,2,32
Gwynedd,WAX,F,10,13,0,0,10,0,33
Gwynedd,WAX,M,1,7,0,0,0,0,8
Gwynedd,WB,F,"1,524","1,382",932,881,851,"4,684","10,254"
Gwynedd,WB,M,"1,547","1,193",245,53,34,169,"3,241"
Gwynedd,WBX,F,224,146,98,92,70,557,"1,187"
Gwynedd,WBX,M,220,170,24,5,4,36,459
Gwynedd,WG,F,0,0,1,1,0,3,5
Gwynedd,WG,M,1,0,0,0,0,0,1
Gwynedd,WGX,F,1,0,0,0,0,0,1
Gwynedd,WP,F,0,0,0,0,0,1,1
Gwynedd,WP,M,1,1,0,0,0,0,2
Gwynedd,WPX,F,0,0,0,0,1,1,2
Gwynedd,WS,F,0,0,1,0,0,0,1
Gwynedd,WSX,M,0,0,0,0,0,1,1
Gwynedd,WW,F,5,0,3,2,0,14,24
Gwynedd,WW,M,9,2,0,0,0,2,13
Gwynedd,WWX,F,3,0,1,0,1,0,5
Gwynedd,WWX,M,0,2,0,0,0,0,2
Dyfed,AA,F,445,413,132,127,90,496,"1,703"
Dyfed,AA,M,438,387,73,22,18,66,"1,004"
Dyfed,AAX,F,"1,119","1,050",368,139,209,889,"3,774"
Dyfed,AAX,M,"1,171","1,027",325,15,2,71,"2,611"
Dyfed,AR,F,0,0,1,1,0,2,4
Dyfed,AR,M,1,1,0,0,0,0,2
Dyfed,ARX,F,0,0,0,2,0,0,2
Dyfed,ARX,M,1,0,0,0,0,0,1
Dyfed,AUX,F,0,8,0,0,0,1,9
Dyfed,AY,F,249,272,202,202,214,655,"1,794"
Dyfed,AY,M,70,28,11,5,1,2,117
Dyfed,AYX,F,146,59,244,144,29,97,719
Dyfed,AYX,M,36,11,7,3,0,0,57
Dyfed,BA,F,148,127,60,30,33,170,568
Dyfed,BA,M,131,142,39,9,9,58,388
Dyfed,BAB,F,0,0,0,0,0,1,1
Dyfed,BABX,F,0,0,0,0,0,15,15
Dyfed,BAL,F,0,0,0,0,0,1,1
Dyfed,BAR,F,0,0,0,0,0,1,1
Dyfed,BARX,F,0,0,0,0,0,22,22
Dyfed,BAWX,F,0,0,0,0,0,1,1
Dyfed,BAX,F,754,470,185,130,147,722,"2,408"
Dyfed,BAX,M,690,465,126,8,1,83,"1,373"
Dyfed,BAZ,F,2,0,0,0,0,4,6
Dyfed,BAZ,M,1,0,1,0,0,1,3
Dyfed,BAZX,F,15,2,3,0,0,8,28
Dyfed,BAZX,M,23,3,0,0,0,0,26
Dyfed,BB,F,494,482,301,222,159,"1,024","2,682"
Dyfed,BB,M,496,473,192,38,21,143,"1,363"
Dyfed,BBX,F,"3,977","3,373","1,747","1,025",891,"3,184","14,197"
Dyfed,BBX,M,"4,208","3,371","1,065",32,10,179,"8,865"
Dyfed,BF,F,"7,556","8,019","9,214","8,888","8,571","12,215","54,463"
Dyfed,BF,M,"3,667","2,373","1,116",134,60,57,"7,407"
Dyfed,BFX,F,"1,239","1,078",906,776,756,"1,258","6,013"
Dyfed,BFX,M,422,239,96,17,5,14,793
Dyfed,BG,F,3,4,2,1,1,13,24
Dyfed,BG,M,2,5,1,0,0,1,9
Dyfed,BGX,F,12,8,4,16,2,8,50
Dyfed,BGX,M,11,8,3,2,0,0,24
Dyfed,BH,F,71,0,0,0,0,"1,029","1,100"
Dyfed,BH,M,21,0,0,0,0,4,25
Dyfed,BHX,F,9,0,0,0,0,150,159
Dyfed,BHX,M,9,0,0,0,0,1,10
Dyfed,BI,F,0,1,0,1,0,0,2
Dyfed,BI,M,0,1,0,0,0,0,1
Dyfed,BLG,F,0,0,4,2,8,17,31
Dyfed,BLGX,F,0,0,0,1,0,1,2
Dyfed,BP,F,0,0,0,0,0,1,1
Dyfed,BP,M,0,1,0,0,0,0,1
Dyfed,BR,F,0,0,0,1,0,1,2
Dyfed,BR,M,1,0,0,0,0,0,1
Dyfed,BRX,F,1,2,0,3,1,1,8
Dyfed,BRX,M,3,2,0,0,0,0,5
Dyfed,BS,F,146,122,152,113,80,292,905
Dyfed,BS,M,60,14,11,3,0,4,92
Dyfed,BSH,F,32,26,10,9,8,34,119
Dyfed,BSH,M,27,28,0,1,2,3,61
Dyfed,BSHO,F,0,0,0,0,0,1,1
Dyfed,BSHX,F,37,25,24,4,13,26,129
Dyfed,BSHX,M,48,46,6,1,0,0,101
Dyfed,BSX,F,138,91,116,82,109,402,938
Dyfed,BSX,M,48,35,6,3,0,5,97
Dyfed,BU,F,40,9,37,29,18,69,202
Dyfed,BU,M,35,12,2,0,2,17,68
Dyfed,BW,F,25,13,8,14,9,47,116
Dyfed,BW,M,22,10,3,2,1,3,41
Dyfed,BWB,F,7,10,5,6,6,29,63
Dyfed,BWB,M,9,5,2,0,0,0,16
Dyfed,BWBX,F,1,0,0,0,0,0,1
Dyfed,BWBX,M,4,1,0,0,0,0,5
Dyfed,BWX,F,6,8,5,2,3,36,60
Dyfed,BWX,M,8,9,0,0,0,1,18
Dyfed,BX,F,0,0,0,0,0,3,3
Dyfed,CA,F,0,0,0,0,0,1,1
Dyfed,CB,F,4,0,1,1,1,69,76
Dyfed,CB,M,7,2,0,0,0,0,9
Dyfed,CD,F,168,91,45,12,13,5,334
Dyfed,CD,M,13,3,0,0,0,0,16
Dyfed,CH,F,914,830,410,303,289,"2,012","4,758"
Dyfed,CH,M,914,772,279,126,77,555,"2,723"
Dyfed,CHI,F,1,0,0,1,0,2,4
Dyfed,CHIX,F,1,0,1,0,0,2,4
Dyfed,CHIX,M,1,0,0,0,0,0,1
Dyfed,CHL,M,0,1,0,0,0,0,1
Dyfed,CHX,F,"6,102","5,138","1,337",586,507,"4,162","17,832"
Dyfed,CHX,M,"6,109","5,505","1,158",76,19,573,"13,440"
Dyfed,DE,F,0,0,0,0,0,3,3
Dyfed,DEV,F,0,1,4,0,2,3,10
Dyfed,DEV,M,1,2,1,1,0,1,6
Dyfed,DEVX,F,5,11,4,0,0,7,27
Dyfed,DEVX,M,8,13,0,0,0,1,22
Dyfed,DEX,F,127,85,83,69,50,192,606
Dyfed,DEX,M,95,88,39,7,5,31,265
Dyfed,DEXX,F,9,10,1,3,1,14,38
Dyfed,DEXX,M,9,5,3,1,0,2,20
Dyfed,DR,F,0,0,2,4,0,4,10
Dyfed,DR,M,0,1,0,0,0,0,1
Dyfed,DRX,F,3,0,3,0,2,6,14
Dyfed,DRX,M,0,0,0,0,0,1,1
Dyfed,DS,F,120,127,132,69,101,197,746
Dyfed,DS,M,40,30,17,5,0,2,94
Dyfed,DSHO,F,1,0,0,0,0,10,11
Dyfed,DSHO,M,1,0,0,0,0,0,1
Dyfed,DSX,F,95,74,28,20,20,28,265
Dyfed,DSX,M,20,3,1,0,0,0,24
Dyfed,DV,F,0,0,0,0,0,25,25
Dyfed,DV,M,0,0,0,0,0,1,1
Dyfed,DVX,F,0,0,0,0,0,26,26
Dyfed,DVX,M,0,0,0,0,0,1,1
Dyfed,FE,F,4,0,1,0,0,0,5
Dyfed,FEX,M,0,1,0,0,0,0,1
Dyfed,FR,F,0,0,0,0,0,"36,422","36,422"
Dyfed,FR,M,0,0,0,0,0,283,283
Dyfed,FRX,F,0,0,0,0,0,753,753
Dyfed,FRX,M,0,0,0,0,0,55,55
Dyfed,GA,F,1,0,2,4,4,20,31
Dyfed,GA,M,5,1,0,0,0,1,7
Dyfed,GAS,F,0,1,2,2,0,2,7
Dyfed,GAX,F,5,3,0,2,1,12,23
Dyfed,GAX,M,1,0,1,0,0,1,3
Dyfed,GB,F,0,0,0,1,0,0,1
Dyfed,GB,M,0,0,1,0,0,0,1
Dyfed,GBX,F,0,1,0,1,1,0,3
Dyfed,GBX,M,1,1,1,0,0,0,3
Dyfed,GE,F,3,5,3,2,11,9,33
Dyfed,GE,M,8,6,0,0,0,0,14
Dyfed,GEX,F,19,9,11,6,6,29,80
Dyfed,GEX,M,4,7,3,0,0,9,23
Dyfed,GL,F,0,1,0,0,0,2,3
Dyfed,GU,F,108,126,117,84,105,293,833
Dyfed,GU,M,23,32,8,2,1,3,69
Dyfed,GUX,F,6,5,5,11,6,17,50
Dyfed,GUX,M,0,2,1,0,0,0,3
Dyfed,GY,F,3,0,0,0,0,0,3
Dyfed,GY,M,1,0,0,0,0,0,1
Dyfed,GYX,F,1,0,0,0,0,1,2
Dyfed,GYX,M,1,0,0,0,0,0,1
Dyfed,H,F,0,0,0,0,0,703,703
Dyfed,H,M,0,0,0,0,0,145,145
Dyfed,HE,F,628,601,289,250,217,728,"2,713"
Dyfed,HE,M,685,651,226,102,51,137,"1,852"
Dyfed,HEBL,F,0,0,0,0,0,62,62
Dyfed,HEBL,M,0,0,0,0,0,3,3
Dyfed,HEBLX,F,0,0,0,0,0,520,520
Dyfed,HEBLX,M,0,0,0,0,0,29,29
Dyfed,HEBR,F,0,0,0,0,0,4,4
Dyfed,HEBRX,F,0,0,0,0,0,1,1
Dyfed,HER,F,0,0,0,0,0,67,67
Dyfed,HER,M,0,0,0,0,0,6,6
Dyfed,HERX,F,0,0,0,0,0,188,188
Dyfed,HERX,M,0,0,0,0,0,5,5
Dyfed,HEX,F,"3,718","3,200","1,482",990,869,"3,272","13,531"
Dyfed,HEX,M,"4,031","3,322",887,67,34,116,"8,457"
Dyfed,HF,F,"17,768","17,141","16,784","15,524","12,751","26,215","106,183"
Dyfed,HF,M,"5,975","2,314",841,177,79,114,"9,500"
Dyfed,HFX,F,921,751,760,729,653,"1,375","5,189"
Dyfed,HFX,M,435,150,67,8,0,7,667
Dyfed,HI,F,39,40,30,37,22,139,307
Dyfed,HI,M,35,34,15,11,7,30,132
Dyfed,HIX,F,2,7,1,1,2,9,22
Dyfed,HIX,M,6,1,3,0,0,1,11
Dyfed,HL,F,0,0,0,0,0,20,20
Dyfed,HO,F,"2,516","2,383","2,510","2,460","1,917","3,289","15,075"
Dyfed,HO,M,498,160,98,33,16,24,829
Dyfed,HOX,F,55,55,42,57,60,246,515
Dyfed,HOX,M,41,27,6,0,0,8,82
Dyfed,HX,F,0,0,0,0,0,"1,500","1,500"
Dyfed,HX,M,0,0,0,0,0,212,212
Dyfed,IM,F,0,0,2,1,1,3,7
Dyfed,IM,M,1,2,0,0,0,0,3
Dyfed,IMX,F,1,0,0,0,0,0,1
Dyfed,JE,F,360,463,461,433,318,"1,064","3,099"
Dyfed,JE,M,47,22,30,9,1,28,137
Dyfed,JEX,F,897,825,487,626,625,403,"3,863"
Dyfed,JEX,M,59,14,9,1,0,2,85
Dyfed,JY,F,125,0,0,0,0,4,129
Dyfed,JY,M,16,0,0,0,0,0,16
Dyfed,JYX,F,8,0,0,0,0,0,8
Dyfed,JYX,M,2,0,0,0,0,0,2
Dyfed,KE,F,0,1,0,2,0,2,5
Dyfed,KE,M,1,0,0,0,0,0,1
Dyfed,KEX,F,1,3,0,0,0,0,4
Dyfed,LH,F,50,24,15,22,22,80,213
Dyfed,LH,M,34,39,12,4,1,8,98
Dyfed,LHX,F,19,6,5,4,2,39,75
Dyfed,LHX,M,22,7,1,0,0,1,31
Dyfed,LI,F,0,0,0,0,0,"1,014","1,014"
Dyfed,LI,M,0,0,0,0,0,309,309
Dyfed,LIM,F,"3,548","2,884","1,445",983,814,"2,519","12,193"
Dyfed,LIM,M,"3,483","3,001",820,249,210,564,"8,327"
Dyfed,LIM X,F,0,0,0,0,0,6,6
Dyfed,LIMB,F,0,0,0,0,0,80,80
Dyfed,LIMB,M,0,0,0,0,0,1,1
Dyfed,LIMBX,F,0,0,0,0,0,636,636
Dyfed,LIMBX,M,0,0,0,0,0,11,11
Dyfed,LIMR,F,0,0,0,0,0,119,119
Dyfed,LIMR,M,0,0,0,0,0,12,12
Dyfed,LIMRX,F,0,0,0,0,0,279,279
Dyfed,LIMRX,M,0,0,0,0,0,4,4
Dyfed,LIMX,F,"14,884","12,259","4,768","2,923","2,610","7,647","45,091"
Dyfed,LIMX,M,"15,834","13,016","3,109",187,87,326,"32,559"
Dyfed,LIX,F,0,0,0,0,0,"3,015","3,015"
Dyfed,LIX,M,0,0,0,0,0,608,608
Dyfed,LM,F,0,0,0,0,0,32,32
Dyfed,LM,M,0,0,0,0,0,5,5
Dyfed,LMX,F,0,0,0,0,0,43,43
Dyfed,LR,F,0,2,0,0,0,1,3
Dyfed,LR,M,1,0,0,0,0,0,1
Dyfed,LRX,F,1,0,0,0,0,1,2
Dyfed,LU,F,4,0,1,0,0,0,5
Dyfed,LU,M,3,1,0,0,0,0,4
Dyfed,LUX,F,0,0,0,0,0,3,3
Dyfed,LUX,M,0,0,1,0,0,0,1
Dyfed,MAR,F,0,1,1,1,0,0,3
Dyfed,MARX,F,20,3,10,11,4,13,61
Dyfed,MARX,M,6,3,5,0,0,0,14
Dyfed,MG,F,31,23,16,12,21,74,177
Dyfed,MG,M,36,17,0,2,0,7,62
Dyfed,MGX,F,16,16,17,4,8,33,94
Dyfed,MGX,M,13,12,5,0,0,0,30
Dyfed,MO,F,26,30,16,19,24,22,137
Dyfed,MO,M,23,34,8,1,2,0,68
Dyfed,MOX,F,260,154,52,32,3,33,534
Dyfed,MOX,M,190,104,9,1,0,2,306
Dyfed,MRI,F,88,70,99,148,118,431,954
Dyfed,MRI,M,78,47,28,1,1,20,175
Dyfed,MRIX,F,97,137,197,213,359,"1,191","2,194"
Dyfed,MRIX,M,63,98,61,5,1,15,243
Dyfed,NO,F,0,0,1,3,0,4,8
Dyfed,NOX,F,9,5,0,1,2,38,55
Dyfed,NR,F,11,0,0,0,0,1,12
Dyfed,NR,M,14,0,0,0,0,0,14
Dyfed,NRX,F,78,13,0,0,0,0,91
Dyfed,NRX,M,32,3,0,0,0,0,35
Dyfed,NS,F,0,0,0,0,0,"1,479","1,479"
Dyfed,NS,M,0,0,0,0,0,5,5
Dyfed,OB,F,0,0,0,0,0,1,1
Dyfed,OB,M,0,0,0,0,0,1,1
Dyfed,PA,F,2,0,0,0,2,5,9
Dyfed,PA,M,0,1,1,0,1,0,3
Dyfed,PAX,F,13,11,3,7,6,20,60
Dyfed,PAX,M,13,6,1,0,0,1,21
Dyfed,PI,F,0,0,1,0,0,7,8
Dyfed,PI,M,0,0,2,0,0,0,2
Dyfed,PIX,F,6,3,2,3,0,50,64
Dyfed,PIX,M,3,4,0,0,0,9,16
Dyfed,RO,F,1,0,0,0,1,8,10
Dyfed,RO,M,0,0,2,0,0,0,2
Dyfed,ROTX,F,0,0,9,3,0,0,12
Dyfed,ROTX,M,0,1,0,0,0,0,1
Dyfed,ROX,F,0,0,0,0,1,20,21
Dyfed,ROX,M,0,0,1,0,0,0,1
Dyfed,RP,F,21,12,16,23,10,34,116
Dyfed,RP,M,21,4,4,3,1,0,33
Dyfed,RPX,F,16,10,1,3,0,5,35
Dyfed,RPX,M,10,6,2,0,0,1,19
Dyfed,RWFR,F,1,0,0,0,0,4,5
Dyfed,SA,F,71,49,26,27,27,119,319
Dyfed,SA,M,57,27,10,2,3,8,107
Dyfed,SAX,F,134,125,49,17,13,110,448
Dyfed,SAX,M,159,116,29,0,0,8,312
Dyfed,SB,F,1,0,0,0,2,0,3
Dyfed,SBX,F,0,0,0,0,0,1,1
Dyfed,SBX,M,0,0,1,0,0,0,1
Dyfed,SD,F,34,40,15,21,33,62,205
Dyfed,SD,M,46,25,3,1,0,5,80
Dyfed,SDX,F,46,53,10,27,17,32,185
Dyfed,SDX,M,61,39,5,1,0,0,106
Dyfed,SGX,F,0,0,0,0,0,2,2
Dyfed,SH,F,6,2,5,7,2,21,43
Dyfed,SH,M,5,2,0,1,0,0,8
Dyfed,SHO,F,65,65,137,77,103,516,963
Dyfed,SHO,M,19,44,20,6,1,14,104
Dyfed,SHOX,F,140,130,126,150,69,125,740
Dyfed,SHOX,M,147,72,21,0,0,3,243
Dyfed,SHX,F,3,9,1,1,3,11,28
Dyfed,SHX,M,1,7,0,0,0,0,8
Dyfed,SM,F,465,402,222,155,147,968,"2,359"
Dyfed,SM,M,423,362,92,39,28,161,"1,105"
Dyfed,SMX,F,"2,434","1,788",707,431,408,"2,576","8,344"
Dyfed,SMX,M,"2,425","1,731",433,18,12,246,"4,865"
Dyfed,SOBX,F,0,0,0,0,0,1,1
Dyfed,SRW,F,14,0,0,2,6,5,27
Dyfed,SRW,M,9,0,2,0,0,0,11
Dyfed,SRWX,F,107,10,20,46,87,20,290
Dyfed,SRWX,M,40,2,0,0,0,0,42
Dyfed,ST,F,0,3,0,0,0,0,3
Dyfed,ST,M,0,1,0,1,0,1,3
Dyfed,STX,F,36,33,29,22,9,1,130
Dyfed,STX,M,47,26,2,0,0,0,75
Dyfed,SU,F,0,0,0,0,0,1,1
Dyfed,SUX,F,0,0,1,1,0,6,8
Dyfed,SUX,M,2,0,0,0,0,1,3
Dyfed,WB,F,"1,557","1,393","1,001",875,728,"3,113","8,667"
Dyfed,WB,M,"1,571","1,346",313,84,54,190,"3,558"
Dyfed,WBX,F,552,424,194,172,140,783,"2,265"
Dyfed,WBX,M,610,401,98,6,3,51,"1,169"
Dyfed,WG,F,1,0,0,0,0,0,1
Dyfed,WP,F,8,15,4,1,7,34,69
Dyfed,WP,M,12,6,5,0,1,2,26
Dyfed,WPX,F,2,1,4,0,0,7,14
Dyfed,WPX,M,3,3,1,0,0,0,7
Dyfed,WS,F,0,0,0,0,0,1,1
Dyfed,WS,M,0,0,1,0,0,0,1
Dyfed,WSX,F,0,1,5,18,5,23,52
Dyfed,WSX,M,1,1,1,0,0,0,3
Dyfed,WW,F,6,7,10,3,5,11,42
Dyfed,WW,M,8,7,4,0,0,5,24
Dyfed,WWX,F,0,2,0,0,0,1,3
Dyfed,WWX,M,1,4,0,0,0,0,5
Dyfed,ZE,F,0,0,0,0,0,1,1
Cywyd,AA,F,142,135,54,29,26,250,636
Cywyd,AA,M,134,122,45,12,5,23,341
Cywyd,AAX,F,476,408,132,82,62,428,"1,588"
Cywyd,AAX,M,517,359,86,1,1,27,991
Cywyd,ARX,M,0,1,0,0,0,0,1
Cywyd,AUX,F,0,0,0,0,1,0,1
Cywyd,AY,F,221,187,154,139,85,403,"1,189"
Cywyd,AY,M,72,38,8,0,1,9,128
Cywyd,AYX,F,23,35,11,11,4,5,89
Cywyd,AYX,M,0,4,0,0,0,0,4
Cywyd,BA,F,92,65,13,15,8,82,275
Cywyd,BA,M,93,63,19,11,2,36,224
Cywyd,BAB,F,0,0,0,0,0,1,1
Cywyd,BABX,F,0,0,0,0,0,5,5
Cywyd,BAL,F,0,0,2,0,2,0,4
Cywyd,BAL,M,0,1,1,0,0,1,3
Cywyd,BALX,F,7,0,0,0,1,3,11
Cywyd,BALX,M,2,0,0,0,0,0,2
Cywyd,BAR,F,0,0,0,0,0,1,1
Cywyd,BARX,F,0,0,0,0,0,3,3
Cywyd,BAX,F,370,418,101,47,52,463,"1,451"
Cywyd,BAX,M,420,425,72,3,0,38,958
Cywyd,BAZ,F,4,1,6,4,2,13,30
Cywyd,BAZ,M,7,3,2,1,3,3,19
Cywyd,BAZ X,F,0,0,0,0,0,5,5
Cywyd,BAZX,F,97,88,29,12,15,26,267
Cywyd,BAZX,M,113,45,15,0,0,0,173
Cywyd,BB,F,196,268,94,58,51,251,918
Cywyd,BB,M,193,271,85,11,16,58,634
Cywyd,BBX,F,"2,015","1,953",812,414,321,"1,014","6,529"
Cywyd,BBX,M,"2,182","1,995",554,21,1,69,"4,822"
Cywyd,BF,F,"1,252","1,487","2,108","1,956","2,134","3,205","12,142"
Cywyd,BF,M,898,901,490,39,12,21,"2,361"
Cywyd,BFX,F,361,251,225,185,128,237,"1,387"
Cywyd,BFX,M,263,105,47,1,5,4,425
Cywyd,BG,F,0,2,1,2,2,20,27
Cywyd,BG,M,3,1,1,0,0,3,8
Cywyd,BGX,F,6,2,3,0,1,1,13
Cywyd,BGX,M,5,1,0,0,0,0,6
Cywyd,BH,F,26,0,0,0,0,380,406
Cywyd,BH,M,10,0,0,0,0,0,10
Cywyd,BHX,F,8,0,0,0,0,72,80
Cywyd,BHX,M,11,0,0,0,0,0,11
Cywyd,BI,F,1,0,0,3,0,0,4
Cywyd,BI,M,3,0,1,0,0,0,4
Cywyd,BLG,F,0,0,0,0,0,1,1
Cywyd,BR,F,1,0,1,0,0,2,4
Cywyd,BRX,F,0,0,1,0,0,0,1
Cywyd,BRX,M,0,1,0,0,0,0,1
Cywyd,BS,F,8,4,7,3,4,28,54
Cywyd,BS,M,3,3,2,0,0,2,10
Cywyd,BSH,F,24,26,16,17,11,21,115
Cywyd,BSH,M,34,6,0,1,0,1,42
Cywyd,BSHX,F,5,4,0,1,0,0,10
Cywyd,BSHX,M,7,2,0,0,0,0,9
Cywyd,BSX,F,65,46,61,43,23,120,358
Cywyd,BSX,M,45,20,6,0,0,0,71
Cywyd,BU,F,19,20,6,0,2,55,102
Cywyd,BU,M,28,23,2,0,0,1,54
Cywyd,BW,F,5,1,2,2,2,9,21
Cywyd,BW,M,2,0,0,0,0,0,2
Cywyd,BWB,F,0,0,2,0,0,4,6
Cywyd,BWB,M,0,1,1,0,0,0,2
Cywyd,BWBX,F,1,0,0,0,0,0,1
Cywyd,BWBX,M,1,0,0,0,0,0,1
Cywyd,BWX,F,0,0,0,0,0,3,3
Cywyd,BX,F,0,0,0,0,0,2,2
Cywyd,CB,F,0,0,0,0,0,2,2
Cywyd,CD,F,63,10,52,0,0,8,133
Cywyd,CD,M,10,1,1,0,0,0,12
Cywyd,CH,F,434,408,145,109,105,572,"1,773"
Cywyd,CH,M,410,340,91,33,28,174,"1,076"
Cywyd,CHIX,F,0,0,0,0,0,1,1
Cywyd,CHX,F,"2,458","2,571",596,202,151,"1,243","7,221"
Cywyd,CHX,M,"2,833","2,917",662,35,21,206,"6,674"
Cywyd,DEVX,F,0,1,0,0,0,2,3
Cywyd,DEX,F,25,9,10,10,9,39,102
Cywyd,DEX,M,22,11,2,3,0,2,40
Cywyd,DEXX,F,0,1,0,0,0,0,1
Cywyd,DRX,F,2,0,0,0,0,0,2
Cywyd,DRX,M,1,0,0,0,0,0,1
Cywyd,DS,F,1,1,1,7,17,17,44
Cywyd,DS,M,0,0,1,1,0,1,3
Cywyd,DSX,F,14,1,2,1,4,8,30
Cywyd,DSX,M,1,0,0,0,0,0,1
Cywyd,FR,F,0,0,0,0,0,"10,817","10,817"
Cywyd,FR,M,0,0,0,0,0,147,147
Cywyd,FRX,F,0,0,0,0,0,284,284
Cywyd,FRX,M,0,0,0,0,0,14,14
Cywyd,GA,F,0,0,1,0,0,3,4
Cywyd,GA,M,0,15,0,0,0,0,15
Cywyd,GAX,F,4,3,1,0,0,0,8
Cywyd,GAX,M,2,4,0,0,0,0,6
Cywyd,GB,M,1,0,1,0,0,0,2
Cywyd,GBX,F,0,2,0,0,0,0,2
Cywyd,GBX,M,0,0,0,1,0,0,1
Cywyd,GE,F,2,0,1,0,0,1,4
Cywyd,GE,M,0,0,1,0,0,2,3
Cywyd,GEX,F,49,64,74,29,20,39,275
Cywyd,GEX,M,71,76,15,0,0,1,163
Cywyd,GU,F,4,4,0,9,4,25,46
Cywyd,GU,M,0,0,3,0,0,0,3
Cywyd,GUX,F,0,0,1,0,0,1,2
Cywyd,GUX,M,0,1,0,0,0,0,1
Cywyd,H,F,0,0,0,0,0,165,165
Cywyd,H,M,0,0,0,0,0,21,21
Cywyd,HE,F,80,44,30,44,80,149,427
Cywyd,HE,M,71,58,31,15,19,17,211
Cywyd,HEBL,F,0,0,0,0,0,9,9
Cywyd,HEBLX,F,0,0,0,0,0,89,89
Cywyd,HER,F,0,0,0,0,0,12,12
Cywyd,HER,M,0,0,0,0,0,3,3
Cywyd,HERX,F,0,0,0,0,0,31,31
Cywyd,HERX,M,0,0,0,0,0,1,1
Cywyd,HEX,F,691,479,242,212,166,807,"2,597"
Cywyd,HEX,M,665,498,160,22,6,20,"1,371"
Cywyd,HF,F,"4,945","5,315","5,573","5,052","4,516","8,686","34,087"
Cywyd,HF,M,"2,019","1,263",616,28,16,50,"3,992"
Cywyd,HFX,F,482,391,435,422,331,603,"2,664"
Cywyd,HFX,M,189,107,56,3,4,3,362
Cywyd,HI,F,29,35,12,5,19,105,205
Cywyd,HI,M,35,19,1,3,0,5,63
Cywyd,HIX,F,0,2,1,0,0,10,13
Cywyd,HIX,M,1,8,0,0,0,0,9
Cywyd,HL,M,0,0,0,0,0,1,1
Cywyd,HO,F,445,591,696,658,624,"1,057","4,071"
Cywyd,HO,M,161,99,40,7,9,22,338
Cywyd,HOX,F,15,15,32,42,29,101,234
Cywyd,HOX,M,4,1,4,0,0,1,10
Cywyd,HX,F,0,0,0,0,0,391,391
Cywyd,HX,M,0,0,0,0,0,44,44
Cywyd,IM,F,2,2,0,0,0,5,9
Cywyd,IM,M,2,1,2,0,0,0,5
Cywyd,IMX,F,0,0,0,0,0,1,1
Cywyd,JE,F,167,412,172,252,115,145,"1,263"
Cywyd,JE,M,12,19,5,7,3,3,49
Cywyd,JEX,F,494,341,82,77,117,43,"1,154"
Cywyd,JEX,M,38,13,1,1,0,1,54
Cywyd,JY,F,8,0,0,0,0,0,8
Cywyd,JYX,F,24,0,0,0,0,0,24
Cywyd,JYX,M,1,0,0,0,0,0,1
Cywyd,LH,F,22,6,10,6,21,31,96
Cywyd,LH,M,16,19,1,1,0,1,38
Cywyd,LHX,F,7,3,1,0,1,3,15
Cywyd,LHX,M,4,5,2,0,0,0,11
Cywyd,LI,F,0,0,0,0,0,335,335
Cywyd,LI,M,0,0,0,0,0,77,77
Cywyd,LIM,F,"1,087","1,163",436,280,303,"1,024","4,293"
Cywyd,LIM,M,"1,144","1,218",380,86,59,254,"3,141"
Cywyd,LIMB,F,0,0,0,0,0,21,21
Cywyd,LIMB,M,0,0,0,0,0,1,1
Cywyd,LIMBX,F,0,0,0,0,0,253,253
Cywyd,LIMBX,M,0,0,0,0,0,5,5
Cywyd,LIMR,F,0,0,0,0,0,30,30
Cywyd,LIMR,M,0,0,0,0,0,5,5
Cywyd,LIMRX,F,0,0,0,0,0,113,113
Cywyd,LIMRX,M,0,0,0,0,0,6,6
Cywyd,LIMX,F,"6,955","6,561","2,120",957,984,"3,455","21,032"
Cywyd,LIMX,M,"7,468","6,932","1,613",67,36,100,"16,216"
Cywyd,LIX,F,0,0,0,0,0,"1,263","1,263"
Cywyd,LIX,M,0,0,0,0,0,212,212
Cywyd,LM,F,0,0,0,0,0,15,15
Cywyd,LM,M,0,0,0,0,0,5,5
Cywyd,LMX,F,0,0,0,0,0,29,29
Cywyd,LR,F,0,0,1,0,0,2,3
Cywyd,LRX,F,0,0,0,0,1,0,1
Cywyd,LU,F,0,18,0,0,0,5,23
Cywyd,LU,M,2,0,0,0,1,0,3
Cywyd,LUX,F,0,0,0,0,0,2,2
Cywyd,MALX,F,0,1,0,0,0,0,1
Cywyd,MALX,M,0,1,0,0,0,0,1
Cywyd,MG,F,0,0,1,0,0,2,3
Cywyd,MG,M,0,0,4,0,0,1,5
Cywyd,MGX,F,5,1,5,0,0,6,17
Cywyd,MGX,M,3,1,0,0,0,0,4
Cywyd,MO,F,26,33,25,27,21,38,170
Cywyd,MO,M,32,25,12,0,2,1,72
Cywyd,MOX,F,43,78,70,31,2,36,260
Cywyd,MOX,M,45,20,22,0,0,2,89
Cywyd,MRI,F,170,139,122,99,106,127,763
Cywyd,MRI,M,149,92,42,6,0,4,293
Cywyd,MRIX,F,151,162,127,37,31,207,715
Cywyd,MRIX,M,189,137,44,0,1,1,372
Cywyd,NOX,F,0,2,0,0,0,0,2
Cywyd,NOX,M,1,0,0,0,0,0,1
Cywyd,NR,F,8,0,0,0,0,1,9
Cywyd,NR,M,1,0,0,0,0,0,1
Cywyd,NRX,F,21,0,0,0,0,0,21
Cywyd,NRX,M,9,0,0,0,0,0,9
Cywyd,NS,F,0,0,0,0,0,784,784
Cywyd,NS,M,0,0,0,0,0,1,1
Cywyd,OB,F,0,0,0,0,0,1,1
Cywyd,OO,F,0,0,0,0,0,1,1
Cywyd,PA,F,1,0,0,0,0,1,2
Cywyd,PAX,F,0,4,3,0,1,0,8
Cywyd,PI,F,0,1,0,0,0,0,1
Cywyd,PIX,F,0,2,4,3,0,10,19
Cywyd,PIX,M,0,2,1,0,0,0,3
Cywyd,RO,F,0,0,0,0,0,1,1
Cywyd,ROT,F,0,0,5,0,0,0,5
Cywyd,ROT,M,3,0,1,0,0,0,4
Cywyd,ROTX,F,0,0,3,0,0,0,3
Cywyd,ROTX,M,0,1,0,0,0,0,1
Cywyd,ROX,F,0,0,0,0,0,1,1
Cywyd,ROX,M,0,0,0,0,0,1,1
Cywyd,RP,F,0,0,0,0,0,4,4
Cywyd,RP,M,0,0,6,0,0,1,7
Cywyd,RPX,F,4,0,0,0,0,0,4
Cywyd,RWFR,F,2,0,0,0,0,2,4
Cywyd,SA,F,54,41,29,33,33,158,348
Cywyd,SA,M,52,51,8,1,1,8,121
Cywyd,SAX,F,109,64,27,12,24,256,492
Cywyd,SAX,M,111,69,25,2,1,10,218
Cywyd,SB,F,1,0,0,0,1,1,3
Cywyd,SBX,F,0,2,0,0,0,4,6
Cywyd,SD,F,8,15,6,12,2,8,51
Cywyd,SD,M,7,5,0,2,0,0,14
Cywyd,SDX,F,2,7,10,0,1,2,22
Cywyd,SDX,M,1,14,0,0,0,0,15
Cywyd,SH,F,0,0,0,1,0,4,5
Cywyd,SHO,F,36,24,37,39,27,98,261
Cywyd,SHO,M,15,8,8,0,1,0,32
Cywyd,SHOX,F,18,29,31,30,7,21,136
Cywyd,SHOX,M,16,2,5,1,0,0,24
Cywyd,SHX,F,1,0,1,0,0,0,2
Cywyd,SM,F,187,142,66,20,32,164,611
Cywyd,SM,M,173,153,44,14,15,39,438
Cywyd,SMX,F,680,735,310,150,92,547,"2,514"
Cywyd,SMX,M,797,731,194,12,1,57,"1,792"
Cywyd,SRW,F,28,10,4,16,4,4,66
Cywyd,SRW,M,13,11,6,0,0,0,30
Cywyd,SRWX,F,155,35,8,16,10,6,230
Cywyd,SRWX,M,58,3,1,0,0,0,62
Cywyd,ST,F,55,39,36,18,2,5,155
Cywyd,ST,M,68,17,3,3,1,3,95
Cywyd,STX,F,151,67,57,64,55,46,440
Cywyd,STX,M,155,39,2,0,0,0,196
Cywyd,SU,M,0,0,1,0,0,0,1
Cywyd,SUX,F,0,0,1,1,0,4,6
Cywyd,SUX,M,2,0,0,0,0,0,2
Cywyd,WB,F,214,257,188,144,146,944,"1,893"
Cywyd,WB,M,216,182,43,7,6,31,485
Cywyd,WBX,F,92,75,18,20,33,157,395
Cywyd,WBX,M,74,66,14,0,0,9,163
Cywyd,WP,F,0,0,0,0,0,3,3
Cywyd,WPX,F,0,0,1,0,0,1,2
Cywyd,WSX,F,0,0,0,0,3,2,5
Cywyd,WW,F,0,0,0,0,0,4,4
Cywyd,WW,M,0,2,1,0,0,0,3
Cywyd,ZE,M,0,0,0,0,0,1,1
South Glamorgan,AA,F,24,27,13,24,18,52,158
South Glamorgan,AA,M,21,12,9,3,6,11,62
South Glamorgan,AAX,F,462,332,59,39,35,191,"1,118"
South Glamorgan,AAX,M,446,336,21,3,1,7,814
South Glamorgan,AY,F,0,0,0,0,1,0,1
South Glamorgan,AY,M,0,0,1,0,0,1,2
South Glamorgan,BA,F,7,2,11,1,0,5,26
South Glamorgan,BA,M,4,2,0,2,0,2,10
South Glamorgan,BABX,F,0,0,0,0,0,2,2
South Glamorgan,BALX,F,0,0,0,1,0,0,1
South Glamorgan,BAX,F,49,47,18,8,3,59,184
South Glamorgan,BAX,M,46,55,10,0,0,1,112
South Glamorgan,BAZ,M,0,1,0,0,0,0,1
South Glamorgan,BAZX,F,0,0,1,0,0,0,1
South Glamorgan,BB,F,11,7,7,3,2,24,54
South Glamorgan,BB,M,19,13,5,1,0,2,40
South Glamorgan,BBX,F,158,136,68,54,72,97,585
South Glamorgan,BBX,M,179,187,35,1,0,2,404
South Glamorgan,BF,F,128,147,159,194,232,321,"1,181"
South Glamorgan,BF,M,141,156,52,4,3,0,356
South Glamorgan,BFX,F,6,10,14,25,13,14,82
South Glamorgan,BFX,M,3,7,1,1,0,0,12
South Glamorgan,BG,F,0,1,1,1,1,3,7
South Glamorgan,BH,F,0,0,0,0,0,8,8
South Glamorgan,BRX,F,0,0,0,1,0,0,1
South Glamorgan,BS,M,0,1,0,0,0,0,1
South Glamorgan,BSH,F,14,1,0,0,0,1,16
South Glamorgan,BSH,M,7,3,1,0,0,0,11
South Glamorgan,BSHX,F,0,1,0,1,0,0,2
South Glamorgan,BSHX,M,0,2,0,0,0,0,2
South Glamorgan,BSX,F,0,1,0,0,1,2,4
South Glamorgan,BSX,M,1,1,0,0,0,0,2
South Glamorgan,CH,F,14,27,9,2,1,50,103
South Glamorgan,CH,M,16,35,6,0,2,14,73
South Glamorgan,CHX,F,254,307,90,31,32,191,905
South Glamorgan,CHX,M,438,668,129,5,0,19,"1,259"
South Glamorgan,DEVX,F,1,4,0,0,0,4,9
South Glamorgan,DEVX,M,2,4,1,0,0,0,7
South Glamorgan,DEX,F,1,2,2,1,1,4,11
South Glamorgan,DEX,M,4,0,1,0,0,2,7
South Glamorgan,DEXX,M,1,0,0,0,0,0,1
South Glamorgan,DS,F,13,7,13,10,3,0,46
South Glamorgan,DS,M,1,1,0,0,0,0,2
South Glamorgan,DSX,F,1,1,1,2,0,0,5
South Glamorgan,DV,F,0,0,0,0,0,3,3
South Glamorgan,DVX,F,0,0,0,0,0,1,1
South Glamorgan,FEX,F,0,0,0,1,0,0,1
South Glamorgan,FR,F,0,0,0,0,0,"1,036","1,036"
South Glamorgan,FR,M,0,0,0,0,0,8,8
South Glamorgan,FRX,F,0,0,0,0,0,7,7
South Glamorgan,FRX,M,0,0,0,0,0,1,1
South Glamorgan,GAX,F,0,0,0,1,0,0,1
South Glamorgan,GE,F,24,12,10,13,12,39,110
South Glamorgan,GE,M,22,5,1,1,1,5,35
South Glamorgan,GEX,F,25,35,15,1,0,29,105
South Glamorgan,GEX,M,37,31,14,0,0,1,83
South Glamorgan,GU,F,1,1,0,1,2,3,8
South Glamorgan,H,F,0,0,0,0,0,14,14
South Glamorgan,H,M,0,0,0,0,0,1,1
South Glamorgan,HE,F,35,9,26,18,16,60,164
South Glamorgan,HE,M,33,12,5,0,2,7,59
South Glamorgan,HEBL,F,0,0,0,0,0,7,7
South Glamorgan,HEBLX,F,0,0,0,0,0,12,12
South Glamorgan,HEBR,F,0,0,0,0,0,1,1
South Glamorgan,HER,F,0,0,0,0,0,3,3
South Glamorgan,HER,M,0,0,0,0,0,2,2
South Glamorgan,HERX,F,0,0,0,0,0,2,2
South Glamorgan,HEX,F,129,109,47,32,34,114,465
South Glamorgan,HEX,M,140,127,22,6,1,2,298
South Glamorgan,HF,F,543,442,493,448,328,658,"2,912"
South Glamorgan,HF,M,310,108,37,19,5,29,508
South Glamorgan,HFX,F,22,64,24,38,51,81,280
South Glamorgan,HFX,M,25,8,4,1,0,1,39
South Glamorgan,HI,F,1,2,4,1,1,7,16
South Glamorgan,HI,M,3,2,0,0,1,0,6
South Glamorgan,HO,F,60,33,45,46,61,98,343
South Glamorgan,HO,M,17,16,7,16,0,0,56
South Glamorgan,HOX,F,0,1,0,0,0,2,3
South Glamorgan,HOX,M,1,0,0,0,0,0,1
South Glamorgan,HX,F,0,0,0,0,0,63,63
South Glamorgan,HX,M,0,0,0,0,0,2,2
South Glamorgan,IM,F,0,1,0,0,0,5,6
South Glamorgan,IM,M,1,3,0,0,0,1,5
South Glamorgan,IMX,M,1,0,0,0,0,0,1
South Glamorgan,JE,F,0,0,1,0,1,2,4
South Glamorgan,JEX,F,0,1,1,1,0,0,3
South Glamorgan,JEX,M,1,0,0,0,0,0,1
South Glamorgan,JY,F,1,0,0,0,0,0,1
South Glamorgan,LH,F,0,2,1,0,0,0,3
South Glamorgan,LHX,F,0,0,1,0,0,0,1
South Glamorgan,LHX,M,1,0,0,0,0,0,1
South Glamorgan,LI,F,0,0,0,0,0,20,20
South Glamorgan,LI,M,0,0,0,0,0,4,4
South Glamorgan,LIM,F,98,79,39,26,36,81,359
South Glamorgan,LIM,M,128,124,45,6,8,11,322
South Glamorgan,LIMBX,F,0,0,0,0,0,7,7
South Glamorgan,LIMR,F,0,0,0,0,0,3,3
South Glamorgan,LIMR,M,0,0,0,0,0,3,3
South Glamorgan,LIMRX,F,0,0,0,0,0,11,11
South Glamorgan,LIMX,F,642,483,214,88,99,330,"1,856"
South Glamorgan,LIMX,M,677,596,213,11,7,29,"1,533"
South Glamorgan,LIX,F,0,0,0,0,0,86,86
South Glamorgan,LIX,M,0,0,0,0,0,12,12
South Glamorgan,LMX,F,0,0,0,0,0,1,1
South Glamorgan,MAR,F,0,4,0,6,0,38,48
South Glamorgan,MAR,M,0,5,1,0,2,0,8
South Glamorgan,MARX,F,0,10,5,34,28,147,224
South Glamorgan,MARX,M,0,8,1,0,0,5,14
South Glamorgan,MAX,F,0,0,0,0,0,17,17
South Glamorgan,MG,F,0,0,0,0,0,6,6
South Glamorgan,MGX,F,1,0,0,0,0,3,4
South Glamorgan,MGX,M,0,2,0,0,0,0,2
South Glamorgan,MO,F,1,0,3,0,0,1,5
South Glamorgan,MO,M,0,0,1,1,0,0,2
South Glamorgan,MOX,F,2,0,2,1,0,1,6
South Glamorgan,MOX,M,2,2,0,0,0,0,4
South Glamorgan,MRI,F,0,6,0,0,0,0,6
South Glamorgan,MRIX,F,0,0,0,0,0,2,2
South Glamorgan,MRIX,M,14,6,2,0,0,0,22
South Glamorgan,NS,F,0,0,0,0,0,44,44
South Glamorgan,RP,F,0,9,0,0,0,25,34
South Glamorgan,RP,M,0,0,0,0,0,1,1
South Glamorgan,RPX,F,0,0,0,0,2,2,4
South Glamorgan,SAX,F,0,5,1,0,0,1,7
South Glamorgan,SAX,M,0,5,3,0,0,0,8
South Glamorgan,SD,F,6,8,3,0,4,17,38
South Glamorgan,SD,M,10,5,0,0,3,1,19
South Glamorgan,SDX,F,32,18,18,0,1,15,84
South Glamorgan,SDX,M,34,11,2,0,0,0,47
South Glamorgan,SHO,F,1,3,0,3,7,27,41
South Glamorgan,SHO,M,18,23,1,0,0,1,43
South Glamorgan,SHOX,F,3,0,1,0,1,3,8
South Glamorgan,SHOX,M,2,4,0,0,0,0,6
South Glamorgan,SM,F,15,9,5,1,3,45,78
South Glamorgan,SM,M,19,15,10,1,2,4,51
South Glamorgan,SMX,F,150,132,61,50,49,288,730
South Glamorgan,SMX,M,122,128,27,0,2,19,298
South Glamorgan,SRW,F,0,0,0,0,1,0,1
South Glamorgan,SRWX,F,0,0,0,0,2,0,2
South Glamorgan,SRWX,M,3,0,0,0,0,0,3
South Glamorgan,SUX,F,0,4,5,1,0,1,11
South Glamorgan,SUX,M,2,4,0,0,0,0,6
South Glamorgan,WB,F,32,40,22,28,25,104,251
South Glamorgan,WB,M,48,38,8,5,1,18,118
South Glamorgan,WBX,F,20,2,1,0,1,4,28
South Glamorgan,WBX,M,22,7,1,0,0,1,31
Mid Glamorgan,AA,F,41,25,21,39,21,110,257
Mid Glamorgan,AA,M,48,25,10,2,1,9,95
Mid Glamorgan,AAX,F,147,190,51,43,57,213,701
Mid Glamorgan,AAX,M,154,170,23,0,1,5,353
Mid Glamorgan,ARX,F,0,0,0,0,0,1,1
Mid Glamorgan,AY,F,3,5,5,4,3,20,40
Mid Glamorgan,AY,M,0,0,0,1,0,0,1
Mid Glamorgan,BA,F,16,15,5,9,0,37,82
Mid Glamorgan,BA,M,12,7,1,1,3,9,33
Mid Glamorgan,BABX,F,0,0,0,0,0,2,2
Mid Glamorgan,BABX,M,0,0,0,0,0,1,1
Mid Glamorgan,BAR,F,0,0,0,0,0,1,1
Mid Glamorgan,BARX,F,0,0,0,0,0,2,2
Mid Glamorgan,BARX,M,0,0,0,0,0,1,1
Mid Glamorgan,BAWX,F,0,0,0,0,0,1,1
Mid Glamorgan,BAX,F,133,53,13,12,9,66,286
Mid Glamorgan,BAX,M,143,38,2,0,0,4,187
Mid Glamorgan,BB,F,17,7,9,14,8,29,84
Mid Glamorgan,BB,M,9,12,4,1,1,5,32
Mid Glamorgan,BBX,F,167,121,73,63,42,260,726
Mid Glamorgan,BBX,M,161,74,9,1,1,9,255
Mid Glamorgan,BF,F,67,72,61,55,68,177,500
Mid Glamorgan,BF,M,91,80,16,5,1,3,196
Mid Glamorgan,BFX,F,6,8,3,0,0,15,32
Mid Glamorgan,BFX,M,4,5,0,3,0,0,12
Mid Glamorgan,BG,F,0,5,1,0,0,7,13
Mid Glamorgan,BG,M,0,0,0,0,0,1,1
Mid Glamorgan,BGX,F,16,7,7,5,7,9,51
Mid Glamorgan,BGX,M,10,5,0,1,0,1,17
Mid Glamorgan,BH,F,0,0,0,0,0,11,11
Mid Glamorgan,BHX,F,0,0,0,0,0,1,1
Mid Glamorgan,BLG,F,0,0,0,0,0,18,18
Mid Glamorgan,BS,F,0,0,1,0,0,0,1
Mid Glamorgan,BS,M,0,0,1,0,0,0,1
Mid Glamorgan,BSH,F,0,0,0,0,0,1,1
Mid Glamorgan,BSH,M,0,0,0,0,1,0,1
Mid Glamorgan,BSX,F,0,0,9,11,0,1,21
Mid Glamorgan,BSX,M,0,1,1,0,0,0,2
Mid Glamorgan,BU,F,1,1,2,0,2,2,8
Mid Glamorgan,BU,M,0,1,0,0,1,0,2
Mid Glamorgan,BW,F,0,0,0,0,1,1,2
Mid Glamorgan,BW,M,0,1,0,0,0,0,1
Mid Glamorgan,BWX,F,1,0,0,0,0,3,4
Mid Glamorgan,CA,F,0,0,0,0,0,2,2
Mid Glamorgan,CAX,F,0,0,0,0,0,3,3
Mid Glamorgan,CH,F,86,49,26,18,10,102,291
Mid Glamorgan,CH,M,87,52,17,4,7,57,224
Mid Glamorgan,CHX,F,607,406,133,80,85,617,"1,928"
Mid Glamorgan,CHX,M,704,361,70,6,2,67,"1,210"
Mid Glamorgan,DEV,F,1,0,0,0,0,1,2
Mid Glamorgan,DEVX,F,0,1,0,0,0,0,1
Mid Glamorgan,DEX,F,3,8,2,1,1,10,25
Mid Glamorgan,DEX,M,2,2,0,0,0,1,5
Mid Glamorgan,DEXX,F,0,0,0,0,0,1,1
Mid Glamorgan,DEXX,M,1,0,0,0,0,2,3
Mid Glamorgan,DS,F,0,1,0,0,0,0,1
Mid Glamorgan,FR,F,0,0,0,0,0,583,583
Mid Glamorgan,FR,M,0,0,0,0,0,12,12
Mid Glamorgan,FRX,F,0,0,0,0,0,10,10
Mid Glamorgan,FRX,M,0,0,0,0,0,3,3
Mid Glamorgan,GA,F,0,0,0,1,0,8,9
Mid Glamorgan,GAX,F,2,0,1,1,2,5,11
Mid Glamorgan,GAX,M,3,0,0,0,0,0,3
Mid Glamorgan,GE,F,0,0,3,0,0,9,12
Mid Glamorgan,GEX,F,11,7,3,5,1,18,45
Mid Glamorgan,GEX,M,6,9,0,0,0,0,15
Mid Glamorgan,GU,F,0,0,0,0,0,8,8
Mid Glamorgan,GU,M,0,0,0,0,0,1,1
Mid Glamorgan,GUX,F,0,0,0,1,0,0,1
Mid Glamorgan,H,F,0,0,0,0,0,61,61
Mid Glamorgan,H,M,0,0,0,0,0,6,6
Mid Glamorgan,HE,F,20,31,15,17,20,81,184
Mid Glamorgan,HE,M,16,17,8,4,3,7,55
Mid Glamorgan,HEBL,F,0,0,0,0,0,11,11
Mid Glamorgan,HEBL,M,0,0,0,0,0,2,2
Mid Glamorgan,HEBLX,F,0,0,0,0,0,57,57
Mid Glamorgan,HER,F,0,0,0,0,0,12,12
Mid Glamorgan,HER,M,0,0,0,0,0,3,3
Mid Glamorgan,HERX,F,0,0,0,0,0,26,26
Mid Glamorgan,HEX,F,208,185,85,144,117,493,"1,232"
Mid Glamorgan,HEX,M,165,134,30,4,3,6,342
Mid Glamorgan,HF,F,414,386,398,305,263,444,"2,210"
Mid Glamorgan,HF,M,177,75,23,3,0,3,281
Mid Glamorgan,HFX,F,18,31,30,28,30,21,158
Mid Glamorgan,HFX,M,13,6,5,1,0,0,25
Mid Glamorgan,HI,F,3,3,1,1,4,13,25
Mid Glamorgan,HI,M,3,3,2,3,0,2,13
Mid Glamorgan,HIX,F,1,0,0,0,0,0,1
Mid Glamorgan,HL,F,0,0,0,0,0,1,1
Mid Glamorgan,HO,F,11,7,9,29,13,43,112
Mid Glamorgan,HO,M,0,3,1,1,0,0,5
Mid Glamorgan,HOX,F,0,0,0,0,1,8,9
Mid Glamorgan,HOX,M,1,1,1,0,0,0,3
Mid Glamorgan,HX,F,0,0,0,0,0,226,226
Mid Glamorgan,HX,M,0,0,0,0,0,17,17
Mid Glamorgan,IM,F,0,0,0,0,1,0,1
Mid Glamorgan,JE,F,0,1,0,0,1,3,5
Mid Glamorgan,JE,M,1,0,0,0,0,0,1
Mid Glamorgan,JEX,F,0,1,1,0,0,2,4
Mid Glamorgan,LH,F,9,19,7,8,10,15,68
Mid Glamorgan,LH,M,10,19,4,1,0,0,34
Mid Glamorgan,LHX,F,2,3,5,1,0,1,12
Mid Glamorgan,LHX,M,5,1,1,0,0,0,7
Mid Glamorgan,LI,F,0,0,0,0,0,38,38
Mid Glamorgan,LI,M,0,0,0,0,0,10,10
Mid Glamorgan,LIM,F,182,109,102,73,49,151,666
Mid Glamorgan,LIM,M,156,82,44,7,14,45,348
Mid Glamorgan,LIM X,F,0,0,0,0,0,1,1
Mid Glamorgan,LIMB,F,0,0,0,0,0,9,9
Mid Glamorgan,LIMBX,F,0,0,0,0,0,50,50
Mid Glamorgan,LIMBX,M,0,0,0,0,0,1,1
Mid Glamorgan,LIMR,F,0,0,0,0,0,32,32
Mid Glamorgan,LIMR,M,0,0,0,0,0,2,2
Mid Glamorgan,LIMRX,F,0,0,0,0,0,19,19
Mid Glamorgan,LIMX,F,"1,076",686,264,245,196,673,"3,140"
Mid Glamorgan,LIMX,M,"1,019",504,86,10,5,15,"1,639"
Mid Glamorgan,LIX,F,0,0,0,0,0,262,262
Mid Glamorgan,LIX,M,0,0,0,0,0,44,44
Mid Glamorgan,LM,F,0,0,0,0,0,1,1
Mid Glamorgan,LMX,F,0,0,0,0,0,2,2
Mid Glamorgan,LRX,F,0,0,0,0,0,1,1
Mid Glamorgan,MAR,F,0,0,0,0,0,1,1
Mid Glamorgan,MARX,F,9,1,2,1,6,25,44
Mid Glamorgan,MARX,M,4,0,0,0,0,0,4
Mid Glamorgan,MAX,F,0,0,0,0,0,1,1
Mid Glamorgan,MG,F,2,0,2,0,0,3,7
Mid Glamorgan,MGX,F,0,0,0,0,0,2,2
Mid Glamorgan,MGX,M,0,1,0,0,0,0,1
Mid Glamorgan,MOX,F,0,0,0,0,0,1,1
Mid Glamorgan,MOX,M,1,0,0,0,0,0,1
Mid Glamorgan,MRI,F,1,0,0,0,0,3,4
Mid Glamorgan,MRIX,F,0,1,0,6,5,3,15
Mid Glamorgan,MRIX,M,4,2,0,0,0,0,6
Mid Glamorgan,NRX,M,0,1,0,0,0,0,1
Mid Glamorgan,NS,F,0,0,0,0,0,83,83
Mid Glamorgan,OB,F,0,0,0,0,0,3,3
Mid Glamorgan,PAX,F,2,0,0,0,0,0,2
Mid Glamorgan,PAX,M,0,2,0,0,0,0,2
Mid Glamorgan,PI,F,0,0,0,0,0,1,1
Mid Glamorgan,PIX,F,0,2,0,1,0,1,4
Mid Glamorgan,ROX,F,0,0,3,1,1,3,8
Mid Glamorgan,RP,F,0,2,1,2,1,6,12
Mid Glamorgan,RP,M,0,6,0,0,0,1,7
Mid Glamorgan,RPX,F,0,0,1,1,3,2,7
Mid Glamorgan,RPX,M,0,1,0,0,0,0,1
Mid Glamorgan,SA,F,0,1,0,0,0,19,20
Mid Glamorgan,SA,M,1,0,2,1,0,1,5
Mid Glamorgan,SAX,F,31,8,7,8,7,116,177
Mid Glamorgan,SAX,M,26,2,0,0,0,0,28
Mid Glamorgan,SD,F,7,2,10,0,0,1,20
Mid Glamorgan,SD,M,2,5,7,1,1,1,17
Mid Glamorgan,SDX,F,13,8,1,0,0,0,22
Mid Glamorgan,SDX,M,3,1,0,0,0,0,4
Mid Glamorgan,SH,F,0,1,0,2,2,4,9
Mid Glamorgan,SH,M,0,1,0,0,0,0,1
Mid Glamorgan,SHO,F,8,10,2,0,0,6,26
Mid Glamorgan,SHO,M,7,0,1,0,0,0,8
Mid Glamorgan,SHOX,F,5,0,1,2,3,13,24
Mid Glamorgan,SHOX,M,4,0,0,0,0,0,4
Mid Glamorgan,SHX,M,0,1,0,0,0,0,1
Mid Glamorgan,SM,F,32,31,28,19,12,57,179
Mid Glamorgan,SM,M,25,17,4,2,0,9,57
Mid Glamorgan,SMX,F,204,123,36,41,65,347,816
Mid Glamorgan,SMX,M,190,86,19,1,0,25,321
Mid Glamorgan,SUX,F,0,1,0,3,0,0,4
Mid Glamorgan,SUX,M,0,1,0,0,0,0,1
Mid Glamorgan,WB,F,192,184,163,111,114,310,"1,074"
Mid Glamorgan,WB,M,190,125,34,13,11,18,391
Mid Glamorgan,WBX,F,153,76,37,35,28,99,428
Mid Glamorgan,WBX,M,119,51,4,0,1,1,176
Mid Glamorgan,WGX,F,0,0,0,1,0,0,1
Mid Glamorgan,WSX,F,0,0,0,1,7,13,21
West Glamorgan,AA,F,46,33,20,20,15,114,248
West Glamorgan,AA,M,39,10,3,7,2,5,66
West Glamorgan,AAX,F,189,113,86,42,47,164,641
West Glamorgan,AAX,M,151,82,18,0,1,3,255
West Glamorgan,AY,F,3,0,1,0,0,5,9
West Glamorgan,AY,M,0,0,0,1,0,0,1
West Glamorgan,AYX,F,0,0,2,1,0,1,4
West Glamorgan,BA,F,2,2,3,4,0,10,21
West Glamorgan,BA,M,2,1,2,1,0,6,12
West Glamorgan,BABX,F,0,0,0,0,0,1,1
West Glamorgan,BARX,F,0,0,0,0,0,1,1
West Glamorgan,BAX,F,88,58,58,9,8,56,277
West Glamorgan,BAX,M,85,50,17,2,0,0,154
West Glamorgan,BB,F,16,11,7,8,7,65,114
West Glamorgan,BB,M,4,8,1,2,1,4,20
West Glamorgan,BBX,F,187,149,104,82,87,259,868
West Glamorgan,BBX,M,153,90,19,3,0,10,275
West Glamorgan,BF,F,88,77,70,125,183,225,768
West Glamorgan,BF,M,47,64,15,3,3,3,135
West Glamorgan,BFX,F,0,2,3,3,10,20,38
West Glamorgan,BFX,M,3,8,0,0,0,0,11
West Glamorgan,BG,F,0,0,1,0,0,3,4
West Glamorgan,BGX,F,1,0,0,0,0,4,5
West Glamorgan,BH,F,0,0,0,0,0,4,4
West Glamorgan,BHX,F,0,0,0,0,0,4,4
West Glamorgan,BHX,M,0,0,0,0,0,4,4
West Glamorgan,BLG,F,0,0,0,0,0,3,3
West Glamorgan,BLGX,F,0,0,0,2,1,6,9
West Glamorgan,BS,M,0,0,1,0,0,0,1
West Glamorgan,BSH,F,0,0,0,1,0,0,1
West Glamorgan,BSHX,F,0,1,0,2,7,2,12
West Glamorgan,BSX,F,2,0,0,0,0,3,5
West Glamorgan,BSX,M,0,0,1,0,0,0,1
West Glamorgan,BW,F,4,2,3,1,2,4,16
West Glamorgan,BW,M,2,2,0,0,0,1,5
West Glamorgan,BWX,F,0,0,0,0,0,3,3
West Glamorgan,CB,F,0,0,2,2,0,46,50
West Glamorgan,CB,M,1,0,0,1,0,0,2
West Glamorgan,CD,F,0,0,0,0,0,1,1
West Glamorgan,CH,F,118,69,21,28,26,289,551
West Glamorgan,CH,M,103,83,27,18,10,60,301
West Glamorgan,CHLX,M,0,1,0,0,0,0,1
West Glamorgan,CHX,F,827,506,199,93,66,726,"2,417"
West Glamorgan,CHX,M,856,453,145,11,4,81,"1,550"
West Glamorgan,DE,F,0,0,0,0,0,1,1
West Glamorgan,DEV,M,0,2,0,0,0,0,2
West Glamorgan,DEVX,F,0,0,1,0,0,1,2
West Glamorgan,DEX,F,9,10,8,1,10,28,66
West Glamorgan,DEX,M,7,5,3,0,0,1,16
West Glamorgan,DEXX,F,2,0,0,0,0,0,2
West Glamorgan,DEXX,M,2,1,0,0,0,0,3
West Glamorgan,DS,F,0,0,0,2,0,4,6
West Glamorgan,DV,F,0,0,0,0,0,2,2
West Glamorgan,DV,M,0,0,0,0,0,1,1
West Glamorgan,FR,F,0,0,0,0,0,680,680
West Glamorgan,FR,M,0,0,0,0,0,15,15
West Glamorgan,FRX,F,0,0,0,0,0,32,32
West Glamorgan,FRX,M,0,0,0,0,0,2,2
West Glamorgan,GASX,M,3,0,0,0,0,0,3
West Glamorgan,GAX,F,0,0,0,0,0,3,3
West Glamorgan,GAX,M,0,3,0,0,0,0,3
West Glamorgan,GB,F,0,0,0,0,0,1,1
West Glamorgan,GBX,F,0,0,0,0,0,1,1
West Glamorgan,GE,F,0,0,0,1,1,1,3
West Glamorgan,GE,M,0,0,1,0,0,0,1
West Glamorgan,GEX,F,0,0,1,0,1,0,2
West Glamorgan,GEX,M,1,0,0,0,0,0,1
West Glamorgan,H,F,0,0,0,0,0,93,93
West Glamorgan,H,M,0,0,0,0,0,4,4
West Glamorgan,HE,F,21,14,30,19,10,79,173
West Glamorgan,HE,M,16,10,6,5,2,5,44
West Glamorgan,HEBL,F,0,0,0,0,0,3,3
West Glamorgan,HEBLX,F,0,0,0,0,0,49,49
West Glamorgan,HEBRX,F,0,0,0,0,0,1,1
West Glamorgan,HER,F,0,0,0,0,0,5,5
West Glamorgan,HERX,F,0,0,0,0,0,12,12
West Glamorgan,HERX,M,0,0,0,0,0,1,1
West Glamorgan,HEX,F,177,110,123,72,101,511,"1,094"
West Glamorgan,HEX,M,118,47,11,3,0,3,182
West Glamorgan,HF,F,185,191,238,210,121,315,"1,260"
West Glamorgan,HF,M,97,98,67,2,1,2,267
West Glamorgan,HFX,F,6,7,1,5,3,29,51
West Glamorgan,HFX,M,1,0,4,0,0,0,5
West Glamorgan,HI,F,9,5,11,6,2,14,47
West Glamorgan,HI,M,4,0,1,0,1,1,7
West Glamorgan,HIX,F,0,0,1,0,0,4,5
West Glamorgan,HIX,M,2,0,0,0,0,0,2
West Glamorgan,HO,F,0,0,5,8,9,41,63
West Glamorgan,HO,M,0,8,1,0,0,3,12
West Glamorgan,HOX,F,1,0,0,0,1,0,2
West Glamorgan,HX,F,0,0,0,0,0,228,228
West Glamorgan,HX,M,0,0,0,0,0,12,12
West Glamorgan,JE,F,1,0,0,6,4,4,15
West Glamorgan,JE,M,0,1,0,0,0,0,1
West Glamorgan,JEX,F,3,5,3,5,2,5,23
West Glamorgan,LH,F,0,0,0,1,0,0,1
West Glamorgan,LHX,F,1,0,0,0,0,1,2
West Glamorgan,LI,F,0,0,0,0,0,126,126
West Glamorgan,LI,M,0,0,0,0,0,21,21
West Glamorgan,LIM,F,286,197,128,103,100,335,"1,149"
West Glamorgan,LIM,M,290,173,64,20,20,26,593
West Glamorgan,LIM X,F,0,0,0,0,0,2,2
West Glamorgan,LIMB,F,0,0,0,0,0,14,14
West Glamorgan,LIMBX,F,0,0,0,0,0,60,60
West Glamorgan,LIMBX,M,0,0,0,0,0,1,1
West Glamorgan,LIMR,F,0,0,0,0,0,5,5
West Glamorgan,LIMR,M,0,0,0,0,0,1,1
West Glamorgan,LIMRX,F,0,0,0,0,0,27,27
West Glamorgan,LIMX,F,"1,004",718,334,264,236,977,"3,533"
West Glamorgan,LIMX,M,"1,015",651,197,23,6,13,"1,905"
West Glamorgan,LIX,F,0,0,0,0,0,372,372
West Glamorgan,LIX,M,0,0,0,0,0,55,55
West Glamorgan,LM,F,0,0,0,0,0,3,3
West Glamorgan,LMX,F,0,0,0,0,0,5,5
West Glamorgan,MARX,F,0,0,4,0,0,0,4
West Glamorgan,MARX,M,0,1,1,0,0,0,2
West Glamorgan,MG,F,0,0,0,0,1,3,4
West Glamorgan,MGX,F,1,0,0,0,0,4,5
West Glamorgan,MO,M,0,1,0,0,0,0,1
West Glamorgan,MOX,F,0,0,0,0,0,2,2
West Glamorgan,MOX,M,2,4,0,0,0,0,6
West Glamorgan,MRI,F,0,0,0,0,0,3,3
West Glamorgan,MRI,M,0,0,1,0,0,0,1
West Glamorgan,MRIX,F,0,0,0,0,0,17,17
West Glamorgan,MRIX,M,1,2,0,0,0,0,3
West Glamorgan,NO,F,0,0,0,0,0,2,2
West Glamorgan,NOX,F,0,0,0,0,0,4,4
West Glamorgan,NS,F,0,0,0,0,0,154,154
West Glamorgan,PAX,F,1,0,0,0,1,1,3
West Glamorgan,PI,F,0,0,0,0,0,5,5
West Glamorgan,PIX,F,2,0,1,0,0,3,6
West Glamorgan,PIX,M,1,0,6,0,0,0,7
West Glamorgan,ROX,F,0,0,0,0,0,1,1
West Glamorgan,RP,F,0,0,0,0,0,2,2
West Glamorgan,RP,M,0,0,1,0,0,0,1
West Glamorgan,SA,F,2,3,6,11,9,11,42
West Glamorgan,SA,M,1,3,2,0,2,0,8
West Glamorgan,SAX,F,24,46,13,2,11,45,141
West Glamorgan,SAX,M,35,28,6,0,0,0,69
West Glamorgan,SD,F,0,4,0,0,4,4,12
West Glamorgan,SD,M,0,4,0,0,0,0,4
West Glamorgan,SDX,F,1,0,0,0,0,4,5
West Glamorgan,SHO,F,0,0,0,1,1,6,8
West Glamorgan,SHOX,F,5,5,0,2,0,20,32
West Glamorgan,SHOX,M,5,27,0,0,0,1,33
West Glamorgan,SHX,F,0,0,0,1,0,0,1
West Glamorgan,SHX,M,0,2,0,0,0,0,2
West Glamorgan,SM,F,13,12,16,15,12,54,122
West Glamorgan,SM,M,21,6,1,0,2,7,37
West Glamorgan,SMX,F,89,66,42,18,21,199,435
West Glamorgan,SMX,M,66,62,28,1,0,10,167
West Glamorgan,SRWX,F,3,0,0,0,0,0,3
West Glamorgan,STX,F,0,0,0,0,3,0,3
West Glamorgan,WB,F,78,81,68,74,51,236,588
West Glamorgan,WB,M,82,27,25,7,2,12,155
West Glamorgan,WBX,F,33,17,13,28,16,68,175
West Glamorgan,WBX,M,31,21,5,2,0,1,60
West Glamorgan,WG,F,0,0,0,0,1,0,1
West Glamorgan,WP,F,0,0,0,0,0,3,3
West Glamorgan,WP,M,3,0,0,1,0,0,4
West Glamorgan,WPX,F,0,0,0,0,0,1,1
West Glamorgan,WS,F,0,0,0,0,0,1,1
West Glamorgan,WSX,F,0,0,1,0,0,1,2
West Glamorgan,WW,F,0,0,1,0,0,0,1
Gwent,AA,F,144,106,38,64,42,152,546
Gwent,AA,M,164,118,40,8,7,16,353
Gwent,AAX,F,466,201,119,132,121,307,"1,346"
Gwent,AAX,M,553,340,96,8,0,11,"1,008"
Gwent,ARX,F,1,0,0,0,0,0,1
Gwent,AY,F,0,0,0,3,2,21,26
Gwent,AY,M,0,0,4,0,0,0,4
Gwent,AYX,F,3,4,5,4,9,0,25
Gwent,AYX,M,1,0,1,0,0,0,2
Gwent,BA,F,29,13,9,3,6,42,102
Gwent,BA,M,25,10,9,4,2,15,65
Gwent,BABX,F,0,0,0,0,0,3,3
Gwent,BALX,F,0,0,0,0,0,1,1
Gwent,BAR,F,0,0,0,0,0,2,2
Gwent,BARX,F,0,0,0,0,0,11,11
Gwent,BAX,F,326,245,82,46,60,268,"1,027"
Gwent,BAX,M,343,222,73,1,3,30,672
Gwent,BAZX,F,3,2,4,0,0,0,9
Gwent,BAZX,M,4,1,1,0,0,0,6
Gwent,BB,F,24,37,19,24,24,89,217
Gwent,BB,M,37,35,16,2,4,6,100
Gwent,BBX,F,512,398,179,201,141,529,"1,960"
Gwent,BBX,M,626,452,83,8,1,30,"1,200"
Gwent,BF,F,485,544,539,498,483,"1,109","3,658"
Gwent,BF,M,474,332,216,29,4,5,"1,060"
Gwent,BFX,F,118,108,62,71,54,55,468
Gwent,BFX,M,39,8,14,3,3,0,67
Gwent,BG,F,4,4,1,2,1,15,27
Gwent,BG,M,4,5,0,0,0,1,10
Gwent,BGX,F,1,3,1,1,0,12,18
Gwent,BGX,M,1,1,1,0,0,0,3
Gwent,BH,F,2,0,0,0,0,53,55
Gwent,BH,M,2,0,0,0,0,0,2
Gwent,BHX,F,3,0,0,0,0,7,10
Gwent,BLGX,M,1,0,0,0,0,0,1
Gwent,BRX,F,0,0,0,0,1,0,1
Gwent,BS,F,1,1,4,2,2,14,24
Gwent,BS,M,2,0,0,1,0,1,4
Gwent,BSH,F,0,0,0,0,0,2,2
Gwent,BSH,M,0,1,0,0,0,0,1
Gwent,BSHX,F,0,2,0,0,0,2,4
Gwent,BSHX,M,1,0,1,0,0,0,2
Gwent,BSX,F,1,3,4,2,4,10,24
Gwent,BW,F,3,0,5,2,4,3,17
Gwent,BW,M,3,1,0,0,0,0,4
Gwent,BWX,F,0,1,0,0,2,2,5
Gwent,BWX,M,0,2,0,0,0,0,2
Gwent,CAX,F,0,0,0,0,0,1,1
Gwent,CB,F,0,2,0,0,1,2,5
Gwent,CH,F,106,120,40,45,13,182,506
Gwent,CH,M,86,144,41,12,7,60,350
Gwent,CHIX,F,0,0,0,0,0,1,1
Gwent,CHX,F,"1,264","1,102",286,167,124,897,"3,840"
Gwent,CHX,M,"1,204","1,323",250,18,4,67,"2,866"
Gwent,DEV,F,4,3,0,3,1,8,19
Gwent,DEV,M,2,4,2,0,1,1,10
Gwent,DEVX,F,10,3,3,1,0,1,18
Gwent,DEVX,M,6,2,0,0,1,0,9
Gwent,DEX,F,12,26,3,15,5,43,104
Gwent,DEX,M,17,13,3,1,1,12,47
Gwent,DEXX,F,1,3,1,0,0,1,6
Gwent,DEXX,M,0,1,0,0,0,0,1
Gwent,DR,F,0,0,1,0,0,0,1
Gwent,DRX,F,6,0,0,2,0,0,8
Gwent,DRX,M,6,0,0,0,0,0,6
Gwent,DS,F,24,36,62,30,26,17,195
Gwent,DS,M,0,2,0,0,0,0,2
Gwent,DSHO,F,11,0,0,0,0,0,11
Gwent,DSX,F,3,6,3,1,1,6,20
Gwent,DSX,M,1,0,0,0,0,0,1
Gwent,DV,F,0,0,0,0,0,6,6
Gwent,DVX,F,0,0,0,0,0,3,3
Gwent,DVX,M,0,0,0,0,0,1,1
Gwent,FEX,M,1,0,0,0,0,0,1
Gwent,FR,F,0,0,0,0,0,"3,374","3,374"
Gwent,FR,M,0,0,0,0,0,66,66
Gwent,FRX,F,0,0,0,0,0,88,88
Gwent,FRX,M,0,0,0,0,0,5,5
Gwent,GA,F,11,3,9,17,11,41,92
Gwent,GA,M,10,8,6,2,1,0,27
Gwent,GAX,F,7,5,5,0,0,6,23
Gwent,GAX,M,3,0,3,1,0,0,7
Gwent,GBX,M,1,0,0,0,0,0,1
Gwent,GE,F,19,16,11,11,0,28,85
Gwent,GE,M,16,24,4,2,3,10,59
Gwent,GEX,F,120,67,23,39,18,87,354
Gwent,GEX,M,154,79,12,3,5,15,268
Gwent,GL,F,2,0,2,2,0,3,9
Gwent,GL,M,2,1,1,0,0,0,4
Gwent,GU,F,0,1,0,0,1,6,8
Gwent,GUX,F,0,0,0,0,0,1,1
Gwent,H,F,0,0,0,0,0,101,101
Gwent,H,M,0,0,0,0,0,8,8
Gwent,HE,F,87,72,62,50,24,139,434
Gwent,HE,M,68,58,18,13,6,22,185
Gwent,HEBL,F,0,0,0,0,0,11,11
Gwent,HEBLX,F,0,0,0,0,0,101,101
Gwent,HEBLX,M,0,0,0,0,0,9,9
Gwent,HER,F,0,0,0,0,0,7,7
Gwent,HER,M,0,0,0,0,0,1,1
Gwent,HERX,F,0,0,0,0,0,26,26
Gwent,HERX,M,0,0,0,0,0,2,2
Gwent,HEX,F,543,518,176,228,248,"1,040","2,753"
Gwent,HEX,M,559,418,107,10,1,22,"1,117"
Gwent,HF,F,"1,750","1,847","1,987","1,654","1,377","2,725","11,340"
Gwent,HF,M,961,535,234,18,4,7,"1,759"
Gwent,HFX,F,30,51,65,80,123,163,512
Gwent,HFX,M,19,15,18,1,1,1,55
Gwent,HI,F,4,7,5,3,1,22,42
Gwent,HI,M,5,1,2,4,0,9,21
Gwent,HIX,F,1,0,0,0,0,5,6
Gwent,HIX,M,1,3,0,0,0,0,4
Gwent,HO,F,351,366,308,196,139,349,"1,709"
Gwent,HO,M,39,18,19,1,0,2,79
Gwent,HOX,F,1,5,1,7,9,25,48
Gwent,HOX,M,1,1,0,0,0,1,3
Gwent,HX,F,0,0,0,0,0,366,366
Gwent,HX,M,0,0,0,0,0,31,31
Gwent,IM,F,0,0,0,0,0,4,4
Gwent,JE,F,89,107,109,74,60,226,665
Gwent,JE,M,5,3,2,0,1,0,11
Gwent,JEX,F,121,101,55,22,31,27,357
Gwent,JEX,M,18,2,0,2,0,1,23
Gwent,JY,F,4,0,0,0,0,0,4
Gwent,KEX,M,1,0,0,0,0,0,1
Gwent,LH,F,40,24,14,24,15,66,183
Gwent,LH,M,34,25,5,4,1,6,75
Gwent,LHX,F,17,26,12,6,7,23,91
Gwent,LHX,M,10,14,3,2,0,0,29
Gwent,LI,F,0,0,0,0,0,100,100
Gwent,LI,M,0,0,0,0,0,31,31
Gwent,LIM,F,411,272,217,75,114,358,"1,447"
Gwent,LIM,M,427,262,110,29,22,68,918
Gwent,LIM X,F,0,0,0,0,0,3,3
Gwent,LIMB,F,0,0,0,0,0,27,27
Gwent,LIMB,M,0,0,0,0,0,5,5
Gwent,LIMBX,F,0,0,0,0,0,120,120
Gwent,LIMBX,M,0,0,0,0,0,12,12
Gwent,LIMR,F,0,0,0,0,0,56,56
Gwent,LIMR,M,0,0,0,0,0,11,11
Gwent,LIMRX,F,0,0,0,0,0,64,64
Gwent,LIMRX,M,0,0,0,0,0,5,5
Gwent,LIMX,F,"2,502","1,906",687,391,370,"1,258","7,114"
Gwent,LIMX,M,"2,744","2,005",428,30,8,47,"5,262"
Gwent,LIX,F,0,0,0,0,0,395,395
Gwent,LIX,M,0,0,0,0,0,74,74
Gwent,LM,F,0,0,0,0,0,2,2
Gwent,LM,M,0,0,0,0,0,2,2
Gwent,LMX,F,0,0,0,0,0,1,1
Gwent,LMX,M,0,0,0,0,0,1,1
Gwent,LR,M,1,0,0,0,0,0,1
Gwent,LRX,F,4,0,0,0,0,0,4
Gwent,LRX,M,1,0,0,0,0,0,1
Gwent,MA,M,0,0,1,0,0,0,1
Gwent,MALX,F,0,1,0,0,0,0,1
Gwent,MARX,F,0,0,0,0,1,0,1
Gwent,MAX,M,0,1,0,0,0,0,1
Gwent,MG,F,3,0,0,0,0,6,9
Gwent,MG,M,1,1,0,0,0,2,4
Gwent,MGX,F,10,24,8,0,0,12,54
Gwent,MGX,M,8,10,0,0,0,2,20
Gwent,MO,F,0,0,0,0,4,4,8
Gwent,MO,M,0,1,0,0,0,1,2
Gwent,MOX,F,5,5,22,12,5,2,51
Gwent,MOX,M,8,5,1,0,0,0,14
Gwent,MRI,F,6,12,28,10,3,3,62
Gwent,MRI,M,10,7,2,3,0,1,23
Gwent,MRIX,F,30,31,40,52,21,48,222
Gwent,MRIX,M,41,22,13,0,1,0,77
Gwent,ND,F,0,0,0,0,0,1,1
Gwent,NO,F,0,0,1,0,0,1,2
Gwent,NOX,F,0,0,1,0,0,2,3
Gwent,NR,F,3,0,0,0,0,0,3
Gwent,NR,M,1,0,0,0,0,0,1
Gwent,NRX,F,9,0,0,0,0,0,9
Gwent,NRX,M,8,0,0,0,0,0,8
Gwent,NS,F,0,0,0,0,0,213,213
Gwent,NS,M,0,0,0,0,0,2,2
Gwent,OEX,M,1,0,0,0,0,0,1
Gwent,PAX,F,2,0,0,0,0,0,2
Gwent,PAX,M,2,0,0,0,0,0,2
Gwent,PI,F,0,0,0,0,0,2,2
Gwent,PI,M,0,0,0,0,0,4,4
Gwent,PIX,F,4,0,2,2,0,11,19
Gwent,PIX,M,1,1,0,0,0,0,2
Gwent,RO,F,0,0,0,0,0,1,1
Gwent,ROX,F,0,0,1,0,0,1,2
Gwent,ROX,M,0,0,5,0,0,0,5
Gwent,RP,F,3,9,14,5,5,9,45
Gwent,RP,M,0,0,1,0,0,0,1
Gwent,RPX,F,3,2,4,0,1,1,11
Gwent,RPX,M,0,1,0,0,0,0,1
Gwent,RWFR,F,0,0,0,0,0,1,1
Gwent,SA,F,5,0,0,0,0,1,6
Gwent,SA,M,3,1,0,0,0,3,7
Gwent,SAX,F,5,21,3,33,18,77,157
Gwent,SAX,M,6,12,1,2,0,0,21
Gwent,SD,F,25,13,9,10,6,32,95
Gwent,SD,M,18,10,3,1,2,3,37
Gwent,SDX,F,51,24,26,4,8,11,124
Gwent,SDX,M,44,28,7,0,0,5,84
Gwent,SHO,F,15,16,8,4,6,77,126
Gwent,SHO,M,49,27,1,1,0,4,82
Gwent,SHOX,F,4,8,1,2,0,56,71
Gwent,SHOX,M,6,14,3,1,0,0,24
Gwent,SHX,F,0,0,0,0,0,1,1
Gwent,SM,F,93,95,56,40,45,169,498
Gwent,SM,M,91,84,15,8,8,45,251
Gwent,SMX,F,660,607,212,197,189,852,"2,717"
Gwent,SMX,M,783,613,136,5,2,69,"1,608"
Gwent,SRWX,F,5,0,0,0,1,0,6
Gwent,SRWX,M,6,0,0,0,0,0,6
Gwent,STX,M,1,0,0,0,0,0,1
Gwent,SU,F,2,1,1,0,10,4,18
Gwent,SU,M,1,2,2,0,0,0,5
Gwent,SUX,F,0,1,1,1,1,7,11
Gwent,SUX,M,2,1,0,1,0,0,4
Gwent,WB,F,76,84,64,58,49,188,519
Gwent,WB,M,78,62,12,9,2,3,166
Gwent,WBX,F,44,54,37,18,24,90,267
Gwent,WBX,M,65,42,22,3,1,1,134
Gwent,WGX,F,2,0,0,0,0,0,2
Gwent,WP,F,9,7,6,6,1,27,56
Gwent,WP,M,7,6,6,3,1,4,27
Gwent,WPX,F,10,11,6,9,11,26,73
Gwent,WPX,M,7,5,6,1,0,0,19
Gwent,WS,F,1,0,0,0,0,4,5
Gwent,WS,M,0,0,0,0,0,1,1
Gwent,WSX,F,1,2,1,0,0,1,5
Aberdeenshire,AA,F,656,614,371,263,228,"1,123","3,255"
Aberdeenshire,AA,M,701,653,97,55,37,149,"1,692"
Aberdeenshire,AAX,F,"2,486","2,847",849,718,727,"3,864","11,491"
Aberdeenshire,AAX,M,"2,955","3,639",322,42,12,122,"7,092"
Aberdeenshire,AMX,M,1,0,0,0,0,0,1
Aberdeenshire,AR,F,1,1,1,0,0,0,3
Aberdeenshire,ARX,F,1,1,0,1,0,0,3
Aberdeenshire,ARX,M,0,1,0,0,0,0,1
Aberdeenshire,AY,F,41,47,61,43,58,173,423
Aberdeenshire,AY,M,45,52,22,20,0,0,139
Aberdeenshire,AYX,F,5,6,4,3,2,6,26
Aberdeenshire,AYX,M,8,6,2,0,0,0,16
Aberdeenshire,BA,F,84,76,42,34,46,132,414
Aberdeenshire,BA,M,70,63,25,8,4,43,213
Aberdeenshire,BABX,F,0,0,0,0,0,7,7
Aberdeenshire,BAL,M,1,0,0,0,0,0,1
Aberdeenshire,BALX,F,0,0,0,0,0,2,2
Aberdeenshire,BALX,M,0,1,0,0,0,0,1
Aberdeenshire,BAR,F,0,0,0,0,0,3,3
Aberdeenshire,BARX,F,0,0,0,0,0,15,15
Aberdeenshire,BAW,F,0,0,0,0,0,1,1
Aberdeenshire,BAWX,F,0,0,0,0,0,1,1
Aberdeenshire,BAX,F,444,607,165,134,105,744,"2,199"
Aberdeenshire,BAX,M,432,700,73,19,8,65,"1,297"
Aberdeenshire,BAZ,F,0,1,1,0,0,2,4
Aberdeenshire,BAZ,M,3,2,1,0,1,1,8
Aberdeenshire,BAZX,F,5,34,2,1,0,2,44
Aberdeenshire,BAZX,M,10,36,1,0,0,0,47
Aberdeenshire,BB,F,102,100,78,61,60,264,665
Aberdeenshire,BB,M,79,89,41,6,4,33,252
Aberdeenshire,BBX,F,"1,380","1,559",867,680,773,"2,203","7,462"
Aberdeenshire,BBX,M,"1,233","1,510",196,7,10,52,"3,008"
Aberdeenshire,BF,F,35,85,124,143,129,232,748
Aberdeenshire,BF,M,206,389,100,8,0,3,706
Aberdeenshire,BFX,F,4,0,3,31,4,10,52
Aberdeenshire,BFX,M,12,32,5,2,0,0,51
Aberdeenshire,BG,F,2,2,7,4,3,27,45
Aberdeenshire,BG,M,3,7,8,0,0,3,21
Aberdeenshire,BGX,F,3,6,2,2,2,13,28
Aberdeenshire,BGX,M,1,3,0,0,0,1,5
Aberdeenshire,BH,F,0,0,0,0,0,28,28
Aberdeenshire,BH,M,2,0,0,0,0,0,2
Aberdeenshire,BLG,F,0,0,0,0,1,7,8
Aberdeenshire,BLG,M,1,1,0,0,0,0,2
Aberdeenshire,BLGX,F,0,0,0,0,0,1,1
Aberdeenshire,BP,F,0,1,0,0,0,0,1
Aberdeenshire,BPX,F,2,0,0,0,0,0,2
Aberdeenshire,BRX,F,0,0,0,1,0,0,1
Aberdeenshire,BRX,M,0,1,0,0,0,0,1
Aberdeenshire,BS,F,0,0,0,1,1,4,6
Aberdeenshire,BS,M,1,3,0,0,0,0,4
Aberdeenshire,BSH,F,29,20,17,33,26,15,140
Aberdeenshire,BSH,M,36,40,6,7,3,3,95
Aberdeenshire,BSHX,F,91,94,47,22,23,73,350
Aberdeenshire,BSHX,M,117,168,7,1,0,0,293
Aberdeenshire,BSX,F,0,1,0,0,0,2,3
Aberdeenshire,BSX,M,5,8,1,0,0,0,14
Aberdeenshire,BW,F,0,0,0,0,0,5,5
Aberdeenshire,BWX,F,0,0,0,0,1,2,3
Aberdeenshire,BWX,M,0,1,0,0,0,0,1
Aberdeenshire,CAX,F,0,0,0,0,0,3,3
Aberdeenshire,CB,F,0,7,1,0,1,47,56
Aberdeenshire,CB,M,2,3,2,0,0,0,7
Aberdeenshire,CH,F,448,467,217,190,140,712,"2,174"
Aberdeenshire,CH,M,449,468,153,92,87,342,"1,591"
Aberdeenshire,CHIX,F,0,1,0,0,0,1,2
Aberdeenshire,CHLX,F,1,0,0,0,0,0,1
Aberdeenshire,CHX,F,"8,272","11,762","1,000",509,528,"3,979","26,050"
Aberdeenshire,CHX,M,"8,913","15,379","1,240",43,14,662,"26,251"
Aberdeenshire,DBX,F,0,0,0,0,0,1,1
Aberdeenshire,DEV,M,0,4,0,0,0,0,4
Aberdeenshire,DEVX,F,0,3,0,1,1,11,16
Aberdeenshire,DEVX,M,1,7,0,0,0,0,8
Aberdeenshire,DEX,F,7,10,9,7,4,11,48
Aberdeenshire,DEX,M,7,16,1,1,1,7,33
Aberdeenshire,DEXX,F,2,2,1,0,0,2,7
Aberdeenshire,DEXX,M,0,1,1,0,0,0,2
Aberdeenshire,DG,F,0,0,0,0,0,1,1
Aberdeenshire,DGX,F,0,0,0,0,0,5,5
Aberdeenshire,DS,F,0,1,0,0,0,1,2
Aberdeenshire,DS,M,1,1,3,0,0,0,5
Aberdeenshire,DSX,F,0,3,0,0,0,2,5
Aberdeenshire,DSX,M,0,1,1,0,0,0,2
Aberdeenshire,FE,F,0,0,5,0,0,0,5
Aberdeenshire,FR,F,0,0,0,0,0,488,488
Aberdeenshire,FR,M,0,0,0,0,0,5,5
Aberdeenshire,FRX,F,0,0,0,0,0,12,12
Aberdeenshire,FRX,M,0,0,0,0,0,3,3
Aberdeenshire,GA,F,0,1,1,0,3,19,24
Aberdeenshire,GA,M,1,14,3,1,0,0,19
Aberdeenshire,GAS,M,0,4,0,0,0,0,4
Aberdeenshire,GASX,F,0,0,0,0,3,5,8
Aberdeenshire,GASX,M,1,0,0,0,0,0,1
Aberdeenshire,GAX,F,0,1,0,1,1,30,33
Aberdeenshire,GAX,M,4,9,7,0,0,0,20
Aberdeenshire,GBX,F,0,0,1,2,1,1,5
Aberdeenshire,GBX,M,1,0,0,0,0,0,1
Aberdeenshire,GEX,F,0,3,0,0,1,5,9
Aberdeenshire,GEX,M,0,4,0,0,0,0,4
Aberdeenshire,GL,F,0,0,0,0,0,2,2
Aberdeenshire,GU,F,0,0,0,0,2,3,5
Aberdeenshire,GU,M,0,0,0,1,0,0,1
Aberdeenshire,GUX,F,0,0,0,0,0,1,1
Aberdeenshire,H,F,0,0,0,0,0,8,8
Aberdeenshire,HE,F,35,44,42,51,21,145,338
Aberdeenshire,HE,M,33,32,15,9,1,11,101
Aberdeenshire,HEBL,F,0,0,0,0,0,1,1
Aberdeenshire,HEBLX,F,0,0,0,0,0,58,58
Aberdeenshire,HER,F,0,0,0,0,0,5,5
Aberdeenshire,HERX,F,0,0,0,0,0,22,22
Aberdeenshire,HEX,F,235,236,184,183,117,897,"1,852"
Aberdeenshire,HEX,M,156,227,29,1,0,7,420
Aberdeenshire,HF,F,"1,105","1,078","1,147","1,250",901,"2,493","7,974"
Aberdeenshire,HF,M,"1,741",637,276,38,10,139,"2,841"
Aberdeenshire,HFX,F,185,162,112,124,78,204,865
Aberdeenshire,HFX,M,190,81,10,0,0,6,287
Aberdeenshire,HI,F,98,107,89,76,70,298,738
Aberdeenshire,HI,M,97,123,87,21,20,18,366
Aberdeenshire,HIX,F,20,25,14,6,3,21,89
Aberdeenshire,HIX,M,41,27,9,1,0,1,79
Aberdeenshire,HL,F,0,0,0,0,0,138,138
Aberdeenshire,HL,M,0,0,0,0,0,12,12
Aberdeenshire,HLX,F,0,0,0,0,0,4,4
Aberdeenshire,HO,F,325,347,344,275,301,427,"2,019"
Aberdeenshire,HO,M,437,148,38,10,4,5,642
Aberdeenshire,HOX,F,21,0,1,8,8,4,42
Aberdeenshire,HOX,M,29,11,7,2,0,0,49
Aberdeenshire,HX,F,0,0,0,0,0,19,19
Aberdeenshire,IM,F,0,0,0,0,0,1,1
Aberdeenshire,IMX,F,0,1,0,0,0,2,3
Aberdeenshire,JE,F,50,77,77,73,79,130,486
Aberdeenshire,JE,M,0,1,0,2,0,1,4
Aberdeenshire,JEX,F,3,1,0,0,1,0,5
Aberdeenshire,JEX,M,3,1,0,0,1,0,5
Aberdeenshire,JY,F,19,0,0,0,0,12,31
Aberdeenshire,JYX,F,0,0,0,0,0,1,1
Aberdeenshire,LH,F,5,5,0,1,5,11,27
Aberdeenshire,LH,M,6,7,0,0,0,1,14
Aberdeenshire,LHX,F,9,8,1,0,1,6,25
Aberdeenshire,LHX,M,7,8,0,0,0,0,15
Aberdeenshire,LI,F,0,0,0,0,0,48,48
Aberdeenshire,LI,M,0,0,0,0,0,14,14
Aberdeenshire,LIM,F,620,810,325,270,264,949,"3,238"
Aberdeenshire,LIM,M,603,895,272,102,100,240,"2,212"
Aberdeenshire,LIMB,F,0,0,0,0,0,7,7
Aberdeenshire,LIMB,M,0,0,0,0,0,2,2
Aberdeenshire,LIMBX,F,0,0,0,0,0,195,195
Aberdeenshire,LIMBX,M,0,0,0,0,0,8,8
Aberdeenshire,LIMR,F,0,0,0,0,0,34,34
Aberdeenshire,LIMR,M,0,0,0,0,0,22,22
Aberdeenshire,LIMRX,F,0,0,0,0,0,205,205
Aberdeenshire,LIMRX,M,0,0,0,0,0,4,4
Aberdeenshire,LIMX,F,"9,677","13,098","2,731","2,050","2,115","6,431","36,102"
Aberdeenshire,LIMX,M,"9,972","15,242","1,958",72,25,69,"27,338"
Aberdeenshire,LIX,F,0,0,0,0,0,276,276
Aberdeenshire,LM,F,0,0,0,0,0,417,417
Aberdeenshire,LM,M,0,0,0,0,0,137,137
Aberdeenshire,LMX,F,0,0,0,0,0,"3,136","3,136"
Aberdeenshire,LMX,M,0,0,0,0,0,363,363
Aberdeenshire,LR,F,0,0,0,0,0,2,2
Aberdeenshire,LR,M,0,3,0,0,0,0,3
Aberdeenshire,LRX,F,0,0,1,0,0,0,1
Aberdeenshire,LRX,M,4,0,0,0,0,0,4
Aberdeenshire,LU,F,10,15,26,8,3,36,98
Aberdeenshire,LU,M,42,95,5,2,0,1,145
Aberdeenshire,LUX,F,11,19,4,8,7,86,135
Aberdeenshire,LUX,M,24,56,2,0,0,2,84
Aberdeenshire,MAX,F,0,0,0,0,0,1,1
Aberdeenshire,MG,F,0,0,0,0,0,1,1
Aberdeenshire,MG,M,0,0,0,0,0,1,1
Aberdeenshire,MGX,F,7,1,0,0,0,0,8
Aberdeenshire,MGX,M,2,0,0,0,0,0,2
Aberdeenshire,MO,F,44,15,0,75,20,0,154
Aberdeenshire,MO,M,38,17,1,2,1,0,59
Aberdeenshire,MOX,F,42,7,0,0,0,5,54
Aberdeenshire,MOX,M,44,14,2,0,0,0,60
Aberdeenshire,MRI,F,8,7,9,6,7,21,58
Aberdeenshire,MRI,M,7,2,1,0,0,1,11
Aberdeenshire,MRIX,F,2,3,2,3,4,3,17
Aberdeenshire,MRIX,M,3,15,1,0,0,0,19
Aberdeenshire,NOX,F,0,3,1,0,0,1,5
Aberdeenshire,NRX,F,2,0,0,0,0,0,2
Aberdeenshire,NRX,M,5,0,0,0,0,0,5
Aberdeenshire,NS,F,0,0,0,0,0,188,188
Aberdeenshire,NS,M,0,0,0,0,0,1,1
Aberdeenshire,OB,F,0,0,0,0,0,37,37
Aberdeenshire,OB,M,0,0,0,0,0,4,4
Aberdeenshire,OD,F,0,0,0,0,0,13,13
Aberdeenshire,OD,M,0,0,0,0,0,2,2
Aberdeenshire,OO,F,0,0,0,0,0,86,86
Aberdeenshire,OO,M,0,0,0,0,0,21,21
Aberdeenshire,PA,M,0,1,0,1,0,0,2
Aberdeenshire,PAX,F,1,2,1,1,1,0,6
Aberdeenshire,PAX,M,3,6,1,0,0,0,10
Aberdeenshire,PI,F,0,0,0,1,0,0,1
Aberdeenshire,PIX,F,1,0,0,0,2,5,8
Aberdeenshire,PIX,M,0,1,0,0,0,0,1
Aberdeenshire,RO,F,0,0,0,0,0,3,3
Aberdeenshire,RO,M,0,3,0,0,0,0,3
Aberdeenshire,ROX,F,3,3,3,8,13,29,59
Aberdeenshire,ROX,M,1,14,1,1,0,2,19
Aberdeenshire,RP,F,0,0,0,0,0,1,1
Aberdeenshire,RP,M,1,0,0,0,0,0,1
Aberdeenshire,RPX,M,5,0,0,0,0,0,5
Aberdeenshire,SA,F,20,56,52,36,30,86,280
Aberdeenshire,SA,M,29,64,7,3,1,7,111
Aberdeenshire,SAX,F,161,373,156,149,130,561,"1,530"
Aberdeenshire,SAX,M,224,429,55,1,0,9,718
Aberdeenshire,SB,F,0,1,0,0,1,0,2
Aberdeenshire,SBX,F,0,0,0,0,1,0,1
Aberdeenshire,SD,F,2,2,2,0,0,4,10
Aberdeenshire,SD,M,4,3,0,0,1,1,9
Aberdeenshire,SDX,F,28,38,18,5,6,47,142
Aberdeenshire,SDX,M,53,52,3,1,0,0,109
Aberdeenshire,SH,F,8,7,1,5,3,17,41
Aberdeenshire,SH,M,30,22,3,0,1,0,56
Aberdeenshire,SHO,F,9,18,3,5,4,32,71
Aberdeenshire,SHO,M,23,29,7,1,0,2,62
Aberdeenshire,SHOX,F,117,163,92,89,63,404,928
Aberdeenshire,SHOX,M,188,410,31,3,4,12,648
Aberdeenshire,SHX,F,1,5,5,0,6,37,54
Aberdeenshire,SHX,M,7,5,0,0,0,2,14
Aberdeenshire,SM,F,508,561,442,427,368,"1,431","3,737"
Aberdeenshire,SM,M,503,463,114,76,70,181,"1,407"
Aberdeenshire,SMX,F,"5,459","6,214","2,943","2,665","2,431","12,293","32,005"
Aberdeenshire,SMX,M,"5,710","7,214",616,17,10,293,"13,860"
Aberdeenshire,SRW,F,2,0,0,0,0,0,2
Aberdeenshire,SRW,M,4,2,0,0,0,0,6
Aberdeenshire,SRWX,F,18,0,0,0,0,0,18
Aberdeenshire,SRWX,M,31,1,0,0,0,0,32
Aberdeenshire,ST,F,5,2,0,0,0,0,7
Aberdeenshire,ST,M,2,22,1,1,0,0,26
Aberdeenshire,STX,F,35,47,13,4,4,0,103
Aberdeenshire,STX,M,36,27,0,0,0,0,63
Aberdeenshire,SU,F,0,0,0,0,0,1,1
Aberdeenshire,SUX,F,0,0,0,0,0,4,4
Aberdeenshire,WB,F,0,3,1,0,2,30,36
Aberdeenshire,WB,M,1,0,0,0,0,6,7
Aberdeenshire,WBX,F,4,1,1,3,2,11,22
Aberdeenshire,WBX,M,0,0,2,0,0,1,3
Aberdeenshire,WG,F,0,0,0,0,1,1,2
Aberdeenshire,WGX,M,0,0,1,0,0,0,1
Aberdeenshire,WP,M,0,0,1,0,0,0,1
Aberdeenshire,WPX,F,0,0,0,0,0,2,2
Aberdeenshire,WSX,F,1,0,7,4,1,9,22
Aberdeenshire,WSX,M,5,27,5,0,0,0,37
Angus,AA,F,414,340,191,187,148,531,"1,811"
Angus,AA,M,488,305,29,14,14,37,887
Angus,AAX,F,462,617,208,239,239,"1,273","3,038"
Angus,AAX,M,461,526,67,0,2,32,"1,088"
Angus,ARX,F,0,0,0,0,1,0,1
Angus,AY,F,14,3,8,11,10,15,61
Angus,AY,M,6,12,1,1,0,0,20
Angus,AYX,F,0,0,0,0,1,2,3
Angus,AYX,M,0,1,0,0,0,0,1
Angus,BA,F,16,3,2,0,12,36,69
Angus,BA,M,9,2,1,1,2,6,21
Angus,BABX,F,0,0,0,0,0,4,4
Angus,BALX,F,0,1,0,0,0,0,1
Angus,BARX,F,0,0,0,0,0,6,6
Angus,BAX,F,138,245,37,30,35,135,620
Angus,BAX,M,135,207,28,4,0,8,382
Angus,BAZ,M,0,0,0,0,0,1,1
Angus,BAZX,F,15,6,2,2,1,14,40
Angus,BAZX,M,19,0,0,0,0,0,19
Angus,BB,F,1,6,15,14,27,47,110
Angus,BB,M,4,18,19,1,0,5,47
Angus,BBX,F,133,281,204,109,105,394,"1,226"
Angus,BBX,M,191,253,44,0,1,12,501
Angus,BF,F,62,44,56,55,56,55,328
Angus,BF,M,66,61,16,0,0,0,143
Angus,BFX,F,1,0,0,2,4,1,8
Angus,BFX,M,0,6,0,0,0,0,6
Angus,BG,F,1,1,2,2,0,12,18
Angus,BG,M,3,0,0,1,0,0,4
Angus,BGX,F,0,0,0,0,0,6,6
Angus,BGX,M,0,1,5,0,0,0,6
Angus,BH,F,0,0,0,0,0,8,8
Angus,BLG,F,0,17,12,26,10,81,146
Angus,BLGX,F,0,0,0,0,0,9,9
Angus,BSH,F,32,20,11,18,11,25,117
Angus,BSH,M,41,17,2,3,0,0,63
Angus,BSHX,F,59,45,21,13,11,36,185
Angus,BSHX,M,56,38,4,0,0,0,98
Angus,CB,F,0,1,0,0,0,21,22
Angus,CH,F,117,84,61,48,54,158,522
Angus,CH,M,93,47,29,22,23,84,298
Angus,CHX,F,"1,892","2,618",214,63,46,475,"5,308"
Angus,CHX,M,"2,012","1,898",147,5,4,91,"4,157"
Angus,DEV,M,0,0,1,0,0,0,1
Angus,DEX,F,0,0,0,0,0,1,1
Angus,DEX,M,0,1,0,0,0,0,1
Angus,DGX,F,0,0,0,0,0,1,1
Angus,FR,F,0,0,0,0,0,144,144
Angus,FR,M,0,0,0,0,0,2,2
Angus,GA,F,0,1,0,0,0,1,2
Angus,GA,M,0,0,1,0,0,0,1
Angus,GASX,M,0,0,0,0,0,1,1
Angus,GAX,F,0,0,0,6,0,28,34
Angus,GE,F,0,3,0,0,0,0,3
Angus,GE,M,0,2,0,0,0,1,3
Angus,GEX,F,19,15,0,0,1,0,35
Angus,GEX,M,11,16,0,0,0,0,27
Angus,H,F,0,0,0,0,0,1,1
Angus,HE,F,13,9,10,7,5,18,62
Angus,HE,M,9,13,1,1,2,0,26
Angus,HEBL,F,0,0,0,0,0,1,1
Angus,HEBLX,F,0,0,0,0,0,3,3
Angus,HER,F,0,0,0,0,0,1,1
Angus,HERX,F,0,0,0,0,0,4,4
Angus,HEX,F,22,17,17,13,11,290,370
Angus,HEX,M,34,25,7,0,0,0,66
Angus,HF,F,569,673,424,389,314,730,"3,099"
Angus,HF,M,572,521,125,4,7,29,"1,258"
Angus,HFX,F,0,14,0,2,0,32,48
Angus,HFX,M,1,20,7,1,0,0,29
Angus,HI,F,49,62,18,27,45,154,355
Angus,HI,M,49,92,15,9,6,8,179
Angus,HIX,F,5,15,17,14,7,17,75
Angus,HIX,M,7,0,0,0,0,0,7
Angus,HL,F,0,0,0,0,0,35,35
Angus,HL,M,0,0,0,0,0,3,3
Angus,HLX,F,0,0,0,0,0,1,1
Angus,HO,F,7,11,35,50,67,54,224
Angus,HO,M,92,129,22,3,5,2,253
Angus,HOX,F,0,0,1,1,1,16,19
Angus,HOX,M,4,3,3,0,0,2,12
Angus,HX,F,0,0,0,0,0,7,7
Angus,IMX,F,0,0,1,0,0,0,1
Angus,JE,F,0,1,0,0,0,1,2
Angus,JE,M,0,3,4,0,0,0,7
Angus,JEX,M,0,1,0,0,0,0,1
Angus,LH,F,0,6,0,0,0,2,8
Angus,LH,M,0,2,0,0,0,0,2
Angus,LHX,F,1,1,1,0,0,1,4
Angus,LI,F,0,0,0,0,0,22,22
Angus,LI,M,0,0,0,0,0,4,4
Angus,LIM,F,97,167,53,49,43,217,626
Angus,LIM,M,113,118,43,27,16,48,365
Angus,LIMB,F,0,0,0,0,0,3,3
Angus,LIMB,M,0,0,0,0,0,1,1
Angus,LIMBX,F,0,0,0,0,0,58,58
Angus,LIMBX,M,0,0,0,0,0,1,1
Angus,LIMR,F,0,0,0,0,0,5,5
Angus,LIMR,M,0,0,0,0,0,3,3
Angus,LIMRX,F,0,0,0,0,0,61,61
Angus,LIMX,F,"1,907","2,820",644,449,410,"1,596","7,826"
Angus,LIMX,M,"1,919","2,114",238,4,2,18,"4,295"
Angus,LIX,F,0,0,0,0,0,97,97
Angus,LM,F,0,0,0,0,0,84,84
Angus,LM,M,0,0,0,0,0,31,31
Angus,LMX,F,0,0,0,0,0,745,745
Angus,LMX,M,0,0,0,0,0,65,65
Angus,LR,F,0,1,0,0,0,1,2
Angus,LR,M,0,0,0,1,0,0,1
Angus,LRX,F,5,0,0,0,0,1,6
Angus,LRX,M,2,0,0,0,0,0,2
Angus,LU,F,21,28,42,31,20,64,206
Angus,LU,M,43,1,0,0,0,1,45
Angus,LUX,F,4,1,1,0,11,50,67
Angus,LUX,M,6,4,0,0,0,1,11
Angus,MG,F,7,7,2,17,4,44,81
Angus,MG,M,14,0,0,0,0,0,14
Angus,MGX,F,0,0,0,0,0,2,2
Angus,MO,M,2,5,0,0,0,0,7
Angus,MOX,F,0,1,0,0,0,0,1
Angus,MOX,M,0,7,3,0,0,0,10
Angus,MRI,M,0,12,0,0,0,0,12
Angus,MRIX,F,0,0,6,0,0,0,6
Angus,MRIX,M,0,4,5,0,0,0,9
Angus,NS,F,0,0,0,0,0,46,46
Angus,OB,F,0,0,0,0,0,26,26
Angus,OO,F,0,0,0,0,0,8,8
Angus,OO,M,0,0,0,0,0,3,3
Angus,PAX,F,0,10,1,0,0,0,11
Angus,PAX,M,0,1,0,0,0,0,1
Angus,RO,F,0,0,0,0,0,7,7
Angus,ROX,F,0,0,0,0,0,10,10
Angus,RP,F,0,0,0,0,0,1,1
Angus,SA,F,0,1,0,4,2,18,25
Angus,SA,M,0,1,0,1,0,2,4
Angus,SAX,F,49,72,40,50,64,153,428
Angus,SAX,M,68,33,9,0,0,0,110
Angus,SBX,F,0,0,0,0,2,0,2
Angus,SD,F,0,2,2,0,0,0,4
Angus,SD,M,0,0,0,0,0,1,1
Angus,SDX,F,10,4,7,1,0,1,23
Angus,SDX,M,11,7,0,0,0,0,18
Angus,SH,F,0,0,0,0,0,1,1
Angus,SH,M,2,0,0,0,0,0,2
Angus,SHO,F,0,1,0,0,1,24,26
Angus,SHO,M,0,24,0,1,2,3,30
Angus,SHOX,F,29,33,8,7,12,102,191
Angus,SHOX,M,21,40,0,0,0,2,63
Angus,SHX,F,0,0,0,0,0,5,5
Angus,SHX,M,0,1,0,0,0,0,1
Angus,SM,F,83,77,69,51,45,276,601
Angus,SM,M,87,62,27,21,17,52,266
Angus,SMX,F,"1,381","1,381",698,570,572,"2,868","7,470"
Angus,SMX,M,"1,470",952,112,2,1,72,"2,609"
Angus,SRWX,M,0,1,0,0,0,0,1
Angus,ST,M,0,0,3,0,0,0,3
Angus,STX,F,0,0,0,1,0,0,1
Angus,SUX,F,0,0,0,0,0,2,2
Angus,WB,F,0,0,0,0,0,2,2
Angus,WBX,F,0,0,0,4,0,5,9
Angus,WG,F,0,0,0,0,1,0,1
Angus,WGX,F,1,1,0,0,0,0,2
Angus,WSX,F,1,21,0,5,2,8,37
Angus,WSX,M,0,1,0,0,0,0,1
Argyll,AA,F,51,36,36,24,25,231,403
Argyll,AA,M,44,17,16,19,14,32,142
Argyll,AAX,F,878,540,333,252,298,"1,432","3,733"
Argyll,AAX,M,870,282,20,3,1,19,"1,195"
Argyll,AR,F,0,0,0,0,0,1,1
Argyll,ARX,F,0,0,1,0,0,0,1
Argyll,AY,F,212,260,252,142,191,510,"1,567"
Argyll,AY,M,49,27,10,1,0,3,90
Argyll,AYX,F,5,9,17,8,10,22,71
Argyll,AYX,M,1,0,1,0,0,0,2
Argyll,BA,F,0,0,0,1,0,5,6
Argyll,BA,M,1,1,0,1,1,4,8
Argyll,BARX,F,0,0,0,0,0,1,1
Argyll,BAWX,F,0,0,0,0,0,4,4
Argyll,BAX,F,106,19,9,13,10,143,300
Argyll,BAX,M,101,7,0,0,0,11,119
Argyll,BAZ,F,1,0,0,0,0,2,3
Argyll,BAZ,M,0,1,0,1,0,0,2
Argyll,BAZX,F,2,0,0,0,0,1,3
Argyll,BAZX,M,3,0,0,0,0,0,3
Argyll,BB,F,19,12,14,10,4,63,122
Argyll,BB,M,8,3,5,1,2,7,26
Argyll,BBX,F,378,237,160,175,145,526,"1,621"
Argyll,BBX,M,355,146,25,0,0,16,542
Argyll,BF,F,103,85,106,77,79,161,611
Argyll,BF,M,95,82,13,1,1,0,192
Argyll,BFX,F,0,1,7,3,4,8,23
Argyll,BFX,M,1,0,0,0,0,0,1
Argyll,BG,F,1,1,0,1,0,5,8
Argyll,BGX,F,0,0,1,2,1,8,12
Argyll,BGX,M,1,1,0,0,0,0,2
Argyll,BH,F,11,0,0,0,0,56,67
Argyll,BHX,F,1,0,0,0,0,3,4
Argyll,BHX,M,1,0,0,0,0,0,1
Argyll,BLG,F,40,41,27,51,33,108,300
Argyll,BLG,M,15,14,0,1,0,0,30
Argyll,BLGX,F,0,0,0,0,0,1,1
Argyll,BS,F,0,6,0,0,0,1,7
Argyll,BS,M,0,1,0,0,0,0,1
Argyll,BSH,F,10,6,1,10,3,6,36
Argyll,BSH,M,13,6,2,4,4,6,35
Argyll,BSHX,F,74,38,32,35,35,64,278
Argyll,BSHX,M,64,10,3,0,0,0,77
Argyll,BSX,F,15,10,0,0,2,1,28
Argyll,BSX,M,3,0,0,0,0,0,3
Argyll,BW,F,1,1,2,0,0,0,4
Argyll,BW,M,0,2,0,0,0,2,4
Argyll,BWX,F,6,1,1,1,1,1,11
Argyll,BWX,M,7,0,0,0,0,1,8
Argyll,CB,F,0,0,0,0,0,14,14
Argyll,CH,F,49,15,12,19,9,62,166
Argyll,CH,M,36,25,23,13,13,61,171
Argyll,CHX,F,"1,231",214,54,49,58,689,"2,295"
Argyll,CHX,M,"1,174",222,46,6,6,144,"1,598"
Argyll,DEVX,F,1,0,0,0,0,0,1
Argyll,DEX,F,9,4,7,4,2,17,43
Argyll,DEX,M,13,9,1,2,0,1,26
Argyll,DG,F,0,0,0,0,0,3,3
Argyll,DGX,F,0,0,0,0,0,1,1
Argyll,DGX,M,0,0,0,0,0,1,1
Argyll,DS,F,0,0,0,0,0,1,1
Argyll,DSX,F,0,0,0,0,2,0,2
Argyll,DSX,M,2,0,0,0,0,0,2
Argyll,DV,F,0,0,0,0,0,1,1
Argyll,FR,F,0,0,0,0,0,263,263
Argyll,FR,M,0,0,0,0,0,1,1
Argyll,FRX,F,0,0,0,0,0,4,4
Argyll,GA,F,52,30,46,35,54,398,615
Argyll,GA,M,39,15,6,5,5,8,78
Argyll,GAX,F,6,7,3,0,9,162,187
Argyll,GAX,M,6,6,0,0,0,10,22
Argyll,GL,F,0,0,0,0,0,1,1
Argyll,GLX,F,2,0,0,0,0,7,9
Argyll,GU,F,0,0,3,2,1,10,16
Argyll,GUX,F,0,0,6,3,5,0,14
Argyll,GY,F,0,0,0,0,0,2,2
Argyll,GY,M,0,0,0,0,0,2,2
Argyll,GYX,F,0,0,0,0,0,1,1
Argyll,H,F,0,0,0,0,0,1,1
Argyll,HE,F,0,1,0,0,3,7,11
Argyll,HE,M,0,0,0,0,0,2,2
Argyll,HEBLX,F,0,0,0,0,0,15,15
Argyll,HER,F,0,0,0,0,0,2,2
Argyll,HER,M,0,0,0,0,0,1,1
Argyll,HERX,F,0,0,0,0,0,3,3
Argyll,HEX,F,32,26,10,20,23,220,331
Argyll,HEX,M,50,12,3,1,0,9,75
Argyll,HF,F,485,468,511,493,474,"1,561","3,992"
Argyll,HF,M,312,265,55,2,4,36,674
Argyll,HFX,F,4,5,4,4,1,35,53
Argyll,HI,F,395,308,203,196,170,903,"2,175"
Argyll,HI,M,253,172,55,43,30,38,591
Argyll,HIX,F,22,15,19,13,20,112,201
Argyll,HIX,M,17,3,3,1,1,4,29
Argyll,HL,F,0,0,0,0,0,433,433
Argyll,HL,M,0,0,0,0,0,53,53
Argyll,HLX,F,0,0,0,0,0,36,36
Argyll,HLX,M,0,0,0,0,0,5,5
Argyll,HO,F,322,348,420,334,251,282,"1,957"
Argyll,HO,M,97,124,37,2,1,0,261
Argyll,HOX,F,0,0,1,1,2,2,6
Argyll,HX,F,0,0,0,0,0,14,14
Argyll,JE,F,4,4,6,5,5,15,39
Argyll,JE,M,3,1,0,0,0,0,4
Argyll,JEX,F,0,2,1,0,0,2,5
Argyll,JEX,M,2,0,0,0,0,0,2
Argyll,KE,F,0,0,0,0,0,1,1
Argyll,LH,F,0,1,0,3,0,1,5
Argyll,LH,M,0,0,1,0,1,0,2
Argyll,LHX,F,17,10,0,1,2,5,35
Argyll,LHX,M,2,0,0,0,0,0,2
Argyll,LI,F,0,0,0,0,0,6,6
Argyll,LI,M,0,0,0,0,0,6,6
Argyll,LIM,F,241,117,104,114,93,238,907
Argyll,LIM,M,216,81,52,44,42,119,554
Argyll,LIMB,F,0,0,0,0,0,11,11
Argyll,LIMBX,F,0,0,0,0,0,163,163
Argyll,LIMR,F,0,0,0,0,0,6,6
Argyll,LIMR,M,0,0,0,0,0,5,5
Argyll,LIMRX,F,0,0,0,0,0,90,90
Argyll,LIMRX,M,0,0,0,0,0,2,2
Argyll,LIMX,F,"3,282","1,148",856,899,850,"3,193","10,228"
Argyll,LIMX,M,"3,301",602,87,11,5,19,"4,025"
Argyll,LIX,F,0,0,0,0,0,57,57
Argyll,LM,F,0,0,0,0,0,173,173
Argyll,LM,M,0,0,0,0,0,47,47
Argyll,LMX,F,0,0,0,0,0,"1,554","1,554"
Argyll,LMX,M,0,0,0,0,0,219,219
Argyll,LR,M,1,0,0,0,0,0,1
Argyll,LRX,F,4,0,0,0,0,12,16
Argyll,LRX,M,2,0,0,0,0,0,2
Argyll,LU,F,296,217,187,155,128,661,"1,644"
Argyll,LU,M,86,17,8,15,14,29,169
Argyll,LUX,F,77,17,12,11,16,132,265
Argyll,LUX,M,30,5,0,0,0,2,37
Argyll,MGX,F,0,0,0,0,0,3,3
Argyll,MO,F,0,0,0,1,0,0,1
Argyll,MO,M,0,1,0,1,0,0,2
Argyll,MOX,F,18,6,5,0,0,2,31
Argyll,MOX,M,13,0,0,0,0,0,13
Argyll,MRIX,F,0,0,5,16,17,7,45
Argyll,NOX,F,0,0,0,0,0,5,5
Argyll,NR,F,1,0,0,0,0,0,1
Argyll,NRX,F,10,0,0,0,0,1,11
Argyll,NRX,M,5,0,0,0,0,0,5
Argyll,NS,F,0,0,0,0,0,77,77
Argyll,OB,F,0,0,0,0,0,20,20
Argyll,OB,M,0,0,0,0,0,6,6
Argyll,OD,F,0,0,0,0,0,3,3
Argyll,OO,F,0,0,0,0,0,7,7
Argyll,OO,M,0,0,0,0,0,2,2
Argyll,PIX,F,0,0,0,0,0,2,2
Argyll,RO,F,0,0,0,0,0,2,2
Argyll,ROX,F,0,2,0,3,0,19,24
Argyll,ROX,M,0,2,0,0,0,1,3
Argyll,SA,F,6,3,5,10,4,48,76
Argyll,SA,M,4,1,2,0,1,7,15
Argyll,SAX,F,56,42,44,50,55,591,838
Argyll,SAX,M,53,7,1,1,0,23,85
Argyll,SD,F,8,2,2,1,4,15,32
Argyll,SD,M,4,1,0,0,2,0,7
Argyll,SDX,M,6,0,0,0,0,0,6
Argyll,SH,F,0,0,0,0,0,4,4
Argyll,SHO,F,6,10,1,6,1,38,62
Argyll,SHO,M,10,2,0,1,3,11,27
Argyll,SHOX,F,219,163,123,133,102,624,"1,364"
Argyll,SHOX,M,143,49,8,2,0,17,219
Argyll,SHX,F,0,1,1,0,0,8,10
Argyll,SHX,M,1,1,0,0,0,0,2
Argyll,SM,F,53,16,34,19,28,238,388
Argyll,SM,M,42,17,9,8,12,38,126
Argyll,SMX,F,774,471,290,249,278,"2,427","4,489"
Argyll,SMX,M,657,204,31,3,5,135,"1,035"
Argyll,SRW,M,1,0,0,0,0,0,1
Argyll,SRWX,F,27,8,2,0,0,0,37
Argyll,SRWX,M,9,6,0,0,0,0,15
Argyll,WB,F,2,0,0,0,1,6,9
Argyll,WB,M,1,1,0,0,0,0,2
Argyll,WBX,F,10,1,6,1,2,3,23
Argyll,WBX,M,9,1,0,0,0,0,10
Argyll,WG,F,0,0,0,0,0,1,1
Argyll,WP,F,0,0,1,0,0,3,4
Argyll,WP,M,0,0,0,0,1,0,1
Argyll,WS,F,2,0,1,0,1,4,8
Argyll,WS,M,0,0,0,0,0,9,9
Argyll,WSX,F,52,69,74,65,60,235,555
Argyll,WSX,M,54,7,2,0,0,0,63
Argyll,ZE,F,0,0,0,0,0,1,1
Ayrshire,AA,F,543,557,326,255,184,929,"2,794"
Ayrshire,AA,M,613,436,114,49,32,100,"1,344"
Ayrshire,AAX,F,"2,358","2,025","1,115",747,694,"3,815","10,754"
Ayrshire,AAX,M,"2,404","1,787",322,16,17,155,"4,701"
Ayrshire,AM,F,1,0,0,0,0,0,1
Ayrshire,AN,F,1,0,2,0,0,0,3
Ayrshire,AN,M,1,0,0,0,0,0,1
Ayrshire,AR,F,2,1,0,0,0,1,4
Ayrshire,AR,M,1,0,0,0,0,0,1
Ayrshire,ARX,F,0,0,2,0,0,1,3
Ayrshire,ARX,M,1,0,0,0,0,0,1
Ayrshire,AY,F,965,902,848,809,729,"2,184","6,437"
Ayrshire,AY,M,212,65,27,8,7,52,371
Ayrshire,AYX,F,60,56,74,59,51,88,388
Ayrshire,AYX,M,2,3,1,0,0,1,7
Ayrshire,BA,F,13,4,4,5,6,61,93
Ayrshire,BA,M,12,5,3,6,3,17,46
Ayrshire,BABX,F,0,0,0,0,0,4,4
Ayrshire,BARX,F,0,0,0,0,0,5,5
Ayrshire,BARX,M,0,0,0,0,0,1,1
Ayrshire,BAX,F,262,224,72,43,31,305,937
Ayrshire,BAX,M,269,226,31,2,0,88,616
Ayrshire,BAZX,F,1,0,0,0,0,5,6
Ayrshire,BB,F,97,133,81,47,42,226,626
Ayrshire,BB,M,133,130,52,17,7,40,379
Ayrshire,BBX,F,"1,418","1,231",471,360,319,999,"4,798"
Ayrshire,BBX,M,"1,463","1,318",188,10,10,59,"3,048"
Ayrshire,BF,F,"1,231","1,185","1,462","1,365","1,325","2,273","8,841"
Ayrshire,BF,M,"1,176",945,306,27,59,35,"2,548"
Ayrshire,BFX,F,42,95,75,76,116,165,569
Ayrshire,BFX,M,29,61,4,2,1,0,97
Ayrshire,BG,F,19,16,9,7,13,63,127
Ayrshire,BG,M,14,12,2,0,2,5,35
Ayrshire,BGX,F,6,13,12,8,9,39,87
Ayrshire,BGX,M,10,12,4,0,0,7,33
Ayrshire,BH,F,3,0,0,0,0,171,174
Ayrshire,BH,M,5,0,0,0,0,0,5
Ayrshire,BHX,F,0,0,0,0,0,29,29
Ayrshire,BI,F,0,0,0,0,0,1,1
Ayrshire,BLG,F,1,2,8,18,7,49,85
Ayrshire,BRX,F,2,0,0,0,0,0,2
Ayrshire,BS,F,3,12,11,9,18,30,83
Ayrshire,BS,M,2,2,0,0,0,0,4
Ayrshire,BSH,F,30,14,20,10,8,15,97
Ayrshire,BSH,M,36,16,3,3,2,4,64
Ayrshire,BSHX,F,148,152,88,48,27,78,541
Ayrshire,BSHX,M,140,41,6,1,0,1,189
Ayrshire,BSX,F,5,32,73,16,22,26,174
Ayrshire,BSX,M,1,3,0,0,0,1,5
Ayrshire,BWX,F,0,0,0,0,0,1,1
Ayrshire,BWX,M,0,3,0,0,0,0,3
Ayrshire,BX,F,0,0,0,0,0,1,1
Ayrshire,CAX,F,0,0,0,0,0,1,1
Ayrshire,CB,F,0,0,0,0,0,11,11
Ayrshire,CB,M,0,1,0,0,0,0,1
Ayrshire,CD,F,0,0,0,0,0,3,3
Ayrshire,CH,F,76,70,42,37,25,169,419
Ayrshire,CH,M,88,81,56,45,33,108,411
Ayrshire,CHIX,F,1,0,0,0,0,0,1
Ayrshire,CHX,F,"3,365","1,824",149,84,85,"1,011","6,518"
Ayrshire,CHX,M,"3,067","1,821",203,16,6,402,"5,515"
Ayrshire,DEVX,F,0,0,0,0,0,1,1
Ayrshire,DEX,F,0,4,2,2,1,6,15
Ayrshire,DEX,M,3,1,0,0,0,0,4
Ayrshire,DEXX,F,0,3,0,1,3,0,7
Ayrshire,DEXX,M,0,7,0,0,0,0,7
Ayrshire,DG,F,0,0,0,0,0,7,7
Ayrshire,DGX,F,0,0,0,0,0,1,1
Ayrshire,DR,F,0,0,45,0,0,0,45
Ayrshire,DRX,F,0,0,3,0,0,0,3
Ayrshire,DS,F,0,0,1,1,1,3,6
Ayrshire,DSX,F,0,0,10,10,11,1,32
Ayrshire,FR,F,0,0,0,0,0,"3,265","3,265"
Ayrshire,FR,M,0,0,0,0,0,58,58
Ayrshire,FRX,F,0,0,0,0,0,143,143
Ayrshire,GA,F,15,11,9,14,13,119,181
Ayrshire,GA,M,9,19,1,1,1,3,34
Ayrshire,GASX,F,0,0,0,0,0,1,1
Ayrshire,GAX,F,1,6,0,9,2,70,88
Ayrshire,GAX,M,1,3,0,0,0,3,7
Ayrshire,GE,F,0,0,0,0,0,1,1
Ayrshire,GL,F,0,0,0,0,0,2,2
Ayrshire,GLX,F,0,0,0,0,0,3,3
Ayrshire,H,F,0,0,0,0,0,3,3
Ayrshire,H,M,0,0,0,0,0,1,1
Ayrshire,HE,F,63,25,18,4,4,131,245
Ayrshire,HE,M,67,31,12,3,1,28,142
Ayrshire,HEBL,F,0,0,0,0,0,1,1
Ayrshire,HEBLX,F,0,0,0,0,0,26,26
Ayrshire,HER,F,0,0,0,0,0,2,2
Ayrshire,HER,M,0,0,0,0,0,1,1
Ayrshire,HERX,F,0,0,0,0,0,10,10
Ayrshire,HEX,F,147,163,93,81,79,561,"1,124"
Ayrshire,HEX,M,129,168,26,2,0,12,337
Ayrshire,HF,F,"6,317","6,147","6,444","5,961","5,483","15,170","45,522"
Ayrshire,HF,M,"3,372","2,219",782,100,96,699,"7,268"
Ayrshire,HFX,F,165,166,182,141,99,369,"1,122"
Ayrshire,HFX,M,91,95,19,3,0,14,222
Ayrshire,HI,F,68,60,49,37,36,125,375
Ayrshire,HI,M,47,41,11,4,7,7,117
Ayrshire,HIX,F,7,3,3,1,3,5,22
Ayrshire,HIX,M,5,8,1,0,0,0,14
Ayrshire,HL,F,0,0,0,0,0,47,47
Ayrshire,HL,M,0,0,0,0,0,12,12
Ayrshire,HO,F,749,825,990,762,775,"1,301","5,402"
Ayrshire,HO,M,254,134,86,20,11,29,534
Ayrshire,HOX,F,155,152,208,196,158,300,"1,169"
Ayrshire,HOX,M,102,52,8,8,0,2,172
Ayrshire,HX,F,0,0,0,0,0,8,8
Ayrshire,IM,F,2,1,4,0,1,4,12
Ayrshire,IM,M,2,2,0,1,0,1,6
Ayrshire,IMX,F,4,7,3,0,0,1,15
Ayrshire,IMX,M,0,5,0,0,0,0,5
Ayrshire,JE,F,46,71,98,93,74,212,594
Ayrshire,JE,M,20,7,4,2,0,2,35
Ayrshire,JEX,F,16,20,10,2,2,13,63
Ayrshire,JEX,M,3,1,1,0,0,0,5
Ayrshire,JY,F,36,0,0,0,0,15,51
Ayrshire,JY,M,10,0,0,0,0,0,10
Ayrshire,JYX,F,0,0,0,0,0,6,6
Ayrshire,LH,F,1,0,2,2,1,5,11
Ayrshire,LH,M,0,0,0,0,0,1,1
Ayrshire,LHX,F,2,3,1,0,2,1,9
Ayrshire,LHX,M,15,4,0,0,0,1,20
Ayrshire,LI,F,0,0,0,0,0,20,20
Ayrshire,LI,M,0,0,0,0,0,9,9
Ayrshire,LIM,F,854,683,302,275,286,795,"3,195"
Ayrshire,LIM,M,861,668,177,86,73,179,"2,044"
Ayrshire,LIM X,F,0,0,0,0,0,1,1
Ayrshire,LIMB,F,0,0,0,0,0,16,16
Ayrshire,LIMB,M,0,0,0,0,0,1,1
Ayrshire,LIMBX,F,0,0,0,0,0,342,342
Ayrshire,LIMBX,M,0,0,0,0,0,5,5
Ayrshire,LIMR,F,0,0,0,0,0,7,7
Ayrshire,LIMR,M,0,0,0,0,0,2,2
Ayrshire,LIMRX,F,0,0,0,0,0,104,104
Ayrshire,LIMRX,M,0,0,0,0,0,3,3
Ayrshire,LIMX,F,"8,255","6,301","2,479","1,825","1,664","5,066","25,590"
Ayrshire,LIMX,M,"8,021","6,331","1,027",79,35,114,"15,607"
Ayrshire,LIX,F,0,0,0,0,0,174,174
Ayrshire,LM,F,0,0,0,0,0,583,583
Ayrshire,LM,M,0,0,0,0,0,167,167
Ayrshire,LMX,F,0,0,0,0,0,"2,509","2,509"
Ayrshire,LMX,M,0,0,0,0,0,496,496
Ayrshire,LR,F,2,0,1,0,1,5,9
Ayrshire,LR,M,2,0,1,0,0,0,3
Ayrshire,LRX,F,13,22,17,7,1,7,67
Ayrshire,LRX,M,12,10,4,0,0,0,26
Ayrshire,LU,F,15,12,14,13,4,38,96
Ayrshire,LU,M,43,2,0,2,0,2,49
Ayrshire,LUX,F,14,13,0,1,1,7,36
Ayrshire,LUX,M,13,3,0,0,0,1,17
Ayrshire,MARX,F,0,1,0,0,0,0,1
Ayrshire,MG,F,0,0,0,0,1,1,2
Ayrshire,MGX,F,0,0,0,0,0,9,9
Ayrshire,MO,F,23,10,4,7,32,16,92
Ayrshire,MO,M,13,11,2,4,0,0,30
Ayrshire,MOX,F,192,83,66,29,9,27,406
Ayrshire,MOX,M,153,38,6,0,0,0,197
Ayrshire,MRI,F,120,96,25,9,16,45,311
Ayrshire,MRI,M,109,84,15,1,1,1,211
Ayrshire,MRIX,F,36,23,38,36,48,54,235
Ayrshire,MRIX,M,30,10,2,0,0,0,42
Ayrshire,NO,F,0,0,1,1,0,0,2
Ayrshire,NOX,F,0,0,0,1,0,0,1
Ayrshire,NR,F,2,0,0,0,0,0,2
Ayrshire,NRX,F,11,0,0,0,0,1,12
Ayrshire,NRX,M,2,0,0,0,0,0,2
Ayrshire,NS,F,0,0,0,0,0,320,320
Ayrshire,NS,M,0,0,0,0,0,1,1
Ayrshire,OB,F,0,0,0,0,0,11,11
Ayrshire,OB,M,0,0,0,0,0,1,1
Ayrshire,OD,F,0,0,0,0,0,30,30
Ayrshire,OO,F,0,0,0,0,0,50,50
Ayrshire,OO,M,0,0,0,0,0,13,13
Ayrshire,PAX,F,0,3,0,0,0,1,4
Ayrshire,PAX,M,1,3,0,0,0,0,4
Ayrshire,PIX,F,0,0,0,0,1,1,2
Ayrshire,RO,F,0,0,0,0,0,1,1
Ayrshire,RO,M,0,0,1,0,0,0,1
Ayrshire,ROX,F,1,1,4,0,0,41,47
Ayrshire,ROX,M,1,1,0,0,0,7,9
Ayrshire,RPX,F,0,0,0,0,0,20,20
Ayrshire,SA,F,16,11,7,6,10,32,82
Ayrshire,SA,M,15,4,5,2,1,7,34
Ayrshire,SAX,F,93,65,75,71,60,513,877
Ayrshire,SAX,M,123,39,15,2,0,43,222
Ayrshire,SB,F,0,0,0,0,2,0,2
Ayrshire,SD,M,0,0,1,0,0,2,3
Ayrshire,SDX,F,58,19,32,30,3,4,146
Ayrshire,SDX,M,70,11,0,0,0,0,81
Ayrshire,SH,F,2,0,0,1,0,3,6
Ayrshire,SH,M,1,0,0,0,0,0,1
Ayrshire,SHO,F,10,6,4,5,7,29,61
Ayrshire,SHO,M,2,6,1,2,5,9,25
Ayrshire,SHOX,F,193,168,122,103,80,237,903
Ayrshire,SHOX,M,192,154,25,2,0,5,378
Ayrshire,SHX,F,0,1,4,0,1,9,15
Ayrshire,SHX,M,1,0,0,0,0,0,1
Ayrshire,SM,F,240,183,98,81,81,505,"1,188"
Ayrshire,SM,M,281,178,36,24,20,114,653
Ayrshire,SMX,F,"2,057","1,769",565,366,309,"1,877","6,943"
Ayrshire,SMX,M,"2,092","1,729",276,13,7,425,"4,542"
Ayrshire,SRWX,F,15,0,0,0,6,0,21
Ayrshire,SRWX,M,16,1,0,0,0,0,17
Ayrshire,ST,F,22,14,8,0,0,0,44
Ayrshire,ST,M,20,3,1,0,0,0,24
Ayrshire,SUX,F,0,0,1,1,2,1,5
Ayrshire,SUX,M,1,0,0,0,0,0,1
Ayrshire,WB,F,0,0,0,0,1,1,2
Ayrshire,WBX,F,0,0,0,0,1,1,2
Ayrshire,WG,F,6,2,8,2,1,21,40
Ayrshire,WG,M,3,2,1,0,0,0,6
Ayrshire,WGX,F,0,1,0,0,0,3,4
Ayrshire,WGX,M,2,0,0,0,0,0,2
Ayrshire,WP,F,0,0,1,0,0,2,3
Ayrshire,WP,M,1,0,0,0,0,1,2
Ayrshire,WPX,F,0,1,0,0,0,1,2
Ayrshire,WPX,M,0,0,1,0,0,0,1
Ayrshire,WS,F,0,1,0,1,1,2,5
Ayrshire,WS,M,1,3,0,0,0,1,5
Ayrshire,WSX,F,0,4,18,15,18,14,69
Ayrshire,WSX,M,1,18,1,0,0,0,20
Banffshire,AA,F,186,127,74,53,56,356,852
Banffshire,AA,M,190,150,17,12,12,29,410
Banffshire,AAX,F,816,647,299,200,190,921,"3,073"
Banffshire,AAX,M,925,921,34,4,0,18,"1,902"
Banffshire,ARX,M,1,0,0,0,0,0,1
Banffshire,AY,F,0,0,1,0,0,6,7
Banffshire,AY,M,0,1,0,2,0,0,3
Banffshire,BA,F,20,9,3,11,6,61,110
Banffshire,BA,M,28,5,3,0,2,13,51
Banffshire,BABX,F,0,0,0,0,0,2,2
Banffshire,BARX,F,0,0,0,0,0,1,1
Banffshire,BAX,F,147,142,36,56,39,227,647
Banffshire,BAX,M,180,139,10,1,0,17,347
Banffshire,BAZX,F,1,7,0,2,0,1,11
Banffshire,BAZX,M,3,2,0,0,0,0,5
Banffshire,BB,F,30,26,28,23,23,105,235
Banffshire,BB,M,8,11,5,3,1,14,42
Banffshire,BBX,F,486,417,283,223,255,889,"2,553"
Banffshire,BBX,M,344,325,30,2,5,9,715
Banffshire,BF,F,0,0,2,3,4,42,51
Banffshire,BF,M,1,5,17,4,0,0,27
Banffshire,BFX,F,0,0,0,0,0,1,1
Banffshire,BFX,M,0,0,1,0,0,0,1
Banffshire,BG,F,5,3,4,5,4,15,36
Banffshire,BG,M,7,5,3,0,0,1,16
Banffshire,BGX,F,0,0,0,0,0,5,5
Banffshire,BGX,M,0,1,0,0,0,0,1
Banffshire,BH,F,1,0,0,0,0,1,2
Banffshire,BLGX,F,0,1,0,0,0,0,1
Banffshire,BR,F,0,0,0,0,0,1,1
Banffshire,BRX,F,0,0,0,0,0,1,1
Banffshire,BS,M,0,1,0,0,0,0,1
Banffshire,BSH,F,13,9,2,2,8,3,37
Banffshire,BSH,M,9,3,1,1,0,0,14
Banffshire,BSHX,F,16,33,27,7,2,35,120
Banffshire,BSHX,M,42,43,1,0,0,0,86
Banffshire,BU,F,12,11,2,11,1,24,61
Banffshire,BU,M,14,13,0,0,0,1,28
Banffshire,BW,F,0,0,1,0,0,0,1
Banffshire,CB,F,0,0,0,0,0,3,3
Banffshire,CH,F,83,71,38,25,33,199,449
Banffshire,CH,M,67,92,38,37,16,145,395
Banffshire,CHIX,F,0,0,0,0,0,1,1
Banffshire,CHIX,M,0,1,0,0,0,0,1
Banffshire,CHX,F,"3,196","2,853",194,135,155,"1,150","7,683"
Banffshire,CHX,M,"3,434","3,923",240,16,3,199,"7,815"
Banffshire,DEV,F,0,0,0,0,0,1,1
Banffshire,DEVX,F,0,0,0,0,0,1,1
Banffshire,DEX,F,1,0,1,0,0,1,3
Banffshire,DEX,M,0,0,0,0,0,2,2
Banffshire,DEXX,F,0,0,0,0,0,1,1
Banffshire,DS,M,0,1,2,0,0,0,3
Banffshire,DSX,F,0,1,1,0,0,0,2
Banffshire,DVX,F,0,0,0,0,0,1,1
Banffshire,FR,F,0,0,0,0,0,129,129
Banffshire,GA,F,0,0,2,1,6,22,31
Banffshire,GAS,F,0,7,0,0,0,0,7
Banffshire,GAX,F,0,1,0,0,2,10,13
Banffshire,GAX,M,0,0,0,0,1,1,2
Banffshire,GBX,F,1,0,0,0,0,0,1
Banffshire,GEX,F,0,0,0,0,1,0,1
Banffshire,GEX,M,0,1,0,0,0,0,1
Banffshire,GL,M,0,1,0,0,0,0,1
Banffshire,H,F,0,0,0,0,0,2,2
Banffshire,HE,F,2,6,5,8,5,18,44
Banffshire,HE,M,5,0,0,2,0,2,9
Banffshire,HEBL,F,0,0,0,0,0,1,1
Banffshire,HEBLX,F,0,0,0,0,0,25,25
Banffshire,HER,F,0,0,0,0,0,1,1
Banffshire,HERX,F,0,0,0,0,0,2,2
Banffshire,HEX,F,104,113,102,55,53,315,742
Banffshire,HEX,M,62,75,4,0,0,0,141
Banffshire,HF,F,138,162,150,160,110,218,938
Banffshire,HF,M,97,34,47,5,1,17,201
Banffshire,HFX,F,0,1,2,0,0,19,22
Banffshire,HFX,M,0,1,3,0,0,2,6
Banffshire,HI,F,56,35,22,13,20,108,254
Banffshire,HI,M,40,40,7,7,6,12,112
Banffshire,HIX,F,2,4,2,2,2,1,13
Banffshire,HIX,M,9,10,0,0,0,0,19
Banffshire,HL,F,0,0,0,0,0,32,32
Banffshire,HL,M,0,0,0,0,0,5,5
Banffshire,HLX,F,0,0,0,0,0,1,1
Banffshire,HO,F,1,8,11,6,7,4,37
Banffshire,HO,M,27,31,6,11,0,1,76
Banffshire,HOX,F,87,102,66,52,66,8,381
Banffshire,HOX,M,80,20,0,0,0,0,100
Banffshire,HX,F,0,0,0,0,0,4,4
Banffshire,IM,F,0,0,0,0,0,1,1
Banffshire,IMX,F,0,0,0,0,1,1,2
Banffshire,JE,F,0,2,1,10,2,10,25
Banffshire,JE,M,0,0,0,1,0,1,2
Banffshire,JY,F,0,0,0,0,0,1,1
Banffshire,JY,M,0,0,0,0,0,1,1
Banffshire,JYX,F,0,0,0,0,0,1,1
Banffshire,LH,F,2,2,3,2,1,8,18
Banffshire,LH,M,1,4,0,0,0,1,6
Banffshire,LHX,F,5,6,0,0,1,1,13
Banffshire,LHX,M,5,3,0,0,0,0,8
Banffshire,LI,F,0,0,0,0,0,14,14
Banffshire,LI,M,0,0,0,0,0,6,6
Banffshire,LIM,F,145,145,64,84,39,216,693
Banffshire,LIM,M,148,190,46,25,31,79,519
Banffshire,LIMB,F,0,0,0,0,0,5,5
Banffshire,LIMB,M,0,0,0,0,0,1,1
Banffshire,LIMBX,F,0,0,0,0,0,81,81
Banffshire,LIMR,F,0,0,0,0,0,13,13
Banffshire,LIMR,M,0,0,0,0,0,4,4
Banffshire,LIMRX,F,0,0,0,0,0,101,101
Banffshire,LIMX,F,"3,004","2,747",728,662,629,"2,207","9,977"
Banffshire,LIMX,M,"2,846","3,206",278,20,8,22,"6,380"
Banffshire,LIX,F,0,0,0,0,0,78,78
Banffshire,LM,F,0,0,0,0,0,126,126
Banffshire,LM,M,0,0,0,0,0,30,30
Banffshire,LMX,F,0,0,0,0,0,934,934
Banffshire,LMX,M,0,0,0,0,0,129,129
Banffshire,LRX,F,0,0,0,0,0,1,1
Banffshire,LRX,M,0,0,1,0,0,0,1
Banffshire,LU,F,8,6,1,0,0,13,28
Banffshire,LU,M,35,26,0,0,0,0,61
Banffshire,LUX,F,1,4,0,1,0,13,19
Banffshire,LUX,M,5,6,0,0,0,0,11
Banffshire,MO,M,1,4,0,0,0,0,5
Banffshire,MOX,F,0,0,0,0,0,3,3
Banffshire,MOX,M,1,6,0,0,0,0,7
Banffshire,MRIX,F,0,0,0,0,1,0,1
Banffshire,MRIX,M,0,2,0,0,0,0,2
Banffshire,NS,F,0,0,0,0,0,63,63
Banffshire,OB,F,0,0,0,0,0,2,2
Banffshire,OB,M,0,0,0,0,0,1,1
Banffshire,OO,F,0,0,0,0,0,17,17
Banffshire,OO,M,0,0,0,0,0,4,4
Banffshire,PAX,F,0,0,0,0,1,0,1
Banffshire,PAX,M,0,10,0,0,0,0,10
Banffshire,PI,F,0,0,0,0,0,1,1
Banffshire,PIX,F,0,0,0,0,0,1,1
Banffshire,RO,F,9,0,0,0,0,1,10
Banffshire,RO,M,4,0,0,0,0,1,5
Banffshire,ROX,F,2,0,0,0,1,24,27
Banffshire,ROX,M,3,1,0,0,0,1,5
Banffshire,SA,F,1,0,1,2,2,18,24
Banffshire,SA,M,3,2,0,1,1,0,7
Banffshire,SAX,F,34,57,67,30,59,143,390
Banffshire,SAX,M,41,70,5,0,1,0,117
Banffshire,SD,F,1,0,0,0,1,6,8
Banffshire,SD,M,0,0,0,1,0,1,2
Banffshire,SDX,F,18,17,5,3,1,13,57
Banffshire,SDX,M,25,20,2,1,0,0,48
Banffshire,SH,F,0,0,0,0,0,5,5
Banffshire,SH,M,6,1,0,0,0,0,7
Banffshire,SHO,F,0,1,0,0,3,6,10
Banffshire,SHO,M,1,0,0,0,0,0,1
Banffshire,SHOX,F,26,17,22,9,8,79,161
Banffshire,SHOX,M,49,49,4,1,0,1,104
Banffshire,SHX,F,8,0,0,1,2,2,13
Banffshire,SHX,M,3,2,0,0,0,0,5
Banffshire,SM,F,189,213,128,135,90,633,"1,388"
Banffshire,SM,M,180,159,32,26,13,81,491
Banffshire,SMX,F,"2,028","1,644","1,086",910,801,"4,562","11,031"
Banffshire,SMX,M,"2,086","1,386",116,9,6,125,"3,728"
Banffshire,STX,F,0,0,0,1,3,0,4
Banffshire,STX,M,0,5,0,0,0,0,5
Banffshire,SUX,F,0,0,0,0,0,1,1
Banffshire,WB,F,0,0,0,0,0,5,5
Banffshire,WBX,F,0,1,0,1,0,1,3
Banffshire,WBX,M,0,1,0,0,0,0,1
Banffshire,WP,F,0,0,0,0,0,1,1
Banffshire,WS,M,0,0,0,0,0,1,1
Banffshire,WSX,F,11,5,0,1,0,0,17
Banffshire,WSX,M,18,2,0,0,0,0,20
Berwickshire,AA,F,304,252,141,136,121,546,"1,500"
Berwickshire,AA,M,290,191,43,30,27,50,631
Berwickshire,AAX,F,"1,926","1,450",625,522,493,"1,675","6,691"
Berwickshire,AAX,M,"1,979","1,452",97,9,3,84,"3,624"
Berwickshire,AMX,F,0,1,0,0,0,0,1
Berwickshire,ARX,F,0,1,0,0,0,0,1
Berwickshire,ARX,M,1,0,0,0,0,0,1
Berwickshire,AY,F,1,3,0,0,4,7,15
Berwickshire,AY,M,3,0,0,0,0,26,29
Berwickshire,AYX,F,2,0,1,2,1,1,7
Berwickshire,BA,F,0,7,6,0,9,43,65
Berwickshire,BA,M,6,5,2,1,2,14,30
Berwickshire,BAB,F,0,0,0,0,0,1,1
Berwickshire,BABX,F,0,0,0,0,0,2,2
Berwickshire,BARX,F,0,0,0,0,0,2,2
Berwickshire,BARX,M,0,0,0,0,0,1,1
Berwickshire,BAX,F,160,232,38,28,28,177,663
Berwickshire,BAX,M,154,187,16,1,3,41,402
Berwickshire,BAZX,F,0,4,0,0,0,0,4
Berwickshire,BAZX,M,0,3,1,0,0,0,4
Berwickshire,BB,F,29,20,13,12,10,135,219
Berwickshire,BB,M,7,18,6,2,4,11,48
Berwickshire,BBX,F,263,423,155,144,159,626,"1,770"
Berwickshire,BBX,M,217,316,102,4,1,27,667
Berwickshire,BF,F,14,20,6,3,9,22,74
Berwickshire,BF,M,14,23,10,2,0,0,49
Berwickshire,BFX,F,0,0,0,1,0,0,1
Berwickshire,BFX,M,1,2,2,0,0,0,5
Berwickshire,BGX,F,1,0,0,0,0,1,2
Berwickshire,BGX,M,0,1,0,0,0,0,1
Berwickshire,BH,F,0,0,0,0,0,7,7
Berwickshire,BHX,F,0,0,0,0,0,1,1
Berwickshire,BLG,F,5,2,0,3,0,8,18
Berwickshire,BLG,M,8,0,0,0,0,0,8
Berwickshire,BP,F,0,0,0,0,0,1,1
Berwickshire,BS,M,1,0,0,0,0,0,1
Berwickshire,BSH,F,11,6,11,5,4,6,43
Berwickshire,BSH,M,9,1,5,2,0,3,20
Berwickshire,BSHX,F,21,3,20,17,15,21,97
Berwickshire,BSHX,M,18,22,14,0,0,0,54
Berwickshire,BSX,M,0,2,0,0,0,0,2
Berwickshire,BW,M,0,2,0,0,0,0,2
Berwickshire,CB,F,0,0,0,0,1,36,37
Berwickshire,CH,F,31,39,14,16,8,68,176
Berwickshire,CH,M,30,63,25,10,12,53,193
Berwickshire,CHX,F,"1,446","1,233",50,55,41,497,"3,322"
Berwickshire,CHX,M,"1,578","1,380",62,10,3,162,"3,195"
Berwickshire,DE,F,0,0,0,0,0,1,1
Berwickshire,DEV,F,0,1,0,0,0,0,1
Berwickshire,DEVX,F,0,3,0,0,0,0,3
Berwickshire,DEX,F,0,1,0,0,0,0,1
Berwickshire,DEX,M,0,1,0,0,0,0,1
Berwickshire,DS,M,0,0,2,0,0,0,2
Berwickshire,DVX,F,0,0,0,0,0,1,1
Berwickshire,FR,F,0,0,0,0,0,75,75
Berwickshire,FRX,F,0,0,0,0,0,6,6
Berwickshire,GA,F,22,20,22,14,9,51,138
Berwickshire,GA,M,22,15,5,4,1,1,48
Berwickshire,GASX,F,0,0,0,0,0,1,1
Berwickshire,GAX,F,1,1,7,4,10,15,38
Berwickshire,GAX,M,2,5,0,0,1,0,8
Berwickshire,GEX,F,0,0,0,2,0,3,5
Berwickshire,GEX,M,1,3,1,0,0,0,5
Berwickshire,GL,M,0,0,3,0,0,0,3
Berwickshire,H,F,0,0,0,0,0,1,1
Berwickshire,HE,F,2,5,3,1,8,33,52
Berwickshire,HE,M,2,0,1,0,0,5,8
Berwickshire,HEBL,F,0,0,0,0,0,1,1
Berwickshire,HEBLX,F,0,0,0,0,0,18,18
Berwickshire,HER,F,0,0,0,0,0,1,1
Berwickshire,HERX,F,0,0,0,0,0,7,7
Berwickshire,HEX,F,35,71,39,70,55,359,629
Berwickshire,HEX,M,6,47,9,0,0,1,63
Berwickshire,HF,F,392,344,462,268,160,545,"2,171"
Berwickshire,HF,M,205,49,22,5,0,110,391
Berwickshire,HFX,F,1,2,1,0,0,20,24
Berwickshire,HFX,M,1,3,7,1,0,1,13
Berwickshire,HI,F,22,21,31,12,6,61,153
Berwickshire,HI,M,19,19,8,1,0,3,50
Berwickshire,HIX,F,4,0,0,0,0,2,6
Berwickshire,HL,F,0,0,0,0,0,14,14
Berwickshire,HL,M,0,0,0,0,0,2,2
Berwickshire,HO,F,287,233,221,202,222,197,"1,362"
Berwickshire,HO,M,200,20,1,0,1,3,225
Berwickshire,HOX,F,7,5,1,5,2,1,21
Berwickshire,HOX,M,3,1,0,0,0,0,4
Berwickshire,HX,F,0,0,0,0,0,23,23
Berwickshire,IMX,F,0,0,0,0,0,1,1
Berwickshire,IMX,M,0,1,0,0,0,0,1
Berwickshire,JE,F,0,0,0,0,0,4,4
Berwickshire,JEX,F,0,0,0,0,1,4,5
Berwickshire,JEX,M,0,1,0,0,0,0,1
Berwickshire,LH,F,13,4,1,22,10,11,61
Berwickshire,LH,M,14,8,1,1,2,0,26
Berwickshire,LHX,F,12,10,2,0,0,1,25
Berwickshire,LHX,M,9,4,0,0,0,0,13
Berwickshire,LI,F,0,0,0,0,0,34,34
Berwickshire,LI,M,0,0,0,0,0,8,8
Berwickshire,LIM,F,112,189,85,71,43,281,781
Berwickshire,LIM,M,92,141,41,23,14,60,371
Berwickshire,LIM X,F,0,0,0,0,0,1,1
Berwickshire,LIMB,F,0,0,0,0,0,4,4
Berwickshire,LIMBX,F,0,0,0,0,0,114,114
Berwickshire,LIMR,F,0,0,0,0,0,2,2
Berwickshire,LIMR,M,0,0,0,0,0,5,5
Berwickshire,LIMRX,F,0,0,0,0,0,45,45
Berwickshire,LIMX,F,"2,328","2,866",751,592,506,"1,914","8,957"
Berwickshire,LIMX,M,"2,252","2,595",344,17,3,13,"5,224"
Berwickshire,LIX,F,0,0,0,0,0,241,241
Berwickshire,LIX,M,0,0,0,0,0,1,1
Berwickshire,LM,F,0,0,0,0,0,92,92
Berwickshire,LM,M,0,0,0,0,0,33,33
Berwickshire,LMX,F,0,0,0,0,0,542,542
Berwickshire,LMX,M,0,0,0,0,0,165,165
Berwickshire,LR,F,5,3,0,10,2,5,25
Berwickshire,LR,M,6,1,0,0,1,0,8
Berwickshire,LRX,F,6,2,0,2,0,5,15
Berwickshire,LRX,M,7,1,0,0,0,0,8
Berwickshire,LU,F,19,14,26,28,21,63,171
Berwickshire,LU,M,26,51,0,0,1,6,84
Berwickshire,LUX,F,0,2,0,0,0,9,11
Berwickshire,LUX,M,0,9,0,0,0,0,9
Berwickshire,MARX,F,0,0,0,0,0,1,1
Berwickshire,MAX,F,0,0,0,0,1,3,4
Berwickshire,MG,F,0,0,3,0,0,6,9
Berwickshire,MGX,F,0,7,0,0,0,5,12
Berwickshire,MGX,M,0,0,1,0,0,0,1
Berwickshire,MO,M,2,0,0,0,0,0,2
Berwickshire,MOX,F,0,1,0,0,1,0,2
Berwickshire,MOX,M,4,6,2,0,0,0,12
Berwickshire,MRI,F,0,0,0,0,4,9,13
Berwickshire,MRI,M,0,4,0,0,0,0,4
Berwickshire,MRIX,F,0,1,0,0,0,1,2
Berwickshire,MRIX,M,0,1,11,0,0,0,12
Berwickshire,NO,F,0,0,0,1,0,1,2
Berwickshire,NOX,F,0,0,0,0,0,4,4
Berwickshire,NS,F,0,0,0,0,0,28,28
Berwickshire,OB,F,0,0,0,0,0,7,7
Berwickshire,OB,M,0,0,0,0,0,11,11
Berwickshire,OO,F,0,0,0,0,0,12,12
Berwickshire,OO,M,0,0,0,0,0,4,4
Berwickshire,PA,M,0,0,0,1,0,0,1
Berwickshire,PAX,F,6,3,3,0,0,1,13
Berwickshire,PAX,M,5,3,0,0,0,0,8
Berwickshire,PI,F,0,0,0,0,0,1,1
Berwickshire,PIX,F,0,0,0,0,0,2,2
Berwickshire,RO,F,0,0,0,0,0,1,1
Berwickshire,ROX,F,0,0,0,0,0,1,1
Berwickshire,RPX,F,1,0,0,0,0,1,2
Berwickshire,SA,F,9,8,3,1,4,63,88
Berwickshire,SA,M,1,13,1,1,0,5,21
Berwickshire,SAX,F,142,153,68,63,131,488,"1,045"
Berwickshire,SAX,M,59,93,9,0,1,10,172
Berwickshire,SD,F,2,2,4,13,9,32,62
Berwickshire,SD,M,5,1,2,0,3,0,11
Berwickshire,SDX,F,13,19,9,2,1,7,51
Berwickshire,SDX,M,15,4,1,0,0,0,20
Berwickshire,SH,F,0,1,0,0,1,2,4
Berwickshire,SH,M,0,12,0,0,0,0,12
Berwickshire,SHO,F,0,1,0,1,2,11,15
Berwickshire,SHO,M,1,7,0,0,0,0,8
Berwickshire,SHOX,F,81,83,48,28,21,60,321
Berwickshire,SHOX,M,82,91,2,0,0,1,176
Berwickshire,SHX,F,0,0,0,0,0,2,2
Berwickshire,SM,F,108,80,58,44,52,294,636
Berwickshire,SM,M,83,77,23,16,9,65,273
Berwickshire,SMX,F,784,802,350,275,327,"2,163","4,701"
Berwickshire,SMX,M,798,622,104,6,16,163,"1,709"
Berwickshire,SRWX,M,0,1,0,0,0,0,1
Berwickshire,ST,F,3,0,0,0,0,0,3
Berwickshire,ST,M,23,1,2,0,0,1,27
Berwickshire,STX,F,0,19,0,0,0,0,19
Berwickshire,STX,M,0,17,1,0,0,0,18
Berwickshire,WB,F,19,22,15,12,15,19,102
Berwickshire,WB,M,15,17,2,0,1,0,35
Berwickshire,WBX,F,0,0,0,0,2,4,6
Berwickshire,WBX,M,1,0,0,0,0,0,1
Berwickshire,WS,M,0,1,1,0,1,0,3
Berwickshire,WSX,F,1,1,1,10,0,1,14
Berwickshire,WSX,M,0,2,0,1,0,0,3
Bute,AA,F,75,41,50,27,28,128,349
Bute,AA,M,55,17,8,8,4,11,103
Bute,AAX,F,241,131,103,97,123,381,"1,076"
Bute,AAX,M,209,90,37,2,3,17,358
Bute,AY,F,45,50,64,39,45,125,368
Bute,AY,M,29,13,2,2,2,2,50
Bute,AYX,F,1,6,5,1,6,15,34
Bute,AYX,M,0,0,2,0,1,0,3
Bute,BA,F,0,0,0,1,0,5,6
Bute,BA,M,0,1,0,0,1,0,2
Bute,BAX,F,0,1,0,0,1,24,26
Bute,BAX,M,0,0,0,0,0,5,5
Bute,BAZX,F,2,0,0,0,0,0,2
Bute,BB,F,8,4,10,4,4,10,40
Bute,BB,M,6,3,0,0,2,1,12
Bute,BBX,F,156,111,51,39,37,124,518
Bute,BBX,M,118,40,4,1,1,10,174
Bute,BF,F,42,51,77,83,87,144,484
Bute,BF,M,19,19,9,5,11,8,71
Bute,BFX,F,26,24,17,19,3,0,89
Bute,BFX,M,18,1,2,0,2,0,23
Bute,BG,F,0,0,0,0,0,3,3
Bute,BH,F,0,0,0,0,0,50,50
Bute,BHX,F,3,0,0,0,0,0,3
Bute,BSH,F,3,1,0,0,0,0,4
Bute,BSHX,F,9,0,0,0,1,22,32
Bute,BSHX,M,13,0,0,0,0,0,13
Bute,BSX,F,0,0,0,0,0,2,2
Bute,BWX,F,0,0,0,0,0,1,1
Bute,CB,F,0,0,0,0,0,14,14
Bute,CD,F,0,0,0,0,0,1,1
Bute,CH,F,0,4,0,0,2,10,16
Bute,CH,M,1,0,5,2,6,10,24
Bute,CHX,F,256,114,13,7,10,126,526
Bute,CHX,M,288,48,8,1,0,46,391
Bute,DE,F,0,0,0,0,0,1,1
Bute,DEX,F,3,2,4,3,0,6,18
Bute,DEX,M,5,0,1,0,0,1,7
Bute,DSX,F,0,0,0,0,0,2,2
Bute,FR,F,0,0,0,0,0,291,291
Bute,FR,M,0,0,0,0,0,6,6
Bute,FRX,F,0,0,0,0,0,2,2
Bute,FRX,M,0,0,0,0,0,1,1
Bute,GA,F,5,1,3,4,1,35,49
Bute,GA,M,7,6,6,0,0,7,26
Bute,GAX,F,1,0,0,2,0,13,16
Bute,GAX,M,0,1,1,0,1,1,4
Bute,H,F,0,0,0,0,0,1,1
Bute,HE,F,10,16,0,0,0,15,41
Bute,HE,M,5,7,0,2,1,2,17
Bute,HEBLX,F,0,0,0,0,0,2,2
Bute,HEX,F,23,15,12,10,6,67,133
Bute,HEX,M,19,9,0,0,1,2,31
Bute,HF,F,338,310,417,355,347,"1,006","2,773"
Bute,HF,M,236,110,22,3,5,49,425
Bute,HFX,F,27,42,22,28,24,38,181
Bute,HFX,M,37,35,0,0,1,0,73
Bute,HI,F,52,27,27,11,24,91,232
Bute,HI,M,48,7,4,3,0,4,66
Bute,HIX,F,0,2,0,0,1,1,4
Bute,HIX,M,6,0,0,0,0,1,7
Bute,HL,F,0,0,0,0,0,24,24
Bute,HL,M,0,0,0,0,0,1,1
Bute,HLX,F,0,0,0,0,0,1,1
Bute,HO,F,166,143,154,126,99,230,918
Bute,HO,M,58,5,4,0,0,0,67
Bute,HOX,F,3,7,8,3,23,33,77
Bute,HOX,M,5,0,0,0,0,0,5
Bute,HX,F,0,0,0,0,0,1,1
Bute,JE,F,6,5,3,3,3,8,28
Bute,JE,M,3,1,2,1,0,0,7
Bute,JEX,F,2,0,0,2,0,3,7
Bute,JY,F,1,0,0,0,0,0,1
Bute,LH,F,0,0,1,0,0,3,4
Bute,LH,M,0,0,1,0,0,0,1
Bute,LIM,F,62,23,26,36,12,82,241
Bute,LIM,M,45,13,7,8,6,16,95
Bute,LIMBX,F,0,0,0,0,0,49,49
Bute,LIMBX,M,0,0,0,0,0,1,1
Bute,LIMR,F,0,0,0,0,0,4,4
Bute,LIMRX,F,0,0,0,0,0,5,5
Bute,LIMX,F,690,377,269,141,129,482,"2,088"
Bute,LIMX,M,608,239,22,15,1,8,893
Bute,LIX,F,0,0,0,0,0,2,2
Bute,LM,F,0,0,0,0,0,80,80
Bute,LM,M,0,0,0,0,0,15,15
Bute,LMX,F,0,0,0,0,0,244,244
Bute,LMX,M,0,0,0,0,0,55,55
Bute,LU,F,10,2,2,3,6,20,43
Bute,LU,M,9,4,0,1,0,0,14
Bute,LUX,F,0,0,0,0,0,2,2
Bute,LUX,M,1,0,0,0,0,0,1
Bute,MGX,F,0,0,0,0,0,1,1
Bute,MRI,F,0,0,0,0,0,1,1
Bute,NDX,F,0,0,0,0,0,1,1
Bute,NS,F,0,0,0,0,0,51,51
Bute,OB,F,0,0,0,0,0,3,3
Bute,OB,M,0,0,0,0,0,1,1
Bute,OD,F,0,0,0,0,0,2,2
Bute,OD,M,0,0,0,0,0,1,1
Bute,OO,F,0,0,0,0,0,15,15
Bute,SA,F,0,0,0,0,0,7,7
Bute,SA,M,0,2,0,0,0,1,3
Bute,SAX,F,17,9,12,11,15,59,123
Bute,SAX,M,21,25,2,0,0,1,49
Bute,SD,F,6,0,0,0,0,0,6
Bute,SD,M,1,0,0,0,1,1,3
Bute,SDX,F,15,6,11,7,10,10,59
Bute,SDX,M,1,0,0,0,0,0,1
Bute,SH,F,0,1,0,0,0,1,2
Bute,SHO,F,0,0,0,0,0,1,1
Bute,SHO,M,0,0,0,1,0,1,2
Bute,SHOX,F,8,1,1,8,1,13,32
Bute,SHOX,M,5,0,1,0,0,1,7
Bute,SHX,F,0,0,1,0,0,0,1
Bute,SHX,M,0,1,0,0,0,0,1
Bute,SM,F,37,23,16,12,9,67,164
Bute,SM,M,26,17,5,5,6,16,75
Bute,SMX,F,358,217,97,91,111,438,"1,312"
Bute,SMX,M,307,90,20,2,0,35,454
Bute,WS,F,1,0,0,0,0,0,1
Bute,WS,M,1,0,0,0,0,0,1
Bute,WSX,F,8,7,3,6,9,22,55
Bute,WSX,M,6,14,1,0,0,0,21
Caithness,AA,F,90,79,46,44,47,237,543
Caithness,AA,M,99,74,26,34,18,36,287
Caithness,AAX,F,"1,243",926,318,366,363,"1,536","4,752"
Caithness,AAX,M,"1,297",702,20,9,0,16,"2,044"
Caithness,AY,F,39,37,47,53,39,165,380
Caithness,AY,M,46,35,9,4,2,6,102
Caithness,AYX,F,0,0,0,0,0,1,1
Caithness,AYX,M,0,1,0,1,1,1,4
Caithness,BA,F,0,0,1,1,1,10,13
Caithness,BA,M,0,0,0,1,0,0,1
Caithness,BABX,F,0,0,0,0,0,4,4
Caithness,BALX,F,0,1,0,0,0,0,1
Caithness,BALX,M,1,0,0,0,0,0,1
Caithness,BARX,F,0,0,0,0,0,2,2
Caithness,BAX,F,27,19,15,12,19,154,246
Caithness,BAX,M,18,15,1,0,0,7,41
Caithness,BAZ,F,1,0,0,0,0,0,1
Caithness,BAZX,F,6,7,2,0,1,1,17
Caithness,BAZX,M,8,0,0,0,0,0,8
Caithness,BB,F,23,1,8,9,25,64,130
Caithness,BB,M,29,1,1,0,2,1,34
Caithness,BBX,F,234,195,187,174,200,611,"1,601"
Caithness,BBX,M,216,74,6,3,1,15,315
Caithness,BF,F,72,51,50,87,88,136,484
Caithness,BF,M,76,51,32,3,4,5,171
Caithness,BFX,F,0,0,0,0,0,12,12
Caithness,BFX,M,0,0,1,0,0,0,1
Caithness,BG,F,0,1,0,0,0,1,2
Caithness,BG,M,0,1,0,0,0,0,1
Caithness,BGX,F,0,0,0,0,0,6,6
Caithness,BGX,M,1,0,1,0,0,0,2
Caithness,BLG,F,0,6,0,5,2,3,16
Caithness,BRX,F,1,0,0,0,0,0,1
Caithness,BSH,F,18,22,16,8,5,31,100
Caithness,BSH,M,10,7,2,5,5,3,32
Caithness,BSHX,F,55,29,21,5,3,44,157
Caithness,BSHX,M,61,27,0,0,0,0,88
Caithness,BW,F,0,0,0,0,1,1,2
Caithness,BW,M,0,1,0,0,0,0,1
Caithness,BWX,F,0,0,0,0,0,2,2
Caithness,CB,F,0,0,0,1,0,29,30
Caithness,CH,F,57,65,44,36,19,149,370
Caithness,CH,M,80,32,45,37,29,102,325
Caithness,CHIX,F,3,2,0,0,0,0,5
Caithness,CHIX,M,6,5,0,0,0,0,11
Caithness,CHX,F,"2,722",928,147,170,159,"1,302","5,428"
Caithness,CHX,M,"2,933",725,30,7,6,189,"3,890"
Caithness,DEV,F,0,0,0,0,1,0,1
Caithness,DEVX,F,0,0,0,0,0,1,1
Caithness,DEX,F,1,0,1,0,0,1,3
Caithness,DS,F,0,1,0,0,0,0,1
Caithness,DSX,F,0,0,0,0,2,6,8
Caithness,FR,F,0,0,0,0,0,46,46
Caithness,FR,M,0,0,0,0,0,2,2
Caithness,FRX,F,0,0,0,0,0,5,5
Caithness,GA,F,19,14,15,14,18,85,165
Caithness,GA,M,9,9,2,1,1,2,24
Caithness,GAX,F,3,4,10,26,0,63,106
Caithness,GAX,M,2,0,1,0,0,0,3
Caithness,GBX,F,0,0,1,0,0,0,1
Caithness,GEX,F,0,0,0,0,0,1,1
Caithness,GLX,F,0,0,0,0,0,1,1
Caithness,H,F,0,0,0,0,0,4,4
Caithness,HE,F,0,1,1,2,1,20,25
Caithness,HE,M,0,0,0,1,2,0,3
Caithness,HEBL,F,0,0,0,0,0,1,1
Caithness,HEBLX,F,0,0,0,0,0,17,17
Caithness,HER,F,0,0,0,0,0,3,3
Caithness,HERX,F,0,0,0,0,0,5,5
Caithness,HEX,F,42,40,17,22,46,432,599
Caithness,HEX,M,41,18,0,0,0,4,63
Caithness,HF,F,0,1,17,7,9,64,98
Caithness,HF,M,5,4,3,0,0,3,15
Caithness,HFX,F,0,2,0,1,0,11,14
Caithness,HFX,M,2,0,2,0,0,2,6
Caithness,HI,F,41,36,29,18,21,113,258
Caithness,HI,M,26,29,10,7,1,6,79
Caithness,HIX,F,3,4,0,5,3,7,22
Caithness,HIX,M,2,2,0,0,0,0,4
Caithness,HL,F,0,0,0,0,0,34,34
Caithness,HL,M,0,0,0,0,0,1,1
Caithness,HLX,F,0,0,0,0,0,8,8
Caithness,HLX,M,0,0,0,0,0,2,2
Caithness,HO,F,1,3,1,5,3,4,17
Caithness,HO,M,0,3,0,0,0,0,3
Caithness,HOX,F,0,0,0,0,2,2,4
Caithness,HX,F,0,0,0,0,0,20,20
Caithness,IM,F,0,0,0,0,1,0,1
Caithness,IMX,F,0,0,0,0,0,1,1
Caithness,JE,F,1,0,1,1,0,6,9
Caithness,JE,M,0,1,0,0,0,0,1
Caithness,JEX,F,0,0,0,0,0,1,1
Caithness,JY,F,0,0,0,0,0,1,1
Caithness,KE,F,0,0,0,0,0,1,1
Caithness,KE,M,1,0,0,0,0,0,1
Caithness,KEX,F,0,0,0,0,0,1,1
Caithness,LH,F,1,1,1,2,1,6,12
Caithness,LH,M,2,0,0,0,0,1,3
Caithness,LHX,F,9,0,0,1,0,0,10
Caithness,LHX,M,8,1,0,0,0,0,9
Caithness,LI,F,0,0,0,0,0,10,10
Caithness,LI,M,0,0,0,0,0,5,5
Caithness,LIM,F,139,65,50,56,54,221,585
Caithness,LIM,M,123,73,32,26,14,52,320
Caithness,LIMB,F,0,0,0,0,0,2,2
Caithness,LIMBX,F,0,0,0,0,0,28,28
Caithness,LIMR,F,0,0,0,0,0,2,2
Caithness,LIMRX,F,0,0,0,0,0,75,75
Caithness,LIMX,F,"2,310","1,321",694,553,699,"1,903","7,480"
Caithness,LIMX,M,"2,147",877,52,9,6,22,"3,113"
Caithness,LIX,F,0,0,0,0,0,64,64
Caithness,LM,F,0,0,0,0,0,83,83
Caithness,LM,M,0,0,0,0,0,33,33
Caithness,LMX,F,0,0,0,0,0,867,867
Caithness,LMX,M,0,0,0,0,0,94,94
Caithness,LR,F,1,0,0,0,0,0,1
Caithness,LRX,F,1,0,1,3,0,59,64
Caithness,LU,F,25,18,26,14,21,65,169
Caithness,LU,M,21,5,1,1,0,0,28
Caithness,LUX,F,4,4,2,11,1,17,39
Caithness,LUX,M,4,0,0,0,0,1,5
Caithness,MARX,F,1,0,0,0,0,0,1
Caithness,MARX,M,2,0,0,0,0,0,2
Caithness,MAX,F,0,1,1,0,0,0,2
Caithness,MG,F,0,0,1,0,0,0,1
Caithness,MGX,F,0,0,0,0,0,1,1
Caithness,MGX,M,1,0,0,0,0,0,1
Caithness,MO,F,0,0,0,0,0,1,1
Caithness,MOX,F,0,1,0,0,0,1,2
Caithness,MOX,M,0,1,0,0,0,0,1
Caithness,MRI,F,0,0,2,4,0,1,7
Caithness,MRIX,F,0,0,0,4,1,10,15
Caithness,NS,F,0,0,0,0,0,66,66
Caithness,OB,F,0,0,0,0,0,41,41
Caithness,OO,F,0,0,0,0,0,31,31
Caithness,OO,M,0,0,0,0,0,2,2
Caithness,PAX,F,0,0,0,0,0,1,1
Caithness,PIX,F,0,0,0,0,0,3,3
Caithness,ROX,F,0,1,0,0,0,5,6
Caithness,ROX,M,0,1,0,0,0,0,1
Caithness,RPX,F,0,0,0,0,0,2,2
Caithness,RWFR,F,0,0,0,0,0,1,1
Caithness,SA,F,0,0,3,4,8,22,37
Caithness,SA,M,0,1,2,2,1,2,8
Caithness,SAX,F,65,36,45,32,47,271,496
Caithness,SAX,M,29,18,1,0,0,1,49
Caithness,SB,F,0,1,0,0,0,0,1
Caithness,SD,F,0,0,0,3,5,0,8
Caithness,SDX,F,8,30,11,1,7,13,70
Caithness,SDX,M,11,5,0,0,0,0,16
Caithness,SH,F,0,1,0,0,3,4,8
Caithness,SH,M,1,1,1,0,0,0,3
Caithness,SHO,F,10,6,3,2,4,70,95
Caithness,SHO,M,7,4,3,2,1,2,19
Caithness,SHOX,F,192,93,95,41,50,211,682
Caithness,SHOX,M,153,54,1,0,0,4,212
Caithness,SHX,F,1,0,4,0,1,9,15
Caithness,SM,F,84,74,60,54,52,281,605
Caithness,SM,M,97,50,21,12,12,44,236
Caithness,SMX,F,"1,056",827,652,593,579,"4,212","7,919"
Caithness,SMX,M,"1,045",360,15,8,0,105,"1,533"
Caithness,STX,F,0,1,1,0,0,0,2
Caithness,STX,M,1,1,0,0,0,0,2
Caithness,SU,F,0,0,0,0,0,1,1
Caithness,SUX,F,1,0,1,1,1,2,6
Caithness,SUX,M,0,1,0,0,0,0,1
Caithness,WB,F,1,0,1,0,0,5,7
Caithness,WBX,F,0,0,0,0,0,3,3
Caithness,WG,F,0,0,3,2,0,4,9
Caithness,WG,M,0,0,0,1,0,0,1
Caithness,WGX,F,0,1,0,0,0,0,1
Caithness,WS,F,2,1,1,0,0,3,7
Caithness,WS,M,1,1,1,0,2,1,6
Caithness,WSX,F,0,0,2,0,0,13,15
Clackmannan,AA,F,3,1,1,2,4,9,20
Clackmannan,AA,M,9,27,1,0,0,2,39
Clackmannan,AAX,F,30,26,8,7,14,24,109
Clackmannan,AAX,M,26,149,10,0,0,0,185
Clackmannan,BA,F,0,0,0,1,0,0,1
Clackmannan,BA,M,0,0,0,0,0,1,1
Clackmannan,BAX,F,21,31,1,2,0,4,59
Clackmannan,BAX,M,26,25,2,0,0,0,53
Clackmannan,BAZX,F,2,0,0,0,0,0,2
Clackmannan,BAZX,M,1,0,0,0,0,0,1
Clackmannan,BB,F,0,0,0,11,0,1,12
Clackmannan,BB,M,0,0,1,0,0,0,1
Clackmannan,BBX,F,7,3,1,35,1,5,52
Clackmannan,BBX,M,5,3,0,0,0,0,8
Clackmannan,BF,F,0,0,0,0,0,1,1
Clackmannan,BSHX,F,0,1,0,0,0,0,1
Clackmannan,BSHX,M,0,3,0,0,0,0,3
Clackmannan,CH,F,21,14,6,9,8,43,101
Clackmannan,CH,M,24,18,2,3,1,3,51
Clackmannan,CHX,F,77,87,11,2,3,22,202
Clackmannan,CHX,M,90,105,8,0,0,4,207
Clackmannan,GA,F,0,4,0,0,8,0,12
Clackmannan,GA,M,0,5,0,0,0,0,5
Clackmannan,HE,F,0,0,0,0,0,3,3
Clackmannan,HEX,F,0,0,0,0,0,6,6
Clackmannan,HEX,M,0,2,0,0,0,0,2
Clackmannan,HF,F,60,49,47,22,27,113,318
Clackmannan,HF,M,11,5,0,1,0,1,18
Clackmannan,HI,F,8,3,2,1,1,13,28
Clackmannan,HI,M,5,1,1,0,0,2,9
Clackmannan,HL,F,0,0,0,0,0,5,5
Clackmannan,HL,M,0,0,0,0,0,3,3
Clackmannan,HO,F,6,11,7,31,15,20,90
Clackmannan,HOX,F,0,0,0,0,0,3,3
Clackmannan,LHX,F,0,0,0,0,0,4,4
Clackmannan,LIM,F,4,18,4,4,3,4,37
Clackmannan,LIM,M,3,3,4,3,1,0,14
Clackmannan,LIMB,M,0,0,0,0,0,1,1
Clackmannan,LIMBX,F,0,0,0,0,0,6,6
Clackmannan,LIMR,F,0,0,0,0,0,2,2
Clackmannan,LIMR,M,0,0,0,0,0,1,1
Clackmannan,LIMRX,F,0,0,0,0,0,1,1
Clackmannan,LIMX,F,141,217,29,35,22,104,548
Clackmannan,LIMX,M,115,207,29,0,0,0,351
Clackmannan,LIX,F,0,0,0,0,0,6,6
Clackmannan,LM,F,0,0,0,0,0,6,6
Clackmannan,LM,M,0,0,0,0,0,1,1
Clackmannan,LMX,F,0,0,0,0,0,36,36
Clackmannan,LMX,M,0,0,0,0,0,6,6
Clackmannan,LU,F,0,8,0,0,0,3,11
Clackmannan,LUX,F,0,0,0,0,0,3,3
Clackmannan,LUX,M,1,1,0,0,0,0,2
Clackmannan,MARX,F,0,0,0,0,0,1,1
Clackmannan,MO,F,0,0,0,0,0,1,1
Clackmannan,MOX,M,1,1,0,0,0,1,3
Clackmannan,NS,F,0,0,0,0,0,4,4
Clackmannan,OB,F,0,0,0,0,0,2,2
Clackmannan,OB,M,0,0,0,0,0,2,2
Clackmannan,PAX,M,0,0,1,0,0,0,1
Clackmannan,SAX,F,1,2,0,0,0,7,10
Clackmannan,SAX,M,0,2,0,0,0,0,2
Clackmannan,SHOX,F,0,2,0,0,0,0,2
Clackmannan,SHOX,M,0,4,0,0,0,0,4
Clackmannan,SM,F,0,2,0,0,1,0,3
Clackmannan,SM,M,0,2,0,0,0,1,3
Clackmannan,SMX,F,23,52,12,31,31,76,225
Clackmannan,SMX,M,28,86,13,0,0,0,127
Clackmannan,WSX,F,0,0,0,0,0,3,3
Dumfriesshire,AA,F,500,447,218,220,208,"1,195","2,788"
Dumfriesshire,AA,M,549,481,88,49,28,147,"1,342"
Dumfriesshire,AAX,F,"2,527","2,169","1,053",800,938,"4,382","11,869"
Dumfriesshire,AAX,M,"2,929","2,530",341,14,8,165,"5,987"
Dumfriesshire,AMX,F,1,0,0,0,0,0,1
Dumfriesshire,AMX,M,0,1,0,0,0,0,1
Dumfriesshire,ARX,F,1,0,0,0,0,0,1
Dumfriesshire,AY,F,337,295,296,326,252,844,"2,350"
Dumfriesshire,AY,M,143,44,17,4,1,33,242
Dumfriesshire,AYX,F,8,4,5,7,6,28,58
Dumfriesshire,AYX,M,2,0,2,0,0,0,4
Dumfriesshire,BA,F,11,13,9,7,11,74,125
Dumfriesshire,BA,M,14,22,5,5,5,25,76
Dumfriesshire,BAB,F,0,0,0,0,0,1,1
Dumfriesshire,BABX,F,0,0,0,0,0,17,17
Dumfriesshire,BAL,F,0,0,0,0,0,1,1
Dumfriesshire,BARX,F,0,0,0,0,0,13,13
Dumfriesshire,BAWX,F,0,0,0,0,0,2,2
Dumfriesshire,BAX,F,300,234,65,50,68,386,"1,103"
Dumfriesshire,BAX,M,323,192,54,7,1,62,639
Dumfriesshire,BAZ,F,1,0,0,0,1,5,7
Dumfriesshire,BAZ,M,2,2,0,0,0,1,5
Dumfriesshire,BAZX,F,8,2,0,1,0,5,16
Dumfriesshire,BAZX,M,10,1,1,0,0,0,12
Dumfriesshire,BB,F,113,156,81,53,40,207,650
Dumfriesshire,BB,M,158,157,37,12,7,88,459
Dumfriesshire,BBX,F,"1,224","1,253",542,286,254,"1,019","4,578"
Dumfriesshire,BBX,M,"1,202","1,134",258,11,5,224,"2,834"
Dumfriesshire,BEL,M,0,1,0,0,0,0,1
Dumfriesshire,BF,F,369,375,535,610,669,"1,100","3,658"
Dumfriesshire,BF,M,431,442,299,36,9,16,"1,233"
Dumfriesshire,BFX,F,29,26,26,59,73,87,300
Dumfriesshire,BFX,M,45,26,16,3,2,3,95
Dumfriesshire,BG,F,41,23,19,19,10,89,201
Dumfriesshire,BG,M,42,27,9,5,0,5,88
Dumfriesshire,BGX,F,4,6,4,2,3,15,34
Dumfriesshire,BGX,M,3,3,3,0,1,2,12
Dumfriesshire,BH,F,10,0,0,0,0,310,320
Dumfriesshire,BH,M,6,0,0,0,0,1,7
Dumfriesshire,BHX,F,4,0,0,0,0,65,69
Dumfriesshire,BHX,M,0,0,0,0,0,1,1
Dumfriesshire,BLG,F,96,97,42,44,48,159,486
Dumfriesshire,BLG,M,100,42,0,0,0,0,142
Dumfriesshire,BLGX,F,0,0,1,0,0,29,30
Dumfriesshire,BR,M,1,0,0,0,0,0,1
Dumfriesshire,BRX,F,0,0,0,0,0,1,1
Dumfriesshire,BS,F,61,53,66,33,15,88,316
Dumfriesshire,BS,M,31,5,11,8,0,0,55
Dumfriesshire,BSH,F,51,36,35,14,6,21,163
Dumfriesshire,BSH,M,43,34,1,3,2,4,87
Dumfriesshire,BSHX,F,120,124,72,48,14,34,412
Dumfriesshire,BSHX,M,111,93,4,1,0,1,210
Dumfriesshire,BSX,F,15,0,4,8,4,11,42
Dumfriesshire,BSX,M,9,2,1,1,0,1,14
Dumfriesshire,BW,F,1,0,0,0,1,4,6
Dumfriesshire,BW,M,3,3,1,0,0,0,7
Dumfriesshire,BWB,F,0,0,0,0,0,1,1
Dumfriesshire,BWB,M,0,1,0,0,0,0,1
Dumfriesshire,BWX,F,1,0,0,1,0,1,3
Dumfriesshire,BWX,M,0,0,0,0,0,1,1
Dumfriesshire,BX,F,0,0,0,0,0,1,1
Dumfriesshire,CAX,F,0,0,0,0,0,1,1
Dumfriesshire,CB,F,0,0,1,3,0,38,42
Dumfriesshire,CD,F,0,0,0,0,0,17,17
Dumfriesshire,CH,F,196,178,99,85,73,397,"1,028"
Dumfriesshire,CH,M,183,119,75,64,38,225,704
Dumfriesshire,CHL,F,0,1,0,0,0,0,1
Dumfriesshire,CHX,F,"4,351","3,176",241,71,97,"1,199","9,135"
Dumfriesshire,CHX,M,"4,196","3,035",208,17,4,628,"8,088"
Dumfriesshire,DE,F,0,0,0,0,0,3,3
Dumfriesshire,DEV,F,2,3,0,2,1,5,13
Dumfriesshire,DEV,M,2,2,0,0,0,0,4
Dumfriesshire,DEVX,F,0,2,1,2,2,5,12
Dumfriesshire,DEVX,M,0,4,0,0,0,1,5
Dumfriesshire,DEX,F,11,4,7,9,7,32,70
Dumfriesshire,DEX,M,14,5,0,0,0,2,21
Dumfriesshire,DEXX,F,0,4,0,2,1,1,8
Dumfriesshire,DEXX,M,0,7,0,1,0,0,8
Dumfriesshire,DG,F,0,0,0,0,0,1,1
Dumfriesshire,DR,F,2,0,5,0,0,0,7
Dumfriesshire,DS,F,2,0,0,7,3,7,19
Dumfriesshire,DS,M,0,1,1,0,0,0,2
Dumfriesshire,DSX,F,0,0,0,0,2,0,2
Dumfriesshire,DVX,F,0,0,0,0,0,1,1
Dumfriesshire,EFB,M,1,0,0,0,0,0,1
Dumfriesshire,FR,F,0,0,0,0,0,"2,398","2,398"
Dumfriesshire,FR,M,0,0,0,0,0,18,18
Dumfriesshire,FRX,F,0,0,0,0,0,57,57
Dumfriesshire,FRX,M,0,0,0,0,0,2,2
Dumfriesshire,GA,F,151,171,115,121,135,852,"1,545"
Dumfriesshire,GA,M,178,166,40,5,11,35,435
Dumfriesshire,GAS,F,0,0,0,0,0,1,1
Dumfriesshire,GAS,M,0,0,1,0,0,0,1
Dumfriesshire,GASX,F,0,0,0,0,0,1,1
Dumfriesshire,GAX,F,80,45,27,18,22,210,402
Dumfriesshire,GAX,M,75,49,5,1,0,35,165
Dumfriesshire,GBX,F,1,0,0,0,0,0,1
Dumfriesshire,GBX,M,1,0,0,0,0,0,1
Dumfriesshire,GEX,F,0,0,0,1,2,1,4
Dumfriesshire,GEX,M,0,1,0,0,0,0,1
Dumfriesshire,GL,F,0,0,0,0,0,2,2
Dumfriesshire,GLX,F,0,0,0,1,0,0,1
Dumfriesshire,GU,F,0,0,0,2,0,0,2
Dumfriesshire,H,F,0,0,0,0,0,11,11
Dumfriesshire,HE,F,34,30,19,9,22,128,242
Dumfriesshire,HE,M,41,27,3,2,2,9,84
Dumfriesshire,HEBL,F,0,0,0,0,0,3,3
Dumfriesshire,HEBLX,F,0,0,0,0,0,55,55
Dumfriesshire,HER,F,0,0,0,0,0,2,2
Dumfriesshire,HERX,F,0,0,0,0,0,10,10
Dumfriesshire,HEX,F,171,80,79,64,95,616,"1,105"
Dumfriesshire,HEX,M,313,51,25,0,2,13,404
Dumfriesshire,HF,F,"4,379","4,319","4,564","3,981","3,399","9,451","30,093"
Dumfriesshire,HF,M,"2,441","1,288",607,115,68,"1,301","5,820"
Dumfriesshire,HFX,F,279,411,275,229,169,391,"1,754"
Dumfriesshire,HFX,M,227,176,52,4,1,27,487
Dumfriesshire,HI,F,11,19,16,9,14,80,149
Dumfriesshire,HI,M,8,3,13,3,6,10,43
Dumfriesshire,HIX,F,5,15,1,0,0,2,23
Dumfriesshire,HIX,M,6,7,0,0,1,0,14
Dumfriesshire,HL,F,0,0,0,0,0,22,22
Dumfriesshire,HL,M,0,0,0,0,0,7,7
Dumfriesshire,HLX,F,0,0,0,0,0,2,2
Dumfriesshire,HO,F,"1,432","1,291","1,362","1,219","1,081","1,440","7,825"
Dumfriesshire,HO,M,447,218,68,12,19,5,769
Dumfriesshire,HOX,F,171,151,163,172,187,401,"1,245"
Dumfriesshire,HOX,M,81,50,24,3,1,2,161
Dumfriesshire,HX,F,0,0,0,0,0,29,29
Dumfriesshire,IM,F,2,2,2,1,0,8,15
Dumfriesshire,IM,M,1,2,1,0,0,1,5
Dumfriesshire,IMX,F,1,2,0,0,0,0,3
Dumfriesshire,IMX,M,0,1,0,0,0,0,1
Dumfriesshire,JE,F,90,89,68,43,23,124,437
Dumfriesshire,JE,M,2,4,0,2,1,0,9
Dumfriesshire,JEX,F,22,27,1,0,0,3,53
Dumfriesshire,JEX,M,2,0,0,0,0,0,2
Dumfriesshire,JY,F,3,0,0,0,0,6,9
Dumfriesshire,JY,M,1,0,0,0,0,0,1
Dumfriesshire,LH,F,0,1,4,1,0,22,28
Dumfriesshire,LH,M,0,0,0,0,0,1,1
Dumfriesshire,LHX,F,1,3,3,1,2,12,22
Dumfriesshire,LHX,M,3,3,2,1,0,0,9
Dumfriesshire,LI,F,0,0,0,0,0,72,72
Dumfriesshire,LI,M,0,0,0,0,0,16,16
Dumfriesshire,LIM,F,616,515,348,264,238,712,"2,693"
Dumfriesshire,LIM,M,557,466,156,59,70,171,"1,479"
Dumfriesshire,LIMB,F,0,0,0,0,0,18,18
Dumfriesshire,LIMB,M,0,0,0,0,0,1,1
Dumfriesshire,LIMBX,F,0,0,0,0,0,385,385
Dumfriesshire,LIMBX,M,0,0,0,0,0,6,6
Dumfriesshire,LIMR,F,0,0,0,0,0,14,14
Dumfriesshire,LIMR,M,0,0,0,0,0,13,13
Dumfriesshire,LIMRX,F,0,0,0,0,0,162,162
Dumfriesshire,LIMRX,M,0,0,0,0,0,1,1
Dumfriesshire,LIMX,F,"6,687","5,731","1,651","1,294","1,237","4,799","21,399"
Dumfriesshire,LIMX,M,"6,704","5,441",836,81,21,47,"13,130"
Dumfriesshire,LIX,F,0,0,0,0,0,336,336
Dumfriesshire,LIX,M,0,0,0,0,0,2,2
Dumfriesshire,LM,F,0,0,0,0,0,318,318
Dumfriesshire,LM,M,0,0,0,0,0,206,206
Dumfriesshire,LMX,F,0,0,0,0,0,"2,128","2,128"
Dumfriesshire,LMX,M,0,0,0,0,0,"1,004","1,004"
Dumfriesshire,LR,F,1,0,0,0,0,9,10
Dumfriesshire,LRX,F,0,0,0,0,0,4,4
Dumfriesshire,LU,F,181,138,105,78,48,223,773
Dumfriesshire,LU,M,179,71,5,6,4,6,271
Dumfriesshire,LUX,F,70,39,39,12,21,55,236
Dumfriesshire,LUX,M,51,23,2,1,0,0,77
Dumfriesshire,MGX,F,0,0,4,0,0,5,9
Dumfriesshire,MO,F,1,0,6,5,2,0,14
Dumfriesshire,MO,M,2,1,0,0,0,0,3
Dumfriesshire,MOX,F,54,8,6,4,0,1,73
Dumfriesshire,MOX,M,42,12,0,0,0,0,54
Dumfriesshire,MRI,F,5,1,10,0,1,6,23
Dumfriesshire,MRI,M,0,18,1,0,0,1,20
Dumfriesshire,MRIX,F,15,25,31,47,34,13,165
Dumfriesshire,MRIX,M,31,42,20,9,1,0,103
Dumfriesshire,NOX,F,0,0,0,0,0,4,4
Dumfriesshire,NOX,M,2,5,0,0,0,0,7
Dumfriesshire,NR,M,4,0,0,0,0,0,4
Dumfriesshire,NRX,F,36,3,0,0,0,1,40
Dumfriesshire,NRX,M,18,0,0,0,0,0,18
Dumfriesshire,NS,F,0,0,0,0,0,195,195
Dumfriesshire,OB,F,0,0,0,0,0,20,20
Dumfriesshire,OB,M,0,0,0,0,0,13,13
Dumfriesshire,OD,F,0,0,0,0,0,7,7
Dumfriesshire,OD,M,0,0,0,0,0,5,5
Dumfriesshire,OO,F,0,0,0,0,0,16,16
Dumfriesshire,OO,M,0,0,0,0,0,21,21
Dumfriesshire,PAX,F,0,0,0,0,0,8,8
Dumfriesshire,PAX,M,2,1,0,0,0,0,3
Dumfriesshire,PI,F,0,0,0,0,0,1,1
Dumfriesshire,PI,M,0,0,0,0,0,1,1
Dumfriesshire,PIX,F,0,0,0,2,0,4,6
Dumfriesshire,RO,F,0,0,0,0,1,7,8
Dumfriesshire,RO,M,0,0,0,0,0,2,2
Dumfriesshire,ROX,F,0,0,0,0,0,6,6
Dumfriesshire,ROX,M,0,0,0,0,0,6,6
Dumfriesshire,RPX,M,1,0,0,0,0,0,1
Dumfriesshire,RWFR,F,0,0,0,0,0,1,1
Dumfriesshire,SA,F,55,45,27,7,15,160,309
Dumfriesshire,SA,M,60,35,9,1,1,6,112
Dumfriesshire,SAX,F,114,61,56,44,79,596,950
Dumfriesshire,SAX,M,134,186,4,2,0,13,339
Dumfriesshire,SBX,F,1,0,0,0,0,0,1
Dumfriesshire,SD,F,8,15,13,8,5,37,86
Dumfriesshire,SD,M,5,5,2,0,0,2,14
Dumfriesshire,SDX,F,14,14,5,8,5,19,65
Dumfriesshire,SDX,M,19,4,5,0,0,1,29
Dumfriesshire,SH,M,0,0,0,1,0,0,1
Dumfriesshire,SHO,F,3,13,9,9,13,69,116
Dumfriesshire,SHO,M,10,12,5,2,3,4,36
Dumfriesshire,SHOX,F,60,98,85,89,108,484,924
Dumfriesshire,SHOX,M,80,52,7,1,0,10,150
Dumfriesshire,SHX,F,1,2,1,1,0,6,11
Dumfriesshire,SHX,M,2,0,0,1,0,1,4
Dumfriesshire,SM,F,144,142,69,64,51,316,786
Dumfriesshire,SM,M,109,116,25,16,11,90,367
Dumfriesshire,SMX,F,975,979,462,471,463,"1,939","5,289"
Dumfriesshire,SMX,M,"1,026",750,63,9,2,241,"2,091"
Dumfriesshire,SRW,F,1,0,0,0,5,0,6
Dumfriesshire,SRWX,F,32,0,4,2,1,3,42
Dumfriesshire,SRWX,M,10,4,1,3,0,0,18
Dumfriesshire,ST,F,11,1,6,2,0,0,20
Dumfriesshire,ST,M,6,3,6,2,1,2,20
Dumfriesshire,STX,F,197,130,75,73,31,31,537
Dumfriesshire,STX,M,225,63,0,0,0,0,288
Dumfriesshire,SU,F,0,0,1,0,0,1,2
Dumfriesshire,SUX,F,0,0,0,1,0,0,1
Dumfriesshire,SUX,M,0,2,0,0,0,0,2
Dumfriesshire,WB,F,2,5,4,2,1,10,24
Dumfriesshire,WB,M,1,6,1,1,0,0,9
Dumfriesshire,WBX,F,0,2,1,2,4,12,21
Dumfriesshire,WBX,M,5,27,3,0,0,0,35
Dumfriesshire,WG,F,1,5,6,1,1,5,19
Dumfriesshire,WGX,F,0,0,2,0,0,1,3
Dumfriesshire,WP,F,0,0,0,0,0,1,1
Dumfriesshire,WPX,F,0,0,0,0,0,2,2
Dumfriesshire,WS,F,8,5,2,5,4,16,40
Dumfriesshire,WS,M,9,7,3,0,0,8,27
Dumfriesshire,WSX,F,50,38,43,46,34,187,398
Dumfriesshire,WSX,M,45,39,10,0,0,0,94
Dumfriesshire,ZE,F,0,2,0,0,0,0,2
Dumbartonshire,AA,F,15,9,20,11,15,74,144
Dumbartonshire,AA,M,21,28,3,2,6,8,68
Dumbartonshire,AAX,F,266,118,91,91,79,249,894
Dumbartonshire,AAX,M,271,184,6,1,1,7,470
Dumbartonshire,AY,F,46,44,68,53,47,191,449
Dumbartonshire,AY,M,31,17,7,0,1,5,61
Dumbartonshire,AYX,F,0,5,4,0,3,7,19
Dumbartonshire,BA,F,21,19,33,18,17,88,196
Dumbartonshire,BA,M,24,19,2,1,1,7,54
Dumbartonshire,BABX,F,0,0,0,0,0,1,1
Dumbartonshire,BARX,F,0,0,0,0,0,2,2
Dumbartonshire,BAX,F,71,49,4,11,10,155,300
Dumbartonshire,BAX,M,75,28,0,0,0,21,124
Dumbartonshire,BAZX,M,0,1,0,0,0,0,1
Dumbartonshire,BB,F,0,6,0,1,0,7,14
Dumbartonshire,BB,M,4,3,2,0,1,3,13
Dumbartonshire,BBX,F,129,83,45,23,24,60,364
Dumbartonshire,BBX,M,117,99,8,1,0,2,227
Dumbartonshire,BF,F,31,61,44,24,27,63,250
Dumbartonshire,BF,M,15,34,7,2,0,0,58
Dumbartonshire,BFX,F,43,40,41,0,1,0,125
Dumbartonshire,BFX,M,40,48,9,0,0,0,97
Dumbartonshire,BGX,F,2,3,2,2,1,13,23
Dumbartonshire,BGX,M,3,1,0,0,0,1,5
Dumbartonshire,BH,F,1,0,0,0,0,2,3
Dumbartonshire,BLG,F,0,0,1,0,0,0,1
Dumbartonshire,BSH,M,0,2,0,1,1,1,5
Dumbartonshire,BSHX,F,2,0,1,1,0,2,6
Dumbartonshire,BSHX,M,0,9,0,0,0,0,9
Dumbartonshire,BSX,F,2,0,1,0,0,7,10
Dumbartonshire,BSX,M,2,0,0,0,0,0,2
Dumbartonshire,CB,F,0,0,0,0,0,4,4
Dumbartonshire,CB,M,0,0,2,0,0,0,2
Dumbartonshire,CH,F,3,5,2,2,1,10,23
Dumbartonshire,CH,M,1,11,5,1,5,7,30
Dumbartonshire,CHX,F,211,100,19,24,19,142,515
Dumbartonshire,CHX,M,213,170,7,2,1,9,402
Dumbartonshire,DEVX,F,0,0,0,0,0,13,13
Dumbartonshire,DEX,F,0,0,0,1,0,0,1
Dumbartonshire,DEX,M,0,1,0,0,0,0,1
Dumbartonshire,DGX,F,0,0,0,0,0,1,1
Dumbartonshire,FR,F,0,0,0,0,0,107,107
Dumbartonshire,FR,M,0,0,0,0,0,2,2
Dumbartonshire,FRX,F,0,0,0,0,0,4,4
Dumbartonshire,GA,F,0,0,0,1,2,3,6
Dumbartonshire,GA,M,0,0,1,0,0,0,1
Dumbartonshire,GAX,F,0,0,0,0,2,8,10
Dumbartonshire,GAX,M,0,0,0,0,0,2,2
Dumbartonshire,H,M,0,0,0,0,0,1,1
Dumbartonshire,HE,F,0,0,0,1,4,8,13
Dumbartonshire,HE,M,1,1,0,1,1,0,4
Dumbartonshire,HEBLX,F,0,0,0,0,0,6,6
Dumbartonshire,HEBLX,M,0,0,0,0,0,3,3
Dumbartonshire,HERX,F,0,0,0,0,0,1,1
Dumbartonshire,HEX,F,43,37,21,21,27,122,271
Dumbartonshire,HEX,M,40,15,10,0,0,4,69
Dumbartonshire,HF,F,307,317,323,263,241,682,"2,133"
Dumbartonshire,HF,M,167,141,53,3,1,18,383
Dumbartonshire,HFX,F,23,23,37,77,55,166,381
Dumbartonshire,HFX,M,3,0,0,0,0,1,4
Dumbartonshire,HI,F,13,43,11,22,19,62,170
Dumbartonshire,HI,M,19,8,1,2,0,4,34
Dumbartonshire,HIX,F,3,5,0,5,8,8,29
Dumbartonshire,HIX,M,6,1,0,0,0,0,7
Dumbartonshire,HL,F,0,0,0,0,0,24,24
Dumbartonshire,HO,F,26,1,4,4,4,5,44
Dumbartonshire,HO,M,8,2,3,0,0,1,14
Dumbartonshire,HOX,F,35,29,25,29,23,55,196
Dumbartonshire,HOX,M,7,2,0,0,1,1,11
Dumbartonshire,HX,F,0,0,0,0,0,1,1
Dumbartonshire,IM,F,0,0,0,0,0,1,1
Dumbartonshire,JE,F,3,4,4,5,8,7,31
Dumbartonshire,JE,M,2,0,0,0,0,0,2
Dumbartonshire,JEX,F,3,1,0,1,3,0,8
Dumbartonshire,JEX,M,1,0,0,0,0,0,1
Dumbartonshire,JY,F,1,0,0,0,0,0,1
Dumbartonshire,LHX,F,0,0,1,0,0,0,1
Dumbartonshire,LHX,M,0,0,2,0,0,0,2
Dumbartonshire,LI,F,0,0,0,0,0,1,1
Dumbartonshire,LI,M,0,0,0,0,0,1,1
Dumbartonshire,LIM,F,19,26,10,8,7,46,116
Dumbartonshire,LIM,M,18,18,10,3,5,17,71
Dumbartonshire,LIMBX,F,0,0,0,0,0,30,30
Dumbartonshire,LIMBX,M,0,0,0,0,0,7,7
Dumbartonshire,LIMR,F,0,0,0,0,0,1,1
Dumbartonshire,LIMR,M,0,0,0,0,0,2,2
Dumbartonshire,LIMRX,F,0,0,0,0,0,22,22
Dumbartonshire,LIMRX,M,0,0,0,0,0,1,1
Dumbartonshire,LIMX,F,574,364,251,226,145,394,"1,954"
Dumbartonshire,LIMX,M,613,357,52,1,1,7,"1,031"
Dumbartonshire,LIX,F,0,0,0,0,0,2,2
Dumbartonshire,LM,F,0,0,0,0,0,36,36
Dumbartonshire,LM,M,0,0,0,0,0,13,13
Dumbartonshire,LMX,F,0,0,0,0,0,184,184
Dumbartonshire,LMX,M,0,0,0,0,0,43,43
Dumbartonshire,LU,F,27,20,21,23,12,41,144
Dumbartonshire,LU,M,25,11,2,0,0,3,41
Dumbartonshire,LUX,F,4,0,0,0,0,4,8
Dumbartonshire,LUX,M,3,2,0,0,0,0,5
Dumbartonshire,MO,M,0,0,1,0,1,0,2
Dumbartonshire,MOX,F,14,22,6,2,12,10,66
Dumbartonshire,MOX,M,26,7,5,0,0,1,39
Dumbartonshire,MRI,F,0,0,1,1,0,1,3
Dumbartonshire,MRIX,F,0,1,1,3,2,2,9
Dumbartonshire,MRIX,M,0,0,1,0,0,0,1
Dumbartonshire,NOX,F,0,0,0,0,0,1,1
Dumbartonshire,NS,F,0,0,0,0,0,20,20
Dumbartonshire,OB,F,0,0,0,0,0,16,16
Dumbartonshire,OB,M,0,0,0,0,0,6,6
Dumbartonshire,OO,M,0,0,0,0,0,2,2
Dumbartonshire,PAX,M,0,3,0,0,0,0,3
Dumbartonshire,RPX,F,1,0,0,0,0,0,1
Dumbartonshire,RPX,M,3,0,0,0,0,0,3
Dumbartonshire,SA,M,0,0,0,0,0,1,1
Dumbartonshire,SAX,F,2,5,7,10,14,36,74
Dumbartonshire,SAX,M,0,1,0,0,0,0,1
Dumbartonshire,SD,F,0,0,0,0,0,2,2
Dumbartonshire,SDX,F,0,0,0,0,0,1,1
Dumbartonshire,SH,F,2,0,0,0,1,1,4
Dumbartonshire,SHO,F,0,0,0,0,0,1,1
Dumbartonshire,SHO,M,0,0,0,0,0,1,1
Dumbartonshire,SHOX,F,71,63,38,13,6,62,253
Dumbartonshire,SHOX,M,59,19,1,0,0,0,79
Dumbartonshire,SHX,M,1,0,0,0,0,0,1
Dumbartonshire,SM,F,9,6,1,6,3,43,68
Dumbartonshire,SM,M,9,12,2,3,3,6,35
Dumbartonshire,SMX,F,240,175,93,54,59,405,"1,026"
Dumbartonshire,SMX,M,270,197,15,1,0,15,498
Dumbartonshire,STX,F,0,0,0,1,0,0,1
Dumbartonshire,SUX,F,0,0,0,0,0,1,1
Dumbartonshire,WP,F,1,1,0,1,0,4,7
Dumbartonshire,WP,M,4,0,1,0,0,0,5
Dumbartonshire,WS,M,0,0,0,0,0,1,1
Dumbartonshire,WSX,F,13,1,2,1,2,4,23
Dumbartonshire,WSX,M,13,1,1,0,1,0,16
Dumbartonshire,ZE,M,0,0,0,0,0,1,1
East Lothian,AA,F,20,16,15,13,13,55,132
East Lothian,AA,M,19,22,7,5,6,13,72
East Lothian,AAX,F,620,438,170,159,96,495,"1,978"
East Lothian,AAX,M,668,455,69,1,1,7,"1,201"
East Lothian,AY,F,3,0,0,0,1,3,7
East Lothian,BA,F,0,1,0,0,0,1,2
East Lothian,BA,M,0,0,0,0,0,2,2
East Lothian,BABX,F,0,0,0,0,0,3,3
East Lothian,BAX,F,36,63,7,3,9,24,142
East Lothian,BAX,M,27,47,3,0,0,4,81
East Lothian,BAZ,F,0,0,0,0,0,1,1
East Lothian,BB,F,1,9,2,3,1,9,25
East Lothian,BB,M,3,7,0,0,1,0,11
East Lothian,BBX,F,47,97,32,26,31,112,345
East Lothian,BBX,M,49,94,13,0,0,1,157
East Lothian,BF,F,0,0,0,1,2,8,11
East Lothian,BF,M,1,0,0,0,0,0,1
East Lothian,BFX,F,0,0,0,0,0,5,5
East Lothian,BG,F,0,0,0,0,0,1,1
East Lothian,BGX,F,0,0,0,0,0,2,2
East Lothian,BH,F,0,0,0,0,0,2,2
East Lothian,BLG,F,0,0,0,1,0,0,1
East Lothian,BSH,F,0,0,1,0,0,0,1
East Lothian,BSH,M,1,0,0,0,0,1,2
East Lothian,BSHX,F,0,0,0,2,0,0,2
East Lothian,BSHX,M,6,15,0,0,0,0,21
East Lothian,BW,F,9,5,5,2,7,5,33
East Lothian,BW,M,3,1,0,0,0,0,4
East Lothian,BWX,F,2,2,0,0,0,0,4
East Lothian,CB,F,0,0,0,0,1,30,31
East Lothian,CH,F,26,19,15,9,9,22,100
East Lothian,CH,M,28,6,9,6,1,17,67
East Lothian,CHX,F,492,438,8,9,7,111,"1,065"
East Lothian,CHX,M,504,454,43,0,0,44,"1,045"
East Lothian,DEVX,M,1,2,0,0,0,0,3
East Lothian,DEX,F,1,4,0,1,0,1,7
East Lothian,DEX,M,0,0,0,0,1,0,1
East Lothian,DEXX,F,0,0,0,0,0,1,1
East Lothian,DSX,F,0,0,0,0,0,1,1
East Lothian,FR,F,0,0,0,0,0,17,17
East Lothian,FRX,F,0,0,0,0,0,16,16
East Lothian,GA,F,0,0,1,1,2,8,12
East Lothian,GA,M,0,0,1,0,0,0,1
East Lothian,GAX,F,0,5,2,1,1,2,11
East Lothian,GAX,M,0,0,12,0,0,0,12
East Lothian,GE,F,1,0,0,0,0,0,1
East Lothian,GE,M,0,0,1,1,0,0,2
East Lothian,GEX,F,14,9,0,0,0,0,23
East Lothian,GEX,M,5,0,0,0,0,0,5
East Lothian,HE,F,4,0,3,0,0,6,13
East Lothian,HE,M,3,2,0,0,0,0,5
East Lothian,HEBLX,F,0,0,0,0,0,4,4
East Lothian,HEX,F,7,1,4,0,3,45,60
East Lothian,HEX,M,6,5,0,0,0,0,11
East Lothian,HF,F,24,5,30,52,49,144,304
East Lothian,HF,M,10,15,4,0,1,1,31
East Lothian,HFX,F,0,1,0,0,1,3,5
East Lothian,HI,F,6,3,2,2,2,20,35
East Lothian,HI,M,3,5,4,1,2,2,17
East Lothian,HIX,F,1,1,0,2,0,1,5
East Lothian,HIX,M,1,0,2,0,0,0,3
East Lothian,HL,F,0,0,0,0,0,3,3
East Lothian,HL,M,0,0,0,0,0,1,1
East Lothian,HO,F,1,9,3,7,24,17,61
East Lothian,HO,M,0,2,1,0,0,0,3
East Lothian,HOX,F,0,0,0,0,0,2,2
East Lothian,IM,F,0,0,0,0,0,1,1
East Lothian,JE,F,54,57,73,45,33,53,315
East Lothian,JE,M,2,0,2,0,0,0,4
East Lothian,JY,F,17,0,0,0,0,17,34
East Lothian,LHX,M,0,1,0,0,0,0,1
East Lothian,LI,F,0,0,0,0,0,24,24
East Lothian,LIM,F,38,77,33,23,33,105,309
East Lothian,LIM,M,37,53,13,5,6,13,127
East Lothian,LIMB,F,0,0,0,0,0,6,6
East Lothian,LIMBX,F,0,0,0,0,0,55,55
East Lothian,LIMR,F,0,0,0,0,0,2,2
East Lothian,LIMR,M,0,0,0,0,0,3,3
East Lothian,LIMRX,F,0,0,0,0,0,20,20
East Lothian,LIMX,F,786,892,311,193,166,921,"3,269"
East Lothian,LIMX,M,765,719,99,1,0,5,"1,589"
East Lothian,LIX,F,0,0,0,0,0,138,138
East Lothian,LIX,M,0,0,0,0,0,1,1
East Lothian,LM,F,0,0,0,0,0,48,48
East Lothian,LM,M,0,0,0,0,0,8,8
East Lothian,LMX,F,0,0,0,0,0,188,188
East Lothian,LMX,M,0,0,0,0,0,54,54
East Lothian,LRX,F,0,0,0,0,0,3,3
East Lothian,LU,F,21,30,24,12,17,62,166
East Lothian,LU,M,60,39,3,0,0,5,107
East Lothian,LUX,F,12,0,1,0,0,17,30
East Lothian,LUX,M,8,12,0,0,0,0,20
East Lothian,MG,F,0,0,0,0,0,1,1
East Lothian,MO,M,0,1,0,0,0,0,1
East Lothian,MOX,M,6,0,0,0,0,0,6
East Lothian,MRI,F,0,0,0,0,0,1,1
East Lothian,MRIX,M,0,1,0,0,0,0,1
East Lothian,NO,F,0,0,0,1,0,0,1
East Lothian,NS,F,0,0,0,0,0,20,20
East Lothian,OB,F,0,0,0,0,0,5,5
East Lothian,PAX,F,0,1,1,0,0,1,3
East Lothian,ROX,F,0,0,0,0,0,1,1
East Lothian,RPX,F,8,0,0,0,0,0,8
East Lothian,RPX,M,15,0,0,0,0,0,15
East Lothian,SA,F,0,2,4,2,8,16,32
East Lothian,SA,M,1,4,1,0,1,0,7
East Lothian,SAX,F,14,11,1,5,4,57,92
East Lothian,SAX,M,15,8,0,0,0,0,23
East Lothian,SD,F,2,0,4,4,0,0,10
East Lothian,SD,M,1,0,0,2,0,2,5
East Lothian,SDX,F,38,13,17,13,5,9,95
East Lothian,SDX,M,18,10,0,0,0,0,28
East Lothian,SH,F,0,0,0,0,0,1,1
East Lothian,SHO,M,4,1,0,0,0,0,5
East Lothian,SHOX,F,4,12,28,24,17,9,94
East Lothian,SHOX,M,27,13,0,0,0,1,41
East Lothian,SHX,F,2,0,0,0,0,0,2
East Lothian,SHX,M,1,1,0,0,0,0,2
East Lothian,SM,F,101,113,66,52,37,188,557
East Lothian,SM,M,109,64,6,14,10,33,236
East Lothian,SMX,F,584,575,140,114,135,864,"2,412"
East Lothian,SMX,M,643,347,6,1,0,66,"1,063"
East Lothian,WBX,F,0,0,0,0,0,1,1
East Lothian,WP,F,3,8,1,1,1,6,20
East Lothian,WP,M,7,2,0,0,0,1,10
East Lothian,WSX,F,0,0,4,1,0,0,5
East Lothian,WSX,M,2,6,0,0,0,0,8
Fife,AA,F,307,265,149,103,107,457,"1,388"
Fife,AA,M,304,134,31,20,20,37,546
Fife,AAX,F,"1,175",769,344,208,188,"1,194","3,878"
Fife,AAX,M,"1,131",778,89,7,1,31,"2,037"
Fife,ARX,F,0,0,0,0,0,1,1
Fife,ARX,M,1,0,0,0,0,0,1
Fife,AY,F,76,77,90,57,31,121,452
Fife,AY,M,138,9,6,0,1,0,154
Fife,AYX,F,0,0,0,0,0,3,3
Fife,AYX,M,10,0,0,0,0,1,11
Fife,BA,F,39,9,3,5,6,29,91
Fife,BA,M,44,6,4,2,3,11,70
Fife,BABX,F,0,0,0,0,0,6,6
Fife,BARX,F,0,0,0,0,0,6,6
Fife,BAX,F,297,251,74,76,43,208,949
Fife,BAX,M,238,234,14,1,2,12,501
Fife,BAZ,F,0,4,1,0,0,0,5
Fife,BAZ,M,0,2,0,1,1,0,4
Fife,BAZX,F,54,42,0,0,0,1,97
Fife,BAZX,M,42,28,0,0,0,0,70
Fife,BB,F,20,22,11,17,7,35,112
Fife,BB,M,8,17,6,7,4,18,60
Fife,BBX,F,580,587,198,157,144,418,"2,084"
Fife,BBX,M,508,481,37,5,2,15,"1,048"
Fife,BF,F,62,93,75,62,95,132,519
Fife,BF,M,86,105,77,4,1,3,276
Fife,BFX,F,5,3,3,0,0,5,16
Fife,BFX,M,2,7,0,0,0,0,9
Fife,BG,F,5,0,5,4,2,20,36
Fife,BG,M,12,2,1,2,1,0,18
Fife,BGX,F,5,0,3,4,1,6,19
Fife,BGX,M,2,2,0,0,0,0,4
Fife,BH,F,2,0,0,0,0,25,27
Fife,BH,M,1,0,0,0,0,0,1
Fife,BHX,F,2,0,0,0,0,97,99
Fife,BHX,M,4,0,0,0,0,0,4
Fife,BLGX,F,0,0,0,0,0,1,1
Fife,BS,F,0,0,0,0,0,1,1
Fife,BS,M,1,0,0,0,0,0,1
Fife,BSH,F,12,10,2,6,4,14,48
Fife,BSH,M,15,9,3,2,2,2,33
Fife,BSHX,F,56,48,19,14,4,8,149
Fife,BSHX,M,59,48,1,0,0,1,109
Fife,BSX,F,0,0,0,0,0,3,3
Fife,BSX,M,0,0,1,0,0,0,1
Fife,BU,F,28,16,22,10,0,54,130
Fife,BU,M,17,14,9,0,0,2,42
Fife,BW,F,1,0,0,2,2,10,15
Fife,BW,M,2,0,0,0,0,1,3
Fife,BWX,F,0,0,0,1,0,0,1
Fife,BWX,M,0,4,0,0,0,0,4
Fife,CB,F,0,0,0,0,0,30,30
Fife,CH,F,22,43,12,6,33,69,185
Fife,CH,M,32,26,20,15,14,38,145
Fife,CHX,F,"1,261","1,187",102,65,75,496,"3,186"
Fife,CHX,M,"1,331","1,688",108,6,3,120,"3,256"
Fife,DEVX,F,0,0,0,0,0,1,1
Fife,DEXX,M,0,1,0,0,0,0,1
Fife,DS,F,0,0,2,4,0,0,6
Fife,FEX,F,0,0,0,0,0,1,1
Fife,FR,F,0,0,0,0,0,293,293
Fife,FR,M,0,0,0,0,0,7,7
Fife,FRX,F,0,0,0,0,0,1,1
Fife,GA,F,4,1,3,4,1,6,19
Fife,GA,M,4,1,0,0,0,0,5
Fife,GAS,F,1,0,3,0,0,1,5
Fife,GAS,M,0,1,0,0,0,0,1
Fife,GASX,F,0,0,0,1,0,0,1
Fife,GASX,M,0,2,0,0,0,0,2
Fife,GAX,F,6,3,1,0,0,11,21
Fife,GAX,M,1,0,0,0,0,0,1
Fife,GE,F,0,1,0,0,0,0,1
Fife,GEX,M,0,1,0,0,0,0,1
Fife,GL,F,0,0,2,0,1,0,3
Fife,H,F,0,0,0,0,0,1,1
Fife,HE,F,31,19,17,10,7,48,132
Fife,HE,M,20,19,7,7,3,7,63
Fife,HEBLX,F,0,0,0,0,0,1,1
Fife,HER,F,0,0,0,0,0,1,1
Fife,HERX,F,0,0,0,0,0,2,2
Fife,HEX,F,174,156,36,31,22,421,840
Fife,HEX,M,220,169,3,0,0,0,392
Fife,HF,F,887,849,865,708,641,"1,764","5,714"
Fife,HF,M,978,520,156,11,6,64,"1,735"
Fife,HFX,F,48,32,42,26,24,53,225
Fife,HFX,M,43,12,14,0,0,0,69
Fife,HI,F,71,34,61,35,56,163,420
Fife,HI,M,67,71,29,5,4,7,183
Fife,HIX,F,1,1,0,0,2,5,9
Fife,HIX,M,1,1,3,0,0,0,5
Fife,HL,F,0,0,0,0,0,53,53
Fife,HL,M,0,0,0,0,0,13,13
Fife,HO,F,262,276,235,177,117,178,"1,245"
Fife,HO,M,86,92,42,2,2,3,227
Fife,HOX,F,0,0,0,0,0,13,13
Fife,HOX,M,1,0,2,0,0,0,3
Fife,HX,F,0,0,0,0,0,15,15
Fife,IM,F,0,2,0,0,0,4,6
Fife,IM,M,0,2,0,0,0,0,2
Fife,IMX,F,1,0,0,0,0,0,1
Fife,IMX,M,2,2,0,0,0,0,4
Fife,JE,F,4,1,3,0,4,12,24
Fife,JE,M,0,1,0,0,0,1,2
Fife,JEX,F,1,0,0,0,0,0,1
Fife,JY,F,0,0,0,0,0,1,1
Fife,LH,F,0,0,0,2,0,1,3
Fife,LHX,F,1,0,0,0,1,1,3
Fife,LI,F,0,0,0,0,0,12,12
Fife,LI,M,0,0,0,0,0,3,3
Fife,LIM,F,83,166,58,67,53,121,548
Fife,LIM,M,82,160,34,17,16,39,348
Fife,LIMB,F,0,0,0,0,0,1,1
Fife,LIMB,M,0,0,0,0,0,2,2
Fife,LIMBX,F,0,0,0,0,0,66,66
Fife,LIMR,F,0,0,0,0,0,8,8
Fife,LIMR,M,0,0,0,0,0,1,1
Fife,LIMRX,F,0,0,0,0,0,26,26
Fife,LIMRX,M,0,0,0,0,0,1,1
Fife,LIMX,F,"1,788","2,327",575,453,463,"1,484","7,090"
Fife,LIMX,M,"1,831","2,515",325,7,1,15,"4,694"
Fife,LIX,F,0,0,0,0,0,54,54
Fife,LM,F,0,0,0,0,0,78,78
Fife,LM,M,0,0,0,0,0,17,17
Fife,LMX,F,0,0,0,0,0,703,703
Fife,LMX,M,0,0,0,0,0,92,92
Fife,LR,F,11,11,13,6,1,18,60
Fife,LR,M,14,6,2,1,1,1,25
Fife,LU,F,1,14,3,7,0,32,57
Fife,LU,M,0,10,0,0,0,0,10
Fife,LUX,F,0,20,13,5,3,38,79
Fife,LUX,M,0,10,1,0,0,0,11
Fife,MG,F,0,0,0,0,0,1,1
Fife,MO,F,0,3,0,0,0,2,5
Fife,MOX,F,4,4,7,3,0,0,18
Fife,MOX,M,7,23,3,0,0,0,33
Fife,MRI,F,0,0,2,2,1,4,9
Fife,MRI,M,0,2,0,0,0,0,2
Fife,MRIX,F,0,1,5,1,0,5,12
Fife,MRIX,M,3,5,4,0,0,0,12
Fife,NRX,F,2,0,0,0,0,0,2
Fife,NRX,M,3,1,0,0,0,0,4
Fife,NS,F,0,0,0,0,0,35,35
Fife,OB,F,0,0,0,0,0,14,14
Fife,OB,M,0,0,0,0,0,3,3
Fife,OO,F,0,0,0,0,0,18,18
Fife,OO,M,0,0,0,0,0,14,14
Fife,PAX,F,0,2,0,0,0,0,2
Fife,PAX,M,0,1,0,0,0,0,1
Fife,ROX,F,0,0,0,0,0,7,7
Fife,ROX,M,1,0,0,0,0,0,1
Fife,RP,F,0,0,0,0,2,0,2
Fife,RPX,F,5,0,3,0,0,2,10
Fife,RPX,M,3,0,1,0,0,0,4
Fife,SA,F,0,0,0,0,0,11,11
Fife,SA,M,0,2,1,0,1,1,5
Fife,SAX,F,27,53,55,53,32,217,437
Fife,SAX,M,23,38,1,0,0,3,65
Fife,SD,F,0,0,0,0,0,1,1
Fife,SD,M,0,0,0,0,0,2,2
Fife,SDX,F,19,10,2,0,0,0,31
Fife,SDX,M,12,6,0,0,0,0,18
Fife,SH,F,2,1,3,2,0,1,9
Fife,SH,M,1,0,0,0,0,0,1
Fife,SHO,F,4,1,1,2,2,14,24
Fife,SHO,M,3,1,0,1,0,0,5
Fife,SHOX,F,65,33,33,28,20,103,282
Fife,SHOX,M,66,55,4,0,0,4,129
Fife,SHX,F,0,0,0,0,2,0,2
Fife,SHX,M,1,0,0,0,0,0,1
Fife,SM,F,95,122,71,59,58,314,719
Fife,SM,M,89,101,23,19,10,43,285
Fife,SMX,F,"1,161","1,187",488,523,497,"2,783","6,639"
Fife,SMX,M,"1,112","1,165",103,2,3,97,"2,482"
Fife,ST,M,0,0,1,0,0,0,1
Fife,STX,M,0,9,0,0,0,0,9
Fife,SUX,F,0,0,0,0,0,3,3
Fife,WB,F,0,0,0,0,0,1,1
Fife,WBX,F,0,0,0,0,0,1,1
Fife,WSX,F,0,0,0,0,0,1,1
Inverness,AA,F,180,122,75,99,103,394,973
Inverness,AA,M,147,50,22,18,13,32,282
Inverness,AAX,F,576,425,237,273,274,"1,503","3,288"
Inverness,AAX,M,529,238,19,0,2,41,829
Inverness,ARX,F,0,1,0,0,0,0,1
Inverness,AY,F,23,37,78,51,12,49,250
Inverness,AY,M,14,24,1,2,1,3,45
Inverness,AYX,F,0,0,0,0,0,1,1
Inverness,BA,F,3,0,0,2,1,16,22
Inverness,BA,M,1,0,0,0,0,3,4
Inverness,BABX,F,0,0,0,0,0,1,1
Inverness,BAWX,F,0,0,0,0,0,7,7
Inverness,BAX,F,23,8,7,4,28,95,165
Inverness,BAX,M,27,3,0,0,0,2,32
Inverness,BAZX,F,0,0,1,0,0,0,1
Inverness,BB,F,1,6,3,9,1,17,37
Inverness,BB,M,0,2,1,0,0,2,5
Inverness,BBX,F,77,56,77,67,62,307,646
Inverness,BBX,M,64,21,5,0,1,2,93
Inverness,BF,F,0,0,0,1,0,10,11
Inverness,BF,M,0,1,0,0,0,0,1
Inverness,BFX,F,0,0,0,0,0,2,2
Inverness,BG,F,11,2,3,8,4,26,54
Inverness,BG,M,8,8,7,1,0,3,27
Inverness,BGX,F,2,1,3,1,1,7,15
Inverness,BGX,M,4,1,1,0,0,0,6
Inverness,BLG,F,3,2,4,6,10,30,55
Inverness,BLG,M,2,7,1,0,0,0,10
Inverness,BSH,F,7,9,6,6,4,10,42
Inverness,BSH,M,10,6,7,2,6,7,38
Inverness,BSHX,F,65,52,29,26,39,60,271
Inverness,BSHX,M,41,10,1,0,0,0,52
Inverness,BSX,F,0,0,0,1,0,0,1
Inverness,CB,F,0,0,0,0,0,89,89
Inverness,CH,F,9,0,0,3,6,28,46
Inverness,CH,M,7,11,19,12,16,47,112
Inverness,CHX,F,887,231,86,78,48,538,"1,868"
Inverness,CHX,M,854,230,19,1,1,62,"1,167"
Inverness,DE,F,0,0,0,0,0,2,2
Inverness,DEV,F,0,0,0,0,0,1,1
Inverness,DEVX,F,0,0,0,0,0,21,21
Inverness,DEX,F,0,4,3,7,3,8,25
Inverness,DEX,M,6,5,2,0,0,0,13
Inverness,DEXX,F,3,2,0,1,1,1,8
Inverness,DEXX,M,1,0,0,0,0,0,1
Inverness,DS,F,0,0,0,0,0,1,1
Inverness,FR,F,0,0,0,0,0,65,65
Inverness,GA,F,21,28,10,17,24,88,188
Inverness,GA,M,13,8,0,1,1,0,23
Inverness,GAS,M,0,1,0,0,0,0,1
Inverness,GASX,F,0,0,0,0,0,5,5
Inverness,GAX,F,0,0,0,5,4,43,52
Inverness,GAX,M,0,0,0,0,1,0,1
Inverness,GL,F,0,0,0,0,2,0,2
Inverness,GLX,F,0,0,0,0,0,4,4
Inverness,HE,F,1,0,0,0,1,9,11
Inverness,HE,M,0,0,0,0,0,1,1
Inverness,HEBLX,F,0,0,0,0,0,1,1
Inverness,HERX,F,0,0,0,0,0,7,7
Inverness,HEX,F,16,7,21,13,9,127,193
Inverness,HEX,M,11,7,7,0,0,6,31
Inverness,HF,F,44,95,97,45,15,106,402
Inverness,HF,M,13,4,1,0,0,1,19
Inverness,HFX,F,0,3,0,0,0,17,20
Inverness,HI,F,212,169,164,118,142,546,"1,351"
Inverness,HI,M,196,132,82,64,46,51,571
Inverness,HIX,F,20,17,10,9,7,48,111
Inverness,HIX,M,11,15,3,3,1,2,35
Inverness,HL,F,0,0,0,0,0,197,197
Inverness,HL,M,0,0,0,0,0,29,29
Inverness,HLX,F,0,0,0,0,0,47,47
Inverness,HLX,M,0,0,0,0,0,5,5
Inverness,HO,F,0,0,0,1,3,7,11
Inverness,JE,F,0,0,0,0,4,3,7
Inverness,JE,M,0,0,2,1,0,0,3
Inverness,JEX,F,0,1,0,0,6,2,9
Inverness,JY,F,0,0,0,0,0,2,2
Inverness,KEX,F,0,0,0,1,0,0,1
Inverness,LH,F,0,0,0,1,0,1,2
Inverness,LHX,F,1,0,0,0,0,5,6
Inverness,LI,F,0,0,0,0,0,5,5
Inverness,LI,M,0,0,0,0,0,8,8
Inverness,LIM,F,88,54,46,33,30,120,371
Inverness,LIM,M,87,48,41,32,26,107,341
Inverness,LIMB,F,0,0,0,0,0,2,2
Inverness,LIMBX,F,0,0,0,0,0,31,31
Inverness,LIMR,F,0,0,0,0,0,1,1
Inverness,LIMR,M,0,0,0,0,0,11,11
Inverness,LIMRX,F,0,0,0,0,0,81,81
Inverness,LIMRX,M,0,0,0,0,0,1,1
Inverness,LIMX,F,"2,257","1,057",688,661,659,"1,835","7,157"
Inverness,LIMX,M,"2,014",640,65,10,17,30,"2,776"
Inverness,LIX,F,0,0,0,0,0,17,17
Inverness,LM,F,0,0,0,0,0,54,54
Inverness,LM,M,0,0,0,0,0,24,24
Inverness,LMX,F,0,0,0,0,0,887,887
Inverness,LMX,M,0,0,0,0,0,91,91
Inverness,LR,F,0,2,1,4,5,0,12
Inverness,LU,F,18,10,5,9,15,81,138
Inverness,LU,M,20,31,2,0,1,7,61
Inverness,LUX,F,28,28,25,22,23,193,319
Inverness,LUX,M,25,10,0,0,0,5,40
Inverness,MAX,F,0,0,0,0,0,1,1
Inverness,MG,F,0,0,0,0,0,1,1
Inverness,MOX,F,0,0,0,0,0,1,1
Inverness,MOX,M,1,1,0,0,0,0,2
Inverness,NRX,F,9,0,0,0,0,0,9
Inverness,NS,F,0,0,0,0,0,62,62
Inverness,NS,M,0,0,0,0,0,1,1
Inverness,OB,F,0,0,0,0,0,20,20
Inverness,OB,M,0,0,0,0,0,2,2
Inverness,OE,F,0,0,0,0,0,1,1
Inverness,OO,F,0,0,0,0,0,1,1
Inverness,PIX,F,0,0,0,0,0,1,1
Inverness,RO,F,0,0,0,0,0,1,1
Inverness,ROX,F,0,0,0,0,0,1,1
Inverness,RP,F,0,0,0,0,1,1,2
Inverness,RP,M,0,0,0,0,1,0,1
Inverness,RPX,F,6,0,5,3,1,4,19
Inverness,SA,F,9,5,9,0,7,18,48
Inverness,SA,M,7,2,1,1,1,4,16
Inverness,SAX,F,101,63,53,57,81,332,687
Inverness,SAX,M,68,14,2,0,0,6,90
Inverness,SBX,F,0,0,0,0,0,1,1
Inverness,SH,F,2,1,3,0,1,11,18
Inverness,SH,M,5,0,0,0,0,0,5
Inverness,SHO,F,15,5,21,4,6,52,103
Inverness,SHO,M,4,2,1,1,3,8,19
Inverness,SHOX,F,241,304,195,141,153,726,"1,760"
Inverness,SHOX,M,163,49,4,3,3,19,241
Inverness,SHX,F,9,6,1,1,2,37,56
Inverness,SHX,M,2,2,0,0,0,0,4
Inverness,SM,F,127,88,56,60,58,343,732
Inverness,SM,M,104,28,7,22,16,40,217
Inverness,SMX,F,734,554,376,359,357,"3,127","5,507"
Inverness,SMX,M,650,195,5,2,3,100,955
Inverness,SRW,F,0,0,0,0,0,1,1
Inverness,SRWX,F,0,0,0,0,0,2,2
Inverness,STX,F,0,0,0,0,0,1,1
Inverness,SUX,F,10,11,8,7,10,11,57
Inverness,SUX,M,8,5,0,0,0,0,13
Inverness,WB,F,0,0,0,0,0,3,3
Inverness,WB,M,0,1,0,0,0,0,1
Inverness,WBX,F,14,0,0,0,0,5,19
Inverness,WBX,M,7,0,0,0,0,0,7
Inverness,WG,F,0,0,0,0,0,2,2
Inverness,WS,M,0,0,0,1,1,5,7
Inverness,WSX,F,20,17,15,30,21,78,181
Inverness,WSX,M,20,10,1,0,0,0,31
Kincardine,AA,F,165,191,97,75,69,335,932
Kincardine,AA,M,176,175,28,7,10,27,423
Kincardine,AAX,F,508,697,215,151,131,756,"2,458"
Kincardine,AAX,M,607,683,68,1,4,10,"1,373"
Kincardine,AR,F,0,0,1,0,0,0,1
Kincardine,AR,M,0,0,1,0,0,0,1
Kincardine,AY,F,19,33,19,12,11,32,126
Kincardine,AY,M,20,0,0,0,1,0,21
Kincardine,AYX,F,0,0,0,0,1,0,1
Kincardine,AYX,M,0,1,0,0,0,0,1
Kincardine,BA,F,6,7,3,2,4,16,38
Kincardine,BA,M,4,6,1,0,2,5,18
Kincardine,BALX,F,0,0,0,0,0,1,1
Kincardine,BAX,F,135,240,55,30,29,144,633
Kincardine,BAX,M,146,123,16,2,2,13,302
Kincardine,BAZ,M,0,0,0,0,1,0,1
Kincardine,BAZX,F,13,4,0,0,0,0,17
Kincardine,BAZX,M,6,8,0,0,0,0,14
Kincardine,BB,F,9,10,10,10,10,56,105
Kincardine,BB,M,3,10,3,2,0,1,19
Kincardine,BBX,F,180,193,175,116,108,366,"1,138"
Kincardine,BBX,M,72,197,45,3,2,8,327
Kincardine,BF,F,2,11,18,20,64,61,176
Kincardine,BF,M,17,35,4,4,0,0,60
Kincardine,BFX,F,0,0,0,0,6,12,18
Kincardine,BFX,M,0,3,2,0,0,0,5
Kincardine,BG,F,1,4,1,0,1,4,11
Kincardine,BG,M,1,0,2,1,0,1,5
Kincardine,BGX,F,0,1,0,0,1,7,9
Kincardine,BGX,M,1,1,0,0,0,1,3
Kincardine,BH,F,0,0,0,0,0,18,18
Kincardine,BI,F,4,4,1,3,1,7,20
Kincardine,BI,M,4,0,0,0,0,0,4
Kincardine,BLG,F,0,1,9,0,0,7,17
Kincardine,BLG,M,6,7,0,0,0,0,13
Kincardine,BS,F,0,3,0,0,0,1,4
Kincardine,BS,M,0,0,1,0,0,0,1
Kincardine,BSH,F,5,6,5,6,4,3,29
Kincardine,BSH,M,9,8,1,2,0,3,23
Kincardine,BSHX,F,14,11,5,3,1,22,56
Kincardine,BSHX,M,26,42,4,0,0,0,72
Kincardine,BSX,F,0,1,0,0,0,0,1
Kincardine,BWX,F,0,1,0,0,0,0,1
Kincardine,CB,F,0,0,0,0,0,15,15
Kincardine,CH,F,49,58,16,6,5,52,186
Kincardine,CH,M,46,41,23,12,23,62,207
Kincardine,CHIX,F,0,0,0,0,0,1,1
Kincardine,CHX,F,"1,685","2,112",172,90,91,686,"4,836"
Kincardine,CHX,M,"1,737","2,370",178,4,2,90,"4,381"
Kincardine,DEV,M,0,1,0,0,0,0,1
Kincardine,DEVX,F,0,1,0,0,0,1,2
Kincardine,DEX,F,0,8,0,0,0,2,10
Kincardine,DS,F,0,0,0,0,0,2,2
Kincardine,DS,M,0,0,7,0,0,0,7
Kincardine,FR,F,0,0,0,0,0,162,162
Kincardine,FRX,F,0,0,0,0,0,1,1
Kincardine,GA,F,0,0,2,0,0,0,2
Kincardine,GA,M,0,1,5,0,0,0,6
Kincardine,GAX,F,1,1,1,4,2,6,15
Kincardine,GAX,M,0,1,1,0,0,0,2
Kincardine,GEX,F,0,0,0,1,0,1,2
Kincardine,GL,F,1,0,1,0,1,3,6
Kincardine,GL,M,1,0,0,1,0,0,2
Kincardine,GLX,F,0,0,0,0,0,1,1
Kincardine,HE,F,6,11,12,9,1,21,60
Kincardine,HE,M,6,6,3,0,0,1,16
Kincardine,HEBLX,F,0,0,0,0,0,4,4
Kincardine,HERX,F,0,0,0,0,0,10,10
Kincardine,HEX,F,31,60,13,28,39,217,388
Kincardine,HEX,M,52,36,8,0,0,2,98
Kincardine,HF,F,410,351,358,315,181,787,"2,402"
Kincardine,HF,M,322,204,68,38,21,35,688
Kincardine,HFX,F,28,29,27,29,23,44,180
Kincardine,HFX,M,23,9,2,0,0,2,36
Kincardine,HI,F,39,34,33,30,35,100,271
Kincardine,HI,M,44,53,12,2,1,6,118
Kincardine,HIX,F,1,4,3,3,11,9,31
Kincardine,HIX,M,10,12,2,1,0,0,25
Kincardine,HL,F,0,0,0,0,0,27,27
Kincardine,HL,M,0,0,0,0,0,2,2
Kincardine,HLX,F,0,0,0,0,0,5,5
Kincardine,HO,F,54,164,164,144,77,142,745
Kincardine,HO,M,12,44,23,2,2,0,83
Kincardine,HOX,F,0,0,4,0,1,0,5
Kincardine,HX,F,0,0,0,0,0,3,3
Kincardine,IM,F,0,0,0,1,0,0,1
Kincardine,JE,F,2,4,4,9,0,16,35
Kincardine,JE,M,2,1,0,0,0,0,3
Kincardine,JEX,F,0,1,0,0,0,1,2
Kincardine,JY,M,1,0,0,0,0,0,1
Kincardine,LH,F,7,9,4,6,3,4,33
Kincardine,LH,M,10,0,0,0,1,0,11
Kincardine,LHX,F,0,0,0,0,0,5,5
Kincardine,LHX,M,1,13,0,0,0,0,14
Kincardine,LI,F,0,0,0,0,0,3,3
Kincardine,LI,M,0,0,0,0,0,1,1
Kincardine,LIM,F,58,152,53,37,44,138,482
Kincardine,LIM,M,84,114,37,8,15,41,299
Kincardine,LIMBX,F,0,0,0,0,0,78,78
Kincardine,LIMBX,M,0,0,0,0,0,1,1
Kincardine,LIMR,F,0,0,0,0,0,17,17
Kincardine,LIMR,M,0,0,0,0,0,5,5
Kincardine,LIMRX,F,0,0,0,0,0,53,53
Kincardine,LIMRX,M,0,0,0,0,0,2,2
Kincardine,LIMX,F,"1,805","2,474",479,382,365,"1,254","6,759"
Kincardine,LIMX,M,"1,709","2,236",305,19,2,12,"4,283"
Kincardine,LIX,F,0,0,0,0,0,39,39
Kincardine,LM,F,0,0,0,0,0,108,108
Kincardine,LM,M,0,0,0,0,0,20,20
Kincardine,LMX,F,0,0,0,0,0,575,575
Kincardine,LMX,M,0,0,0,0,0,68,68
Kincardine,LR,M,0,3,0,0,0,0,3
Kincardine,LRX,F,0,0,1,0,0,0,1
Kincardine,LU,F,0,0,1,1,1,2,5
Kincardine,LU,M,0,24,1,0,0,0,25
Kincardine,LUX,F,0,2,0,0,0,9,11
Kincardine,LUX,M,9,14,0,0,0,0,23
Kincardine,MAX,F,0,0,0,0,0,1,1
Kincardine,MG,F,0,0,1,0,0,0,1
Kincardine,MGX,F,8,0,0,0,0,0,8
Kincardine,MGX,M,3,0,1,0,0,0,4
Kincardine,MO,F,0,1,0,1,0,3,5
Kincardine,MOX,F,2,5,0,0,1,1,9
Kincardine,MOX,M,0,23,2,0,0,0,25
Kincardine,MRI,F,0,0,3,1,3,25,32
Kincardine,MRI,M,5,2,1,0,0,0,8
Kincardine,MRIX,F,0,1,6,1,0,3,11
Kincardine,MRIX,M,0,2,16,0,0,0,18
Kincardine,NOX,F,0,1,0,0,0,1,2
Kincardine,NRX,F,11,0,0,0,0,0,11
Kincardine,NRX,M,11,0,0,0,0,0,11
Kincardine,NS,F,0,0,0,0,0,44,44
Kincardine,OB,F,0,0,0,0,0,10,10
Kincardine,OB,M,0,0,0,0,0,2,2
Kincardine,OD,F,0,0,0,0,0,1,1
Kincardine,OO,F,0,0,0,0,0,6,6
Kincardine,OO,M,0,0,0,0,0,7,7
Kincardine,PAX,F,1,10,1,0,0,0,12
Kincardine,PAX,M,0,7,0,0,0,0,7
Kincardine,PI,F,0,0,0,0,0,1,1
Kincardine,PIX,F,0,0,0,5,0,1,6
Kincardine,RO,F,0,0,0,0,0,1,1
Kincardine,ROX,F,0,0,0,1,0,9,10
Kincardine,ROX,M,0,1,0,0,0,2,3
Kincardine,SA,F,4,3,3,1,2,15,28
Kincardine,SA,M,3,24,0,1,1,2,31
Kincardine,SAX,F,34,41,9,19,15,91,209
Kincardine,SAX,M,66,106,13,0,0,1,186
Kincardine,SB,M,0,1,0,0,0,0,1
Kincardine,SD,F,0,0,0,0,0,2,2
Kincardine,SD,M,0,0,1,0,0,0,1
Kincardine,SDX,F,0,1,1,0,0,1,3
Kincardine,SDX,M,1,6,2,0,0,0,9
Kincardine,SH,F,1,0,0,1,0,0,2
Kincardine,SH,M,7,1,0,0,0,0,8
Kincardine,SHO,F,1,3,0,0,1,16,21
Kincardine,SHO,M,5,6,2,0,0,1,14
Kincardine,SHOX,F,43,37,23,5,22,117,247
Kincardine,SHOX,M,52,75,2,1,0,0,130
Kincardine,SHX,F,3,0,0,0,0,2,5
Kincardine,SHX,M,3,1,0,0,0,0,4
Kincardine,SM,F,108,137,84,74,82,326,811
Kincardine,SM,M,101,50,28,22,8,46,255
Kincardine,SMX,F,"1,294","1,368",647,596,437,"2,597","6,939"
Kincardine,SMX,M,"1,257","1,074",130,6,1,85,"2,553"
Kincardine,SOBX,M,0,1,0,0,0,0,1
Kincardine,SRWX,F,0,0,0,0,0,1,1
Kincardine,STX,F,1,8,0,0,0,0,9
Kincardine,STX,M,0,15,0,0,0,0,15
Kincardine,SUX,F,0,0,0,0,0,1,1
Kincardine,WB,F,0,2,0,0,0,2,4
Kincardine,WBX,F,0,35,11,1,0,2,49
Kincardine,WBX,M,0,1,0,0,0,0,1
Kincardine,WP,F,1,1,1,0,1,2,6
Kincardine,WP,M,2,0,0,0,0,1,3
Kincardine,WSX,F,2,6,18,25,8,26,85
Kincardine,WSX,M,1,2,1,0,0,0,4
Kinross,AA,F,87,65,43,40,35,130,400
Kinross,AA,M,70,61,14,4,2,10,161
Kinross,AAX,F,86,94,30,36,26,154,426
Kinross,AAX,M,64,58,12,0,0,1,135
Kinross,AR,M,2,0,0,0,0,0,2
Kinross,AY,F,6,16,8,3,11,60,104
Kinross,AY,M,5,2,0,0,0,3,10
Kinross,AYX,F,13,4,27,12,4,0,60
Kinross,AYX,M,8,0,0,0,0,0,8
Kinross,BA,F,0,0,0,1,0,0,1
Kinross,BA,M,0,0,0,0,0,1,1
Kinross,BARX,M,0,0,0,0,0,1,1
Kinross,BAX,F,13,12,2,8,1,10,46
Kinross,BAX,M,10,6,3,0,0,1,20
Kinross,BAZX,F,8,0,0,0,0,0,8
Kinross,BB,F,0,0,1,2,7,3,13
Kinross,BB,M,0,0,0,1,2,0,3
Kinross,BBX,F,46,35,29,50,43,56,259
Kinross,BBX,M,58,18,7,0,0,1,84
Kinross,BF,F,61,63,82,51,55,120,432
Kinross,BF,M,65,44,6,0,0,1,116
Kinross,BFX,F,0,0,0,0,0,2,2
Kinross,BH,F,0,0,0,0,0,5,5
Kinross,BSH,M,0,0,0,1,1,0,2
Kinross,BSHX,F,0,0,0,2,0,7,9
Kinross,BSHX,M,0,1,0,0,0,0,1
Kinross,CB,F,0,0,0,0,0,5,5
Kinross,CH,F,1,4,0,4,0,10,19
Kinross,CH,M,6,2,2,3,0,3,16
Kinross,CHX,F,126,132,25,12,10,51,356
Kinross,CHX,M,93,116,3,0,0,17,229
Kinross,FR,F,0,0,0,0,0,105,105
Kinross,GA,F,0,0,0,0,0,2,2
Kinross,GAX,F,0,1,0,0,0,2,3
Kinross,GB,F,0,0,0,1,0,0,1
Kinross,GBX,M,1,0,0,0,0,0,1
Kinross,HE,F,0,0,0,0,0,10,10
Kinross,HE,M,0,1,0,0,0,0,1
Kinross,HERX,F,0,0,0,0,0,1,1
Kinross,HEX,F,0,0,0,1,0,52,53
Kinross,HEX,M,3,2,0,0,0,1,6
Kinross,HF,F,151,187,163,123,88,262,974
Kinross,HF,M,120,28,6,0,1,6,161
Kinross,HFX,F,55,50,25,36,28,29,223
Kinross,HFX,M,58,6,1,0,0,0,65
Kinross,HI,F,33,34,25,31,37,53,213
Kinross,HI,M,52,19,2,2,0,2,77
Kinross,HL,F,0,0,0,0,0,75,75
Kinross,HL,M,0,0,0,0,0,6,6
Kinross,HLX,F,0,0,0,0,0,4,4
Kinross,HO,F,78,139,80,17,31,33,378
Kinross,HO,M,0,2,0,1,0,0,3
Kinross,HX,F,0,0,0,0,0,1,1
Kinross,LI,F,0,0,0,0,0,2,2
Kinross,LI,M,0,0,0,0,0,2,2
Kinross,LIM,F,1,6,0,1,0,5,13
Kinross,LIM,M,4,7,5,4,3,8,31
Kinross,LIMBX,F,0,0,0,0,0,9,9
Kinross,LIMRX,F,0,0,0,0,0,6,6
Kinross,LIMX,F,436,246,86,70,80,281,"1,199"
Kinross,LIMX,M,471,216,8,0,0,7,702
Kinross,LIX,F,0,0,0,0,0,4,4
Kinross,LM,F,0,0,0,0,0,12,12
Kinross,LM,M,0,0,0,0,0,2,2
Kinross,LMX,F,0,0,0,0,0,99,99
Kinross,LMX,M,0,0,0,0,0,11,11
Kinross,LU,F,3,0,0,0,0,8,11
Kinross,LUX,F,2,0,0,0,0,4,6
Kinross,MO,F,1,0,0,0,1,4,6
Kinross,MO,M,1,1,0,0,0,0,2
Kinross,MOX,F,10,0,0,0,0,0,10
Kinross,MOX,M,6,0,0,0,0,0,6
Kinross,NS,F,0,0,0,0,0,4,4
Kinross,OB,F,0,0,0,0,0,1,1
Kinross,OO,F,0,0,0,0,0,2,2
Kinross,ROX,F,0,0,0,0,0,5,5
Kinross,SA,F,0,2,0,0,0,7,9
Kinross,SA,M,1,0,0,0,0,0,1
Kinross,SAX,F,6,4,12,9,9,50,90
Kinross,SAX,M,7,5,0,0,0,0,12
Kinross,SHO,F,0,0,0,0,0,3,3
Kinross,SHO,M,1,0,0,0,0,1,2
Kinross,SHOX,F,33,3,0,11,9,61,117
Kinross,SHOX,M,16,3,0,0,0,0,19
Kinross,SHX,F,0,0,0,1,0,2,3
Kinross,SM,F,9,7,3,5,6,29,59
Kinross,SM,M,10,5,2,0,1,15,33
Kinross,SMX,F,191,135,67,41,34,331,799
Kinross,SMX,M,186,120,17,0,5,10,338
Kinross,WBX,F,0,0,0,0,0,1,1
Kinross,WSX,F,0,0,0,0,0,1,1
Kirkcudbright,AA,F,209,192,128,118,121,597,"1,365"
Kirkcudbright,AA,M,241,150,52,47,23,72,585
Kirkcudbright,AAX,F,"2,599","2,357","1,162",921,937,"5,231","13,207"
Kirkcudbright,AAX,M,"2,524","1,831",296,8,1,102,"4,762"
Kirkcudbright,AR,F,1,0,1,0,0,0,2
Kirkcudbright,ARX,F,0,0,0,0,0,1,1
Kirkcudbright,ARX,M,1,1,0,0,0,0,2
Kirkcudbright,AY,F,417,435,404,322,298,907,"2,783"
Kirkcudbright,AY,M,67,27,21,1,2,2,120
Kirkcudbright,AYX,F,24,6,17,12,17,16,92
Kirkcudbright,AYX,M,2,1,0,0,0,0,3
Kirkcudbright,BA,F,3,5,0,3,2,31,44
Kirkcudbright,BA,M,1,2,1,1,0,10,15
Kirkcudbright,BAB,F,0,0,0,0,0,1,1
Kirkcudbright,BABX,F,0,0,0,0,0,1,1
Kirkcudbright,BAL,F,0,0,0,0,0,1,1
Kirkcudbright,BARX,F,0,0,0,0,0,4,4
Kirkcudbright,BAX,F,119,117,21,22,34,232,545
Kirkcudbright,BAX,M,121,114,9,2,0,45,291
Kirkcudbright,BAZ X,F,0,0,0,0,0,1,1
Kirkcudbright,BAZX,F,0,0,0,0,0,3,3
Kirkcudbright,BB,F,13,20,12,12,13,86,156
Kirkcudbright,BB,M,6,13,3,3,0,7,32
Kirkcudbright,BBX,F,462,427,156,133,116,529,"1,823"
Kirkcudbright,BBX,M,490,410,94,0,0,71,"1,065"
Kirkcudbright,BF,F,175,308,224,288,304,520,"1,819"
Kirkcudbright,BF,M,121,153,71,5,3,0,353
Kirkcudbright,BFX,F,5,23,16,20,13,46,123
Kirkcudbright,BFX,M,7,15,8,0,0,0,30
Kirkcudbright,BG,F,71,59,23,25,27,120,325
Kirkcudbright,BG,M,62,38,14,5,3,25,147
Kirkcudbright,BGX,F,13,13,6,2,3,15,52
Kirkcudbright,BGX,M,2,5,2,0,0,5,14
Kirkcudbright,BH,F,18,0,0,0,0,41,59
Kirkcudbright,BH,M,1,0,0,0,0,0,1
Kirkcudbright,BHX,F,0,0,0,0,0,21,21
Kirkcudbright,BLG,F,22,17,18,26,43,178,304
Kirkcudbright,BLG,M,8,1,0,0,0,0,9
Kirkcudbright,BLGX,M,1,0,0,0,0,0,1
Kirkcudbright,BRX,F,0,0,0,0,0,1,1
Kirkcudbright,BS,F,0,0,12,10,2,8,32
Kirkcudbright,BSH,F,51,38,14,33,30,29,195
Kirkcudbright,BSH,M,62,22,4,7,3,3,101
Kirkcudbright,BSHO,F,0,0,0,0,0,1,1
Kirkcudbright,BSHX,F,80,117,82,65,25,68,437
Kirkcudbright,BSHX,M,92,88,6,0,0,0,186
Kirkcudbright,BSX,F,0,0,11,3,0,4,18
Kirkcudbright,BSX,M,1,0,0,0,0,1,2
Kirkcudbright,BU,F,0,0,0,0,0,2,2
Kirkcudbright,BU,M,0,0,1,0,0,0,1
Kirkcudbright,BWX,F,0,0,0,0,1,0,1
Kirkcudbright,CAX,F,0,0,0,0,0,1,1
Kirkcudbright,CB,F,0,0,0,0,0,15,15
Kirkcudbright,CB,M,1,0,0,0,0,0,1
Kirkcudbright,CH,F,97,77,43,50,25,172,464
Kirkcudbright,CH,M,78,73,59,54,54,154,472
Kirkcudbright,CHIX,F,1,0,0,0,0,0,1
Kirkcudbright,CHIX,M,1,0,0,0,0,0,1
Kirkcudbright,CHX,F,"4,215","3,095",126,51,56,951,"8,494"
Kirkcudbright,CHX,M,"4,404","2,669",164,8,3,314,"7,562"
Kirkcudbright,DEV,F,0,0,0,0,0,1,1
Kirkcudbright,DEVX,F,21,4,4,0,2,3,34
Kirkcudbright,DEVX,M,23,2,0,0,0,0,25
Kirkcudbright,DEX,F,5,2,2,4,0,5,18
Kirkcudbright,DEX,M,4,2,0,0,1,0,7
Kirkcudbright,DEXX,F,1,1,0,0,0,0,2
Kirkcudbright,DEXX,M,0,1,0,0,0,0,1
Kirkcudbright,DG,F,0,0,0,0,0,6,6
Kirkcudbright,DS,F,0,1,17,5,8,26,57
Kirkcudbright,DS,M,0,0,0,0,0,2,2
Kirkcudbright,DSX,F,2,0,6,0,0,8,16
Kirkcudbright,DV,F,0,0,0,0,0,2,2
Kirkcudbright,DVX,F,0,0,0,0,0,1,1
Kirkcudbright,FR,F,0,0,0,0,0,"1,283","1,283"
Kirkcudbright,FR,M,0,0,0,0,0,2,2
Kirkcudbright,FRX,F,0,0,0,0,0,62,62
Kirkcudbright,GA,F,319,359,286,206,162,"1,145","2,477"
Kirkcudbright,GA,M,365,333,140,14,10,73,935
Kirkcudbright,GAX,F,30,37,10,17,13,121,228
Kirkcudbright,GAX,M,35,24,4,1,0,9,73
Kirkcudbright,GE,F,0,0,0,1,1,0,2
Kirkcudbright,GEX,F,0,0,3,11,11,2,27
Kirkcudbright,GL,F,0,0,3,0,0,0,3
Kirkcudbright,GLX,F,0,0,0,0,0,3,3
Kirkcudbright,GU,F,0,0,0,0,1,21,22
Kirkcudbright,H,F,0,0,0,0,0,3,3
Kirkcudbright,HE,F,10,18,26,6,17,83,160
Kirkcudbright,HE,M,15,2,2,5,2,13,39
Kirkcudbright,HEBL,F,0,0,0,0,0,3,3
Kirkcudbright,HEBLX,F,0,0,0,0,0,56,56
Kirkcudbright,HER,F,0,0,0,0,0,2,2
Kirkcudbright,HERX,F,0,0,0,0,0,16,16
Kirkcudbright,HEX,F,267,180,158,178,167,641,"1,591"
Kirkcudbright,HEX,M,205,125,2,1,0,9,342
Kirkcudbright,HF,F,"3,367","2,834","3,089","3,181","2,581","6,383","21,435"
Kirkcudbright,HF,M,858,382,188,40,11,169,"1,648"
Kirkcudbright,HFX,F,278,262,336,177,108,163,"1,324"
Kirkcudbright,HFX,M,61,26,37,1,0,9,134
Kirkcudbright,HI,F,54,39,38,23,23,116,293
Kirkcudbright,HI,M,33,44,44,12,0,6,139
Kirkcudbright,HIX,F,9,7,8,12,7,16,59
Kirkcudbright,HIX,M,10,6,2,2,1,0,21
Kirkcudbright,HL,F,0,0,0,0,0,18,18
Kirkcudbright,HL,M,0,0,0,0,0,2,2
Kirkcudbright,HLX,F,0,0,0,0,0,1,1
Kirkcudbright,HO,F,575,628,644,596,441,708,"3,592"
Kirkcudbright,HO,M,71,34,13,6,1,6,131
Kirkcudbright,HOX,F,214,265,159,91,76,108,913
Kirkcudbright,HOX,M,29,16,0,0,0,2,47
Kirkcudbright,HX,F,0,0,0,0,0,13,13
Kirkcudbright,IMX,F,0,0,0,0,0,1,1
Kirkcudbright,JE,F,10,10,28,14,17,25,104
Kirkcudbright,JE,M,1,1,3,2,0,2,9
Kirkcudbright,JEX,F,31,19,1,4,6,7,68
Kirkcudbright,JEX,M,4,1,0,0,0,0,5
Kirkcudbright,JY,F,0,0,0,0,0,6,6
Kirkcudbright,JYX,F,5,0,0,0,0,1,6
Kirkcudbright,LH,F,9,5,6,4,3,22,49
Kirkcudbright,LH,M,19,10,1,0,0,1,31
Kirkcudbright,LHX,F,3,3,1,0,1,4,12
Kirkcudbright,LHX,M,1,5,3,0,0,0,9
Kirkcudbright,LI,F,0,0,0,0,0,50,50
Kirkcudbright,LI,M,0,0,0,0,0,11,11
Kirkcudbright,LIM,F,180,210,136,97,100,322,"1,045"
Kirkcudbright,LIM,M,147,125,45,37,40,111,505
Kirkcudbright,LIMB,F,0,0,0,0,0,2,2
Kirkcudbright,LIMBX,F,0,0,0,0,0,286,286
Kirkcudbright,LIMBX,M,0,0,0,0,0,7,7
Kirkcudbright,LIMR,F,0,0,0,0,0,10,10
Kirkcudbright,LIMR,M,0,0,0,0,0,13,13
Kirkcudbright,LIMRX,F,0,0,0,0,0,117,117
Kirkcudbright,LIMRX,M,0,0,0,0,0,1,1
Kirkcudbright,LIMX,F,"4,092","3,330","1,163","1,003","1,031","3,726","14,345"
Kirkcudbright,LIMX,M,"3,980","2,753",353,6,8,22,"7,122"
Kirkcudbright,LIX,F,0,0,0,0,0,160,160
Kirkcudbright,LM,F,0,0,0,0,0,224,224
Kirkcudbright,LM,M,0,0,0,0,0,44,44
Kirkcudbright,LMX,F,0,0,0,0,0,"1,681","1,681"
Kirkcudbright,LMX,M,0,0,0,0,0,359,359
Kirkcudbright,LR,F,0,3,3,1,1,2,10
Kirkcudbright,LR,M,0,2,0,0,0,1,3
Kirkcudbright,LU,F,106,90,81,54,43,149,523
Kirkcudbright,LU,M,154,112,7,1,2,6,282
Kirkcudbright,LUX,F,32,26,7,5,14,14,98
Kirkcudbright,LUX,M,29,21,1,0,0,1,52
Kirkcudbright,MG,F,0,0,0,0,0,1,1
Kirkcudbright,MO,F,0,0,0,0,0,2,2
Kirkcudbright,MO,M,0,0,0,1,0,0,1
Kirkcudbright,MOX,F,59,51,14,26,15,10,175
Kirkcudbright,MOX,M,48,40,1,0,0,0,89
Kirkcudbright,MRI,F,12,9,15,9,3,47,95
Kirkcudbright,MRI,M,9,1,3,0,0,1,14
Kirkcudbright,MRIX,F,55,29,28,25,7,40,184
Kirkcudbright,MRIX,M,46,26,4,0,1,0,77
Kirkcudbright,NO,F,0,2,1,1,0,3,7
Kirkcudbright,NO,M,1,2,0,0,0,0,3
Kirkcudbright,NOX,F,4,5,1,2,3,78,93
Kirkcudbright,NOX,M,7,0,0,0,0,0,7
Kirkcudbright,NR,F,3,0,0,0,0,0,3
Kirkcudbright,NRX,F,31,0,0,6,0,1,38
Kirkcudbright,NRX,M,20,0,0,0,0,0,20
Kirkcudbright,NS,F,0,0,0,0,0,114,114
Kirkcudbright,NS,M,0,0,0,0,0,1,1
Kirkcudbright,OB,F,0,0,0,0,0,80,80
Kirkcudbright,OB,M,0,0,0,0,0,29,29
Kirkcudbright,OD,F,0,0,0,0,0,7,7
Kirkcudbright,OO,F,0,0,0,0,0,27,27
Kirkcudbright,OO,M,0,0,0,0,0,1,1
Kirkcudbright,PAX,F,1,0,0,0,0,1,2
Kirkcudbright,PAX,M,0,1,0,0,0,0,1
Kirkcudbright,PIX,F,4,2,2,0,0,15,23
Kirkcudbright,PIX,M,4,0,0,0,0,0,4
Kirkcudbright,ROX,F,9,9,3,2,5,10,38
Kirkcudbright,ROX,M,8,9,0,0,0,3,20
Kirkcudbright,RPX,F,0,0,0,0,0,6,6
Kirkcudbright,SA,F,20,19,11,16,15,137,218
Kirkcudbright,SA,M,19,22,6,6,2,17,72
Kirkcudbright,SAX,F,305,236,144,183,154,"1,351","2,373"
Kirkcudbright,SAX,M,238,128,12,1,0,71,450
Kirkcudbright,SBX,F,0,0,0,0,0,1,1
Kirkcudbright,SD,F,3,13,18,5,6,24,69
Kirkcudbright,SD,M,3,4,3,2,1,2,15
Kirkcudbright,SDX,F,110,37,23,24,10,54,258
Kirkcudbright,SDX,M,122,39,17,0,0,0,178
Kirkcudbright,SH,F,0,0,1,0,0,1,2
Kirkcudbright,SH,M,0,1,0,0,0,0,1
Kirkcudbright,SHO,F,19,35,39,30,19,103,245
Kirkcudbright,SHO,M,11,14,3,1,2,20,51
Kirkcudbright,SHOX,F,124,95,101,71,79,561,"1,031"
Kirkcudbright,SHOX,M,125,69,6,0,0,5,205
Kirkcudbright,SHX,F,2,0,0,2,1,1,6
Kirkcudbright,SHX,M,1,0,0,0,0,0,1
Kirkcudbright,SM,F,94,69,54,53,58,255,583
Kirkcudbright,SM,M,97,55,26,28,13,87,306
Kirkcudbright,SMX,F,"1,807","1,342",479,361,275,"1,978","6,242"
Kirkcudbright,SMX,M,"1,833","1,136",133,8,1,198,"3,309"
Kirkcudbright,SRW,F,10,13,15,13,10,46,107
Kirkcudbright,SRW,M,2,1,0,0,0,0,3
Kirkcudbright,SRWX,F,34,2,0,0,0,1,37
Kirkcudbright,SRWX,M,7,0,0,0,0,0,7
Kirkcudbright,ST,F,17,0,0,0,0,0,17
Kirkcudbright,ST,M,14,1,4,1,0,0,20
Kirkcudbright,STX,F,74,59,9,0,0,0,142
Kirkcudbright,STX,M,84,51,6,0,0,0,141
Kirkcudbright,SUX,F,0,0,0,0,0,3,3
Kirkcudbright,WB,F,18,6,8,7,4,19,62
Kirkcudbright,WB,M,7,5,7,0,0,1,20
Kirkcudbright,WBX,F,6,12,7,14,2,14,55
Kirkcudbright,WBX,M,16,1,1,0,0,1,19
Kirkcudbright,WG,F,36,40,17,12,11,64,180
Kirkcudbright,WG,M,39,21,3,1,0,1,65
Kirkcudbright,WGX,M,0,2,0,0,0,0,2
Kirkcudbright,WS,F,6,0,3,1,0,11,21
Kirkcudbright,WS,M,4,8,5,3,0,4,24
Kirkcudbright,WSX,F,45,75,53,79,92,276,620
Kirkcudbright,WSX,M,45,53,20,0,0,0,118
Lanarkshire,AA,F,250,208,116,85,79,432,"1,170"
Lanarkshire,AA,M,247,178,37,21,17,65,565
Lanarkshire,AAX,F,"1,394","1,107",444,350,320,"1,895","5,510"
Lanarkshire,AAX,M,"1,376","1,151",132,6,5,55,"2,725"
Lanarkshire,ARX,F,0,0,0,0,0,2,2
Lanarkshire,ARX,M,1,0,0,0,0,1,2
Lanarkshire,AY,F,255,236,222,214,180,616,"1,723"
Lanarkshire,AY,M,36,40,20,6,2,11,115
Lanarkshire,AYX,F,16,10,4,6,9,68,113
Lanarkshire,AYX,M,2,2,0,0,0,0,4
Lanarkshire,BA,F,45,34,24,21,7,124,255
Lanarkshire,BA,M,43,13,6,2,4,28,96
Lanarkshire,BABX,F,0,0,0,0,0,1,1
Lanarkshire,BARX,F,0,0,0,0,0,2,2
Lanarkshire,BAX,F,284,193,47,38,49,400,"1,011"
Lanarkshire,BAX,M,268,130,29,3,1,38,469
Lanarkshire,BAZX,F,1,0,0,0,0,1,2
Lanarkshire,BB,F,50,41,23,21,13,132,280
Lanarkshire,BB,M,60,47,17,4,12,38,178
Lanarkshire,BBX,F,978,897,367,276,238,952,"3,708"
Lanarkshire,BBX,M,"1,066",680,93,10,4,44,"1,897"
Lanarkshire,BF,F,402,411,491,552,632,"1,041","3,529"
Lanarkshire,BF,M,308,223,67,24,11,18,651
Lanarkshire,BFX,F,31,62,97,74,53,144,461
Lanarkshire,BFX,M,26,31,10,6,2,4,79
Lanarkshire,BG,F,3,2,3,4,0,9,21
Lanarkshire,BG,M,3,5,2,1,0,0,11
Lanarkshire,BGX,F,17,8,8,1,0,24,58
Lanarkshire,BGX,M,10,2,1,0,0,0,13
Lanarkshire,BH,F,2,0,0,0,0,72,74
Lanarkshire,BHX,F,0,0,0,0,0,49,49
Lanarkshire,BHX,M,1,0,0,0,0,0,1
Lanarkshire,BLG,F,0,8,0,4,9,8,29
Lanarkshire,BLG,M,5,2,0,0,0,0,7
Lanarkshire,BLGX,F,0,0,0,0,0,1,1
Lanarkshire,BRX,F,2,0,0,0,0,0,2
Lanarkshire,BS,F,7,27,11,9,8,13,75
Lanarkshire,BS,M,0,3,0,0,0,0,3
Lanarkshire,BSH,F,57,53,38,30,12,19,209
Lanarkshire,BSH,M,63,41,4,6,1,3,118
Lanarkshire,BSHX,F,106,67,54,55,20,58,360
Lanarkshire,BSHX,M,114,40,3,0,0,1,158
Lanarkshire,BSX,F,9,8,8,23,13,23,84
Lanarkshire,BSX,M,6,6,3,0,0,1,16
Lanarkshire,BW,F,1,1,0,1,0,2,5
Lanarkshire,BWX,F,0,0,0,0,0,3,3
Lanarkshire,CB,F,0,0,3,0,0,39,42
Lanarkshire,CB,M,0,0,0,0,0,1,1
Lanarkshire,CD,F,0,0,0,0,0,3,3
Lanarkshire,CH,F,87,82,53,48,45,197,512
Lanarkshire,CH,M,84,53,29,24,28,119,337
Lanarkshire,CHIX,M,0,0,0,0,1,0,1
Lanarkshire,CHL,F,0,0,1,0,0,0,1
Lanarkshire,CHX,F,"2,371","1,111",190,163,143,"1,012","4,990"
Lanarkshire,CHX,M,"2,338","1,060",88,12,11,306,"3,815"
Lanarkshire,DEV,F,4,6,10,8,0,17,45
Lanarkshire,DEV,M,8,3,0,0,0,1,12
Lanarkshire,DEVX,F,0,1,0,0,0,3,4
Lanarkshire,DEX,F,0,1,1,2,0,0,4
Lanarkshire,DEX,M,2,0,0,0,0,0,2
Lanarkshire,DEXX,M,0,1,1,0,0,0,2
Lanarkshire,DG,F,0,0,0,0,0,2,2
Lanarkshire,DR,F,0,0,0,1,0,0,1
Lanarkshire,DS,F,0,1,0,1,0,3,5
Lanarkshire,DS,M,1,0,0,0,0,0,1
Lanarkshire,DSX,F,0,0,0,0,0,1,1
Lanarkshire,FR,F,0,0,0,0,0,"1,537","1,537"
Lanarkshire,FR,M,0,0,0,0,0,8,8
Lanarkshire,FRX,F,0,0,0,0,0,48,48
Lanarkshire,GA,F,17,8,13,24,22,35,119
Lanarkshire,GA,M,12,4,2,1,0,1,20
Lanarkshire,GAX,F,1,1,3,1,2,54,62
Lanarkshire,GAX,M,0,4,0,0,0,0,4
Lanarkshire,GB,M,1,0,0,0,0,0,1
Lanarkshire,GEX,F,0,1,0,0,0,0,1
Lanarkshire,GLX,F,0,0,0,1,0,4,5
Lanarkshire,H,F,0,0,0,0,0,3,3
Lanarkshire,H,M,0,0,0,0,0,1,1
Lanarkshire,HE,F,36,14,31,35,19,142,277
Lanarkshire,HE,M,26,5,3,0,1,15,50
Lanarkshire,HEBL,F,0,0,0,0,0,11,11
Lanarkshire,HEBLX,F,0,0,0,0,0,25,25
Lanarkshire,HER,F,0,0,0,0,0,11,11
Lanarkshire,HERX,F,0,0,0,0,0,13,13
Lanarkshire,HEX,F,79,92,113,94,86,433,897
Lanarkshire,HEX,M,68,69,15,1,4,14,171
Lanarkshire,HF,F,"2,639","2,685","2,873","2,418","2,310","6,443","19,368"
Lanarkshire,HF,M,"1,314",786,342,44,29,356,"2,871"
Lanarkshire,HFX,F,149,144,166,191,202,448,"1,300"
Lanarkshire,HFX,M,138,118,37,2,0,8,303
Lanarkshire,HI,F,62,57,38,42,45,152,396
Lanarkshire,HI,M,53,37,14,17,4,18,143
Lanarkshire,HIX,F,7,6,4,2,0,11,30
Lanarkshire,HIX,M,6,6,5,0,0,1,18
Lanarkshire,HL,F,0,0,0,0,0,61,61
Lanarkshire,HL,M,0,0,0,0,0,7,7
Lanarkshire,HLX,F,0,0,0,0,0,4,4
Lanarkshire,HLX,M,0,0,0,0,0,2,2
Lanarkshire,HO,F,796,920,700,523,406,634,"3,979"
Lanarkshire,HO,M,230,144,54,4,3,3,438
Lanarkshire,HOX,F,62,29,30,59,50,82,312
Lanarkshire,HOX,M,53,52,7,0,0,0,112
Lanarkshire,HX,F,0,0,0,0,0,5,5
Lanarkshire,IM,F,0,0,0,0,0,1,1
Lanarkshire,JE,F,15,16,13,23,10,23,100
Lanarkshire,JE,M,4,0,1,0,0,0,5
Lanarkshire,JEX,F,11,3,37,16,9,4,80
Lanarkshire,JEX,M,2,3,0,0,0,0,5
Lanarkshire,JY,F,4,0,0,0,0,3,7
Lanarkshire,KE,M,0,1,0,0,0,0,1
Lanarkshire,LH,F,2,1,2,0,0,8,13
Lanarkshire,LH,M,0,0,0,0,0,2,2
Lanarkshire,LHX,F,2,0,0,0,0,1,3
Lanarkshire,LHX,M,1,0,1,0,0,0,2
Lanarkshire,LI,F,0,0,0,0,0,32,32
Lanarkshire,LI,M,0,0,0,0,0,9,9
Lanarkshire,LIM,F,529,408,266,184,169,688,"2,244"
Lanarkshire,LIM,M,581,295,102,58,37,125,"1,198"
Lanarkshire,LIMB,F,0,0,0,0,0,15,15
Lanarkshire,LIMB,M,0,0,0,0,0,1,1
Lanarkshire,LIMBX,F,0,0,0,0,0,230,230
Lanarkshire,LIMBX,M,0,0,0,0,0,2,2
Lanarkshire,LIMR,F,0,0,0,0,0,7,7
Lanarkshire,LIMR,M,0,0,0,0,0,8,8
Lanarkshire,LIMRX,F,0,0,0,0,0,107,107
Lanarkshire,LIMRX,M,0,0,0,0,0,3,3
Lanarkshire,LIMX,F,"5,118","3,658","1,345","1,000","1,126","4,411","16,658"
Lanarkshire,LIMX,M,"4,981","2,902",384,34,29,47,"8,377"
Lanarkshire,LIX,F,0,0,0,0,0,194,194
Lanarkshire,LIX,M,0,0,0,0,0,1,1
Lanarkshire,LM,F,0,0,0,0,0,473,473
Lanarkshire,LM,M,0,0,0,0,0,122,122
Lanarkshire,LMX,F,0,0,0,0,0,"2,267","2,267"
Lanarkshire,LMX,M,0,0,0,0,0,346,346
Lanarkshire,LR,F,0,0,0,0,0,1,1
Lanarkshire,LRX,F,0,1,0,2,0,4,7
Lanarkshire,LRX,M,1,0,0,0,0,0,1
Lanarkshire,LU,F,88,35,30,20,23,157,353
Lanarkshire,LU,M,97,26,3,3,4,3,136
Lanarkshire,LUX,F,32,11,8,0,1,7,59
Lanarkshire,LUX,M,24,14,3,0,0,1,42
Lanarkshire,MAX,F,0,0,0,0,0,1,1
Lanarkshire,MG,F,0,0,0,0,1,0,1
Lanarkshire,MGX,F,0,0,0,0,0,4,4
Lanarkshire,MGX,M,0,0,1,0,0,0,1
Lanarkshire,MO,F,14,2,5,2,4,4,31
Lanarkshire,MO,M,21,4,4,1,0,0,30
Lanarkshire,MOX,F,156,40,19,7,1,3,226
Lanarkshire,MOX,M,137,23,1,0,0,0,161
Lanarkshire,MRI,F,35,10,14,49,53,143,304
Lanarkshire,MRI,M,49,9,0,1,0,1,60
Lanarkshire,MRIX,F,93,102,118,91,56,231,691
Lanarkshire,MRIX,M,57,38,9,0,1,0,105
Lanarkshire,ND,F,0,0,0,0,0,3,3
Lanarkshire,NOX,F,1,4,1,1,0,0,7
Lanarkshire,NOX,M,2,0,0,0,0,0,2
Lanarkshire,NRX,F,22,0,0,0,0,0,22
Lanarkshire,NRX,M,5,0,0,0,0,0,5
Lanarkshire,NS,F,0,0,0,0,0,132,132
Lanarkshire,NS,M,0,0,0,0,0,2,2
Lanarkshire,OB,F,0,0,0,0,0,107,107
Lanarkshire,OB,M,0,0,0,0,0,5,5
Lanarkshire,OD,F,0,0,0,0,0,13,13
Lanarkshire,OD,M,0,0,0,0,0,3,3
Lanarkshire,OO,F,0,0,0,0,0,25,25
Lanarkshire,OO,M,0,0,0,0,0,12,12
Lanarkshire,PA,F,0,0,0,1,0,1,2
Lanarkshire,PA,M,1,0,0,0,0,0,1
Lanarkshire,PAX,F,9,2,6,0,0,1,18
Lanarkshire,PAX,M,8,8,3,0,0,0,19
Lanarkshire,PIX,F,0,0,0,0,0,3,3
Lanarkshire,RO,F,0,0,0,0,0,2,2
Lanarkshire,ROX,F,1,0,1,0,0,15,17
Lanarkshire,ROX,M,0,1,0,0,0,13,14
Lanarkshire,RWFR,F,0,0,0,0,0,1,1
Lanarkshire,SA,F,10,22,12,4,7,23,78
Lanarkshire,SA,M,25,23,1,0,0,2,51
Lanarkshire,SAX,F,24,21,7,5,14,161,232
Lanarkshire,SAX,M,37,33,3,0,0,4,77
Lanarkshire,SBX,M,1,0,0,0,0,0,1
Lanarkshire,SD,F,1,1,0,0,0,2,4
Lanarkshire,SD,M,3,0,0,0,0,0,3
Lanarkshire,SDX,F,11,0,0,0,0,0,11
Lanarkshire,SDX,M,7,4,0,0,0,0,11
Lanarkshire,SH,F,3,9,3,5,7,17,44
Lanarkshire,SH,M,5,5,1,1,0,0,12
Lanarkshire,SHO,F,55,26,30,9,17,91,228
Lanarkshire,SHO,M,37,11,2,0,2,7,59
Lanarkshire,SHOX,F,70,64,45,22,31,98,330
Lanarkshire,SHOX,M,90,65,3,2,0,0,160
Lanarkshire,SHX,F,0,1,0,0,0,9,10
Lanarkshire,SHX,M,1,0,0,0,0,0,1
Lanarkshire,SM,F,193,127,67,47,36,397,867
Lanarkshire,SM,M,151,87,27,23,20,64,372
Lanarkshire,SMX,F,"1,097",817,395,248,267,"1,722","4,546"
Lanarkshire,SMX,M,"1,076",734,70,8,7,156,"2,051"
Lanarkshire,SRWX,F,0,0,0,0,0,1,1
Lanarkshire,SRWX,M,1,0,0,0,0,0,1
Lanarkshire,SU,F,0,0,0,0,0,2,2
Lanarkshire,WB,F,4,0,4,4,0,3,15
Lanarkshire,WB,M,2,0,0,0,0,0,2
Lanarkshire,WBX,F,0,0,0,0,0,2,2
Lanarkshire,WBX,M,1,1,0,0,0,0,2
Lanarkshire,WG,F,0,0,0,1,0,1,2
Lanarkshire,WG,M,1,0,0,0,0,0,1
Lanarkshire,WP,M,0,0,1,0,3,2,6
Lanarkshire,WSX,F,0,11,3,5,1,6,26
Lanarkshire,WSX,M,2,5,0,0,0,0,7
Mid Lothian,AA,F,61,78,33,71,27,144,414
Mid Lothian,AA,M,81,90,17,11,9,25,233
Mid Lothian,AAX,F,846,779,352,194,215,858,"3,244"
Mid Lothian,AAX,M,866,483,43,0,1,6,"1,399"
Mid Lothian,AMX,F,1,0,0,0,0,0,1
Mid Lothian,AR,M,1,0,0,0,0,0,1
Mid Lothian,AY,F,26,22,24,34,20,57,183
Mid Lothian,AY,M,48,43,46,4,1,0,142
Mid Lothian,AYX,M,0,11,5,0,0,0,16
Mid Lothian,BA,F,4,15,7,4,5,29,64
Mid Lothian,BA,M,8,4,5,3,1,6,27
Mid Lothian,BARX,F,0,0,0,0,0,1,1
Mid Lothian,BAX,F,164,173,16,10,18,138,519
Mid Lothian,BAX,M,132,105,1,1,0,20,259
Mid Lothian,BAZ,F,2,2,3,1,1,3,12
Mid Lothian,BAZ,M,2,1,1,0,1,0,5
Mid Lothian,BAZX,F,14,20,12,4,1,12,63
Mid Lothian,BAZX,M,13,4,0,0,0,0,17
Mid Lothian,BB,F,4,8,3,11,4,40,70
Mid Lothian,BB,M,5,1,9,0,1,2,18
Mid Lothian,BBX,F,114,133,89,76,91,233,736
Mid Lothian,BBX,M,103,55,15,0,0,14,187
Mid Lothian,BF,F,55,61,59,11,15,139,340
Mid Lothian,BF,M,115,115,39,0,0,3,272
Mid Lothian,BFX,F,1,0,0,0,0,2,3
Mid Lothian,BFX,M,2,10,0,0,0,0,12
Mid Lothian,BG,F,0,0,0,0,0,3,3
Mid Lothian,BG,M,0,2,1,0,0,0,3
Mid Lothian,BGX,M,1,0,0,0,0,0,1
Mid Lothian,BLG,F,1,33,44,61,29,85,253
Mid Lothian,BLG,M,10,0,0,0,0,0,10
Mid Lothian,BLGX,F,0,0,0,0,0,35,35
Mid Lothian,BS,M,0,1,0,0,0,0,1
Mid Lothian,BSH,F,10,11,14,1,5,5,46
Mid Lothian,BSH,M,4,3,0,0,1,2,10
Mid Lothian,BSHX,F,35,31,11,6,7,19,109
Mid Lothian,BSHX,M,24,11,1,0,0,0,36
Mid Lothian,BSX,F,0,0,0,1,0,0,1
Mid Lothian,BSX,M,0,1,0,0,0,0,1
Mid Lothian,CB,F,0,0,0,0,0,28,28
Mid Lothian,CH,F,20,13,15,21,8,36,113
Mid Lothian,CH,M,17,10,15,9,6,43,100
Mid Lothian,CHX,F,855,466,13,15,6,324,"1,679"
Mid Lothian,CHX,M,918,225,16,0,0,164,"1,323"
Mid Lothian,DEX,M,0,1,0,0,0,0,1
Mid Lothian,DEXX,F,0,0,0,0,0,2,2
Mid Lothian,DR,F,0,2,0,0,0,0,2
Mid Lothian,DSX,F,0,0,0,0,0,1,1
Mid Lothian,FR,F,0,0,0,0,0,96,96
Mid Lothian,FR,M,0,0,0,0,0,3,3
Mid Lothian,FRX,F,0,0,0,0,0,2,2
Mid Lothian,GA,F,0,0,6,1,0,2,9
Mid Lothian,GA,M,13,3,4,0,0,0,20
Mid Lothian,GAX,F,4,7,4,7,3,11,36
Mid Lothian,GAX,M,1,6,0,0,0,1,8
Mid Lothian,GEX,F,0,0,0,0,0,3,3
Mid Lothian,H,F,0,0,0,0,0,4,4
Mid Lothian,HE,F,0,2,2,2,2,15,23
Mid Lothian,HE,M,0,4,0,0,1,1,6
Mid Lothian,HEBLX,F,0,0,0,0,0,11,11
Mid Lothian,HERX,F,0,0,0,0,0,19,19
Mid Lothian,HEX,F,21,29,19,29,29,228,355
Mid Lothian,HEX,M,11,49,1,0,0,9,70
Mid Lothian,HF,F,273,302,248,248,205,524,"1,800"
Mid Lothian,HF,M,417,223,56,3,3,124,826
Mid Lothian,HFX,F,2,3,0,0,2,8,15
Mid Lothian,HFX,M,89,17,2,0,0,0,108
Mid Lothian,HI,F,16,8,14,7,7,30,82
Mid Lothian,HI,M,18,5,7,0,6,14,50
Mid Lothian,HIX,F,0,1,2,0,0,1,4
Mid Lothian,HIX,M,2,0,0,0,0,0,2
Mid Lothian,HL,F,0,0,0,0,0,8,8
Mid Lothian,HL,M,0,0,0,0,0,4,4
Mid Lothian,HO,F,0,30,73,1,4,14,122
Mid Lothian,HO,M,80,36,6,0,0,0,122
Mid Lothian,HOX,F,0,0,0,0,0,2,2
Mid Lothian,HOX,M,7,1,0,0,0,0,8
Mid Lothian,HX,F,0,0,0,0,0,8,8
Mid Lothian,IM,M,0,0,1,0,0,0,1
Mid Lothian,IMX,F,1,0,0,0,0,0,1
Mid Lothian,IMX,M,0,1,0,0,0,0,1
Mid Lothian,JE,F,0,0,0,1,1,2,4
Mid Lothian,JEX,F,0,1,0,0,0,0,1
Mid Lothian,JEX,M,1,0,0,0,0,0,1
Mid Lothian,JY,F,0,0,0,0,0,2,2
Mid Lothian,LH,F,0,2,0,0,0,0,2
Mid Lothian,LH,M,2,3,0,0,0,0,5
Mid Lothian,LHX,F,1,1,0,0,0,0,2
Mid Lothian,LHX,M,1,0,0,0,0,0,1
Mid Lothian,LI,F,0,0,0,0,0,20,20
Mid Lothian,LI,M,0,0,0,0,0,2,2
Mid Lothian,LIM,F,80,74,45,52,35,118,404
Mid Lothian,LIM,M,78,29,16,10,11,37,181
Mid Lothian,LIMB,F,0,0,0,0,0,2,2
Mid Lothian,LIMBX,F,0,0,0,0,0,53,53
Mid Lothian,LIMR,F,0,0,0,0,0,4,4
Mid Lothian,LIMR,M,0,0,0,0,0,3,3
Mid Lothian,LIMRX,F,0,0,0,0,0,30,30
Mid Lothian,LIMX,F,"1,313","1,248",387,397,440,"1,292","5,077"
Mid Lothian,LIMX,M,"1,228",820,50,5,0,8,"2,111"
Mid Lothian,LIX,F,0,0,0,0,0,142,142
Mid Lothian,LM,F,0,0,0,0,0,60,60
Mid Lothian,LM,M,0,0,0,0,0,19,19
Mid Lothian,LMX,F,0,0,0,0,0,445,445
Mid Lothian,LMX,M,0,0,0,0,0,118,118
Mid Lothian,LRX,F,0,0,0,0,0,2,2
Mid Lothian,LRX,M,5,3,0,0,0,0,8
Mid Lothian,LU,F,16,18,16,2,7,34,93
Mid Lothian,LU,M,6,3,1,0,1,0,11
Mid Lothian,LUX,F,1,14,1,1,5,4,26
Mid Lothian,LUX,M,1,6,2,0,0,0,9
Mid Lothian,MG,F,0,0,0,0,1,4,5
Mid Lothian,MO,F,0,4,0,0,0,0,4
Mid Lothian,MOX,F,6,8,8,2,6,0,30
Mid Lothian,MOX,M,8,6,0,0,0,0,14
Mid Lothian,MRI,F,1,0,0,1,0,1,3
Mid Lothian,MRI,M,1,0,0,1,0,0,2
Mid Lothian,MRIX,F,15,26,13,2,1,0,57
Mid Lothian,MRIX,M,24,23,8,0,0,0,55
Mid Lothian,ND,F,0,0,0,0,0,2,2
Mid Lothian,NDX,F,0,0,0,0,0,4,4
Mid Lothian,NOX,F,10,15,18,16,4,47,110
Mid Lothian,NOX,M,11,4,0,0,0,0,15
Mid Lothian,NS,F,0,0,0,0,0,9,9
Mid Lothian,OB,F,0,0,0,0,0,5,5
Mid Lothian,OO,F,0,0,0,0,0,2,2
Mid Lothian,PAX,F,0,0,0,0,0,3,3
Mid Lothian,PAX,M,0,3,0,0,0,0,3
Mid Lothian,RP,M,0,0,1,0,0,0,1
Mid Lothian,RPX,F,1,0,0,1,0,0,2
Mid Lothian,SA,F,1,1,0,0,0,9,11
Mid Lothian,SA,M,0,0,2,0,1,3,6
Mid Lothian,SAX,F,80,62,64,33,18,190,447
Mid Lothian,SAX,M,66,29,5,0,0,1,101
Mid Lothian,SD,F,0,0,0,0,1,0,1
Mid Lothian,SDX,F,0,2,0,0,0,2,4
Mid Lothian,SDX,M,0,2,0,0,0,0,2
Mid Lothian,SHO,F,3,2,3,0,0,7,15
Mid Lothian,SHO,M,4,9,0,0,0,0,13
Mid Lothian,SHOX,F,32,64,14,14,8,78,210
Mid Lothian,SHOX,M,31,32,0,0,0,0,63
Mid Lothian,SHX,F,0,1,0,0,0,3,4
Mid Lothian,SHX,M,0,1,0,0,0,0,1
Mid Lothian,SM,F,51,38,36,18,9,94,246
Mid Lothian,SM,M,38,24,1,4,1,16,84
Mid Lothian,SMX,F,392,403,166,130,101,954,"2,146"
Mid Lothian,SMX,M,370,221,10,0,0,46,647
Mid Lothian,ST,M,0,6,0,0,0,0,6
Mid Lothian,STX,F,0,0,0,0,3,0,3
Mid Lothian,STX,M,0,1,0,0,0,0,1
Mid Lothian,SUX,F,0,0,0,0,5,0,5
Mid Lothian,WA,M,0,4,0,0,0,0,4
Mid Lothian,WAX,M,0,6,0,0,0,0,6
Mid Lothian,WBX,M,0,1,0,0,0,0,1
Mid Lothian,WG,F,0,0,0,0,0,1,1
Mid Lothian,WSX,F,0,9,15,11,0,20,55
Mid Lothian,WSX,M,0,9,0,0,0,0,9
Mid Lothian,ZE,F,0,0,0,0,0,1,1
Mid Lothian,ZE,M,0,0,0,0,0,3,3
Moray,AA,F,203,133,81,59,60,252,788
Moray,AA,M,204,169,22,12,8,19,434
Moray,AAX,F,415,319,185,163,96,592,"1,770"
Moray,AAX,M,408,245,28,8,7,12,708
Moray,AY,F,1,3,1,0,2,6,13
Moray,AY,M,0,0,0,0,0,1,1
Moray,AYX,F,0,0,0,1,0,0,1
Moray,BA,F,19,19,4,1,1,4,48
Moray,BA,M,18,1,0,0,0,1,20
Moray,BARX,F,0,0,0,0,0,1,1
Moray,BAW,M,0,0,0,0,0,1,1
Moray,BAWX,F,0,0,0,0,0,1,1
Moray,BAX,F,15,14,6,7,7,37,86
Moray,BAX,M,12,13,0,0,0,0,25
Moray,BAZX,M,0,2,0,0,0,0,2
Moray,BB,F,12,2,12,6,5,33,70
Moray,BB,M,6,3,2,1,1,4,17
Moray,BBX,F,198,188,123,155,158,421,"1,243"
Moray,BBX,M,134,74,5,0,0,11,224
Moray,BF,F,13,1,0,0,0,3,17
Moray,BF,M,12,0,1,2,0,0,15
Moray,BG,F,0,0,0,0,0,1,1
Moray,BGX,F,0,0,0,0,1,2,3
Moray,BH,F,5,0,0,0,0,7,12
Moray,BH,M,2,0,0,0,0,0,2
Moray,BS,F,1,1,0,0,3,1,6
Moray,BSH,F,0,1,0,0,0,0,1
Moray,BSH,M,0,2,2,0,1,2,7
Moray,BSHX,F,33,19,10,8,3,11,84
Moray,BSHX,M,41,11,3,4,1,0,60
Moray,CB,F,0,0,0,0,0,39,39
Moray,CH,F,39,30,10,21,12,77,189
Moray,CH,M,23,24,17,14,10,32,120
Moray,CHIX,F,0,0,0,0,0,1,1
Moray,CHX,F,935,845,105,108,99,660,"2,752"
Moray,CHX,M,960,329,12,4,0,111,"1,416"
Moray,DEVX,F,0,0,0,0,0,2,2
Moray,DS,F,0,1,0,0,0,0,1
Moray,DSX,F,0,1,0,0,0,0,1
Moray,FR,F,0,0,0,0,0,72,72
Moray,FRX,F,0,0,0,0,0,6,6
Moray,GA,F,0,0,1,1,0,0,2
Moray,GAX,F,0,0,0,0,0,2,2
Moray,HE,F,5,3,1,2,0,5,16
Moray,HE,M,0,0,0,0,0,2,2
Moray,HEBL,F,0,0,0,0,0,1,1
Moray,HEBLX,F,0,0,0,0,0,10,10
Moray,HER,F,0,0,0,0,0,1,1
Moray,HER,M,0,0,0,0,0,1,1
Moray,HERX,F,0,0,0,0,0,2,2
Moray,HEX,F,41,21,14,15,9,99,199
Moray,HEX,M,11,8,2,0,0,0,21
Moray,HF,F,256,236,275,210,208,730,"1,915"
Moray,HF,M,63,23,7,6,3,19,121
Moray,HFX,F,1,0,0,0,0,5,6
Moray,HI,F,56,38,36,34,34,160,358
Moray,HI,M,52,25,15,6,1,5,104
Moray,HIX,F,1,1,1,0,0,1,4
Moray,HIX,M,1,0,0,0,0,0,1
Moray,HL,F,0,0,0,0,0,67,67
Moray,HL,M,0,0,0,0,0,4,4
Moray,HLX,F,0,0,0,0,0,2,2
Moray,HO,F,291,284,254,197,148,251,"1,425"
Moray,HO,M,159,37,1,3,1,5,206
Moray,HOX,F,0,0,1,0,0,1,2
Moray,HX,F,0,0,0,0,0,1,1
Moray,JE,F,0,0,0,1,1,5,7
Moray,JEX,F,0,1,0,0,0,0,1
Moray,JY,F,0,0,0,0,0,8,8
Moray,LH,F,6,3,2,1,1,14,27
Moray,LH,M,6,4,1,0,0,0,11
Moray,LHX,F,1,1,0,1,0,0,3
Moray,LHX,M,0,0,1,0,0,0,1
Moray,LI,F,0,0,0,0,0,4,4
Moray,LI,M,0,0,0,0,0,4,4
Moray,LIM,F,75,33,21,24,37,96,286
Moray,LIM,M,88,43,18,21,19,36,225
Moray,LIMB,F,0,0,0,0,0,1,1
Moray,LIMBX,F,0,0,0,0,0,5,5
Moray,LIMR,F,0,0,0,0,0,1,1
Moray,LIMRX,F,0,0,0,0,0,29,29
Moray,LIMX,F,"1,543","1,099",362,294,322,"1,170","4,790"
Moray,LIMX,M,"1,591",693,60,10,1,23,"2,378"
Moray,LIX,F,0,0,0,0,0,18,18
Moray,LM,F,0,0,0,0,0,41,41
Moray,LM,M,0,0,0,0,0,10,10
Moray,LMX,F,0,0,0,0,0,494,494
Moray,LMX,M,0,0,0,0,0,39,39
Moray,LU,F,0,2,0,0,0,3,5
Moray,LU,M,0,1,0,0,0,0,1
Moray,LUX,F,0,1,0,2,0,12,15
Moray,LUX,M,1,0,0,0,0,0,1
Moray,MO,F,0,0,0,0,0,1,1
Moray,NS,F,0,0,0,0,0,23,23
Moray,NS,M,0,0,0,0,0,1,1
Moray,OB,F,0,0,0,0,0,7,7
Moray,OO,F,0,0,0,0,0,5,5
Moray,PAX,F,0,0,0,0,0,1,1
Moray,PIX,F,0,1,0,0,1,0,2
Moray,RO,M,0,2,0,0,0,0,2
Moray,ROX,F,2,6,0,5,0,9,22
Moray,ROX,M,1,1,0,0,0,0,2
Moray,SA,F,0,0,0,0,0,2,2
Moray,SA,M,0,0,0,0,0,1,1
Moray,SAX,F,10,17,25,12,3,84,151
Moray,SAX,M,13,7,0,0,0,0,20
Moray,SDX,F,1,0,0,0,0,4,5
Moray,SDX,M,0,2,0,0,0,0,2
Moray,SHO,F,0,0,0,0,0,26,26
Moray,SHO,M,1,0,0,0,2,2,5
Moray,SHOX,F,29,41,14,10,14,107,215
Moray,SHOX,M,21,38,1,0,0,5,65
Moray,SHX,F,0,2,0,0,0,2,4
Moray,SHX,M,1,0,0,0,0,0,1
Moray,SM,F,178,171,110,103,109,352,"1,023"
Moray,SM,M,197,54,14,18,27,38,348
Moray,SMX,F,"1,331","1,061",648,553,510,"2,422","6,525"
Moray,SMX,M,"1,372",461,45,17,3,59,"1,957"
Moray,STX,F,0,0,0,0,3,0,3
Moray,STX,M,0,1,0,0,0,0,1
Moray,SUX,F,0,0,0,0,2,0,2
Moray,WS,F,6,3,5,4,1,9,28
Moray,WS,M,6,7,0,0,2,2,17
Moray,WSX,F,26,1,22,9,3,36,97
Moray,WSX,M,20,40,1,0,0,0,61
Nairn,AA,F,59,60,33,24,33,129,338
Nairn,AA,M,71,42,5,4,1,6,129
Nairn,AAX,F,110,80,50,34,53,224,551
Nairn,AAX,M,128,77,0,0,0,4,209
Nairn,AY,F,0,0,0,0,0,1,1
Nairn,BA,F,0,2,0,2,0,7,11
Nairn,BA,M,1,0,2,0,0,2,5
Nairn,BAX,F,50,11,17,10,3,103,194
Nairn,BAX,M,34,4,1,1,0,6,46
Nairn,BAZX,F,0,2,0,0,0,1,3
Nairn,BB,F,6,1,3,6,4,17,37
Nairn,BB,M,4,0,2,3,0,2,11
Nairn,BBX,F,69,41,86,71,69,162,498
Nairn,BBX,M,70,1,0,1,0,1,73
Nairn,BF,F,0,0,0,0,2,7,9
Nairn,BG,F,2,1,1,0,0,5,9
Nairn,BG,M,3,2,0,0,0,0,5
Nairn,BH,F,0,0,0,0,0,5,5
Nairn,BSH,M,0,0,0,1,0,1,2
Nairn,BSHX,F,1,0,3,2,2,5,13
Nairn,CH,F,38,40,29,20,18,83,228
Nairn,CH,M,41,23,7,5,4,19,99
Nairn,CHX,F,263,98,11,19,43,304,738
Nairn,CHX,M,290,96,2,0,0,39,427
Nairn,FR,F,0,0,0,0,0,48,48
Nairn,GA,F,0,0,0,0,0,1,1
Nairn,GA,M,0,1,0,0,0,0,1
Nairn,GAX,F,0,0,0,0,0,5,5
Nairn,HE,F,0,0,1,0,0,1,2
Nairn,HEBLX,F,0,0,0,0,0,1,1
Nairn,HEX,F,6,7,8,12,3,12,48
Nairn,HEX,M,0,1,0,0,0,0,1
Nairn,HF,F,333,315,336,166,115,309,"1,574"
Nairn,HF,M,23,8,1,0,0,0,32
Nairn,HFX,F,0,0,0,0,0,1,1
Nairn,HI,F,4,2,6,10,6,22,50
Nairn,HI,M,4,4,1,0,0,1,10
Nairn,HIX,F,0,0,0,0,5,2,7
Nairn,HIX,M,1,0,0,0,0,0,1
Nairn,HL,F,0,0,0,0,0,13,13
Nairn,HLX,F,0,0,0,0,0,1,1
Nairn,HO,F,25,5,33,69,65,138,335
Nairn,HO,M,9,2,0,0,0,0,11
Nairn,HX,F,0,0,0,0,0,1,1
Nairn,LHX,F,0,0,0,0,0,2,2
Nairn,LI,F,0,0,0,0,0,1,1
Nairn,LIM,F,17,18,1,3,5,35,79
Nairn,LIM,M,16,8,6,9,7,22,68
Nairn,LIMBX,F,0,0,0,0,0,17,17
Nairn,LIMR,M,0,0,0,0,0,1,1
Nairn,LIMRX,F,0,0,0,0,0,8,8
Nairn,LIMX,F,564,381,126,115,126,395,"1,707"
Nairn,LIMX,M,536,154,8,0,0,3,701
Nairn,LIX,F,0,0,0,0,0,10,10
Nairn,LM,F,0,0,0,0,0,14,14
Nairn,LM,M,0,0,0,0,0,5,5
Nairn,LMX,F,0,0,0,0,0,155,155
Nairn,LMX,M,0,0,0,0,0,18,18
Nairn,LRX,F,0,0,0,0,0,1,1
Nairn,LU,F,0,1,0,0,0,0,1
Nairn,LU,M,0,4,0,0,0,0,4
Nairn,LUX,F,0,4,0,1,0,2,7
Nairn,LUX,M,0,1,0,0,0,0,1
Nairn,MO,F,0,0,0,1,0,1,2
Nairn,NRX,M,2,0,0,0,0,0,2
Nairn,NS,F,0,0,0,0,0,3,3
Nairn,OB,F,0,0,0,0,0,2,2
Nairn,OO,F,0,0,0,0,0,1,1
Nairn,PAX,F,0,0,0,0,0,1,1
Nairn,SA,F,0,4,2,9,4,11,30
Nairn,SA,M,0,1,0,0,0,0,1
Nairn,SAX,F,8,58,9,18,12,68,173
Nairn,SAX,M,0,15,0,0,0,0,15
Nairn,SH,F,0,0,0,1,0,0,1
Nairn,SHO,F,0,0,1,0,0,2,3
Nairn,SHO,M,1,0,0,0,0,0,1
Nairn,SHOX,F,0,0,0,4,5,28,37
Nairn,SHOX,M,0,1,0,0,0,0,1
Nairn,SM,F,2,6,2,14,9,25,58
Nairn,SM,M,4,0,2,2,4,8,20
Nairn,SMX,F,237,140,82,82,58,526,"1,125"
Nairn,SMX,M,177,35,2,0,1,10,225
Nairn,WB,F,0,0,0,2,0,4,6
Nairn,WS,M,0,0,0,0,0,2,2
Nairn,WSX,F,7,28,11,1,7,14,68
Nairn,WSX,M,4,7,0,0,0,0,11
Orkney,AA,F,330,293,153,142,154,774,"1,846"
Orkney,AA,M,359,271,53,58,34,102,877
Orkney,AAX,F,"2,911","2,197","1,153","1,199","1,211","5,784","14,455"
Orkney,AAX,M,"3,104","1,705",35,4,1,67,"4,916"
Orkney,AY,F,10,54,48,52,14,65,243
Orkney,AY,M,9,1,0,1,1,0,12
Orkney,AYX,F,3,12,8,6,6,1,36
Orkney,AYX,M,1,1,0,0,0,0,2
Orkney,BA,F,3,0,0,1,0,1,5
Orkney,BA,M,3,2,4,2,0,2,13
Orkney,BABX,F,0,0,0,0,0,1,1
Orkney,BAX,F,80,34,41,36,59,91,341
Orkney,BAX,M,70,8,2,0,0,5,85
Orkney,BAZX,F,0,1,0,0,0,0,1
Orkney,BB,F,3,3,3,7,12,23,51
Orkney,BB,M,3,4,11,5,2,13,38
Orkney,BBX,F,302,210,130,126,128,471,"1,367"
Orkney,BBX,M,307,104,6,1,0,13,431
Orkney,BF,F,80,67,77,101,58,113,496
Orkney,BF,M,54,27,8,1,0,4,94
Orkney,BFX,F,1,4,3,16,1,6,31
Orkney,BFX,M,2,0,0,0,0,0,2
Orkney,BG,F,0,0,0,0,0,3,3
Orkney,BGX,F,0,0,1,0,0,7,8
Orkney,BGX,M,0,1,0,0,0,0,1
Orkney,BH,F,0,0,0,0,0,4,4
Orkney,BHX,F,0,0,0,0,0,1,1
Orkney,BLGX,F,0,0,0,0,0,1,1
Orkney,BRX,M,1,0,0,0,0,0,1
Orkney,BS,F,0,0,0,0,0,8,8
Orkney,BSH,F,21,8,12,6,2,19,68
Orkney,BSH,M,16,10,4,4,2,3,39
Orkney,BSHX,F,78,54,29,34,17,105,317
Orkney,BSHX,M,67,31,0,0,0,1,99
Orkney,BSX,F,0,5,0,0,0,1,6
Orkney,CB,F,0,0,0,0,0,4,4
Orkney,CB,M,0,0,0,0,0,1,1
Orkney,CD,M,0,0,0,0,0,1,1
Orkney,CH,F,93,76,36,33,28,124,390
Orkney,CH,M,109,76,79,68,36,134,502
Orkney,CHX,F,"4,482","2,290",302,261,250,"1,601","9,186"
Orkney,CHX,M,"4,530","1,642",64,14,6,151,"6,407"
Orkney,DEV,F,8,2,2,4,0,13,29
Orkney,DEV,M,3,0,0,0,0,0,3
Orkney,DEVX,F,4,0,3,2,4,7,20
Orkney,DEVX,M,7,1,0,0,0,0,8
Orkney,DEX,F,15,9,5,2,7,22,60
Orkney,DEX,M,13,4,1,0,0,0,18
Orkney,DEXX,F,0,0,1,0,0,0,1
Orkney,DEXX,M,0,0,1,0,0,0,1
Orkney,DSX,F,0,0,0,0,1,0,1
Orkney,FR,F,0,0,0,0,0,264,264
Orkney,FR,M,0,0,0,0,0,1,1
Orkney,FRX,F,0,0,0,0,0,2,2
Orkney,GA,F,0,0,0,0,0,6,6
Orkney,GAX,F,0,4,2,0,2,70,78
Orkney,GEX,F,0,0,0,0,0,5,5
Orkney,GU,F,0,0,0,0,0,1,1
Orkney,H,F,0,0,0,0,0,1,1
Orkney,HE,F,4,3,3,2,3,24,39
Orkney,HE,M,10,5,3,2,4,1,25
Orkney,HEBLX,F,0,0,0,0,0,19,19
Orkney,HERX,F,0,0,0,0,0,8,8
Orkney,HEX,F,87,28,13,19,44,205,396
Orkney,HEX,M,86,26,3,0,1,4,120
Orkney,HF,F,411,326,359,325,287,796,"2,504"
Orkney,HF,M,147,111,37,0,2,14,311
Orkney,HFX,F,22,5,6,4,0,51,88
Orkney,HFX,M,7,4,1,0,0,0,12
Orkney,HI,F,25,20,16,12,17,27,117
Orkney,HI,M,11,19,6,3,2,4,45
Orkney,HIX,F,9,5,3,4,4,6,31
Orkney,HIX,M,6,5,2,1,0,2,16
Orkney,HL,F,0,0,0,0,0,15,15
Orkney,HLX,F,0,0,0,0,0,2,2
Orkney,HO,F,59,76,38,32,45,92,342
Orkney,HO,M,48,12,2,2,0,1,65
Orkney,HOX,F,12,2,0,2,2,8,26
Orkney,HOX,M,11,0,0,0,0,0,11
Orkney,HX,F,0,0,0,0,0,2,2
Orkney,JE,F,3,2,0,2,2,13,22
Orkney,JE,M,0,0,0,0,1,1,2
Orkney,JEX,F,0,1,0,0,0,0,1
Orkney,JEX,M,1,0,0,0,0,0,1
Orkney,JY,F,0,0,0,0,0,3,3
Orkney,LH,F,0,0,0,0,0,3,3
Orkney,LHX,F,0,3,0,0,0,1,4
Orkney,LHX,M,0,1,0,0,0,0,1
Orkney,LI,F,0,0,0,0,0,3,3
Orkney,LI,M,0,0,0,0,0,3,3
Orkney,LIM,F,168,91,67,50,43,143,562
Orkney,LIM,M,113,66,35,25,30,44,313
Orkney,LIMB,M,0,0,0,0,0,2,2
Orkney,LIMBX,F,0,0,0,0,0,61,61
Orkney,LIMR,F,0,0,0,0,0,3,3
Orkney,LIMR,M,0,0,0,0,0,4,4
Orkney,LIMRX,F,0,0,0,0,0,100,100
Orkney,LIMRX,M,0,0,0,0,0,1,1
Orkney,LIMX,F,"2,178","1,792",784,796,781,"2,769","9,100"
Orkney,LIMX,M,"2,055","1,132",43,4,4,9,"3,247"
Orkney,LIX,F,0,0,0,0,0,1,1
Orkney,LM,F,0,0,0,0,0,57,57
Orkney,LM,M,0,0,0,0,0,19,19
Orkney,LMX,F,0,0,0,0,0,"1,569","1,569"
Orkney,LMX,M,0,0,0,0,0,66,66
Orkney,LRX,F,0,0,0,0,0,1,1
Orkney,LU,F,16,12,6,7,4,20,65
Orkney,LU,M,7,6,4,1,0,1,19
Orkney,LUX,F,2,0,0,0,2,2,6
Orkney,LUX,M,5,0,0,0,0,0,5
Orkney,MG,F,1,0,3,0,0,1,5
Orkney,MG,M,1,1,0,0,0,0,2
Orkney,MGX,F,2,0,2,4,0,10,18
Orkney,MGX,M,0,0,0,1,0,0,1
Orkney,MRIX,F,0,0,0,0,0,14,14
Orkney,NOX,F,0,0,0,0,0,1,1
Orkney,NR,F,4,0,0,0,0,0,4
Orkney,NRX,F,4,0,0,0,0,0,4
Orkney,NRX,M,2,0,0,0,0,0,2
Orkney,NS,F,0,0,0,0,0,72,72
Orkney,NS,M,0,0,0,0,0,1,1
Orkney,OB,F,0,0,0,0,0,35,35
Orkney,OB,M,0,0,0,0,0,1,1
Orkney,OO,F,0,0,0,0,0,10,10
Orkney,OO,M,0,0,0,0,0,2,2
Orkney,PIX,M,0,2,0,0,0,0,2
Orkney,ROX,F,0,0,0,2,0,7,9
Orkney,RWFR,F,0,0,0,0,0,2,2
Orkney,SA,F,3,2,1,0,0,4,10
Orkney,SA,M,10,2,0,0,4,2,18
Orkney,SAX,F,99,91,45,38,22,100,395
Orkney,SAX,M,100,49,1,0,0,1,151
Orkney,SD,F,0,2,0,2,0,1,5
Orkney,SD,M,0,0,1,0,1,1,3
Orkney,SDX,F,26,55,41,22,0,10,154
Orkney,SDX,M,20,25,0,0,0,0,45
Orkney,SH,F,22,16,10,15,7,34,104
Orkney,SH,M,18,11,1,2,1,0,33
Orkney,SHO,F,6,7,1,1,4,20,39
Orkney,SHO,M,5,2,0,2,2,3,14
Orkney,SHOX,F,171,119,40,38,40,378,786
Orkney,SHOX,M,143,81,4,4,0,21,253
Orkney,SHX,F,3,0,3,4,4,16,30
Orkney,SHX,M,0,2,0,1,0,0,3
Orkney,SM,F,20,30,15,17,10,56,148
Orkney,SM,M,17,24,30,31,28,41,171
Orkney,SMX,F,"1,811","1,537","1,027",838,647,"2,823","8,683"
Orkney,SMX,M,"1,794",882,40,4,2,52,"2,774"
Orkney,SUX,F,0,0,0,0,0,2,2
Orkney,TB,F,0,0,0,1,0,0,1
Orkney,TB,M,0,0,0,0,0,1,1
Orkney,TBX,F,0,1,0,6,0,0,7
Orkney,TBX,M,0,4,0,0,0,0,4
Orkney,WB,F,0,0,0,1,3,0,4
Orkney,WBX,F,0,0,0,0,0,1,1
Orkney,WGX,F,0,0,0,0,0,1,1
Orkney,WSX,F,2,0,0,0,0,0,2
Orkney,WSX,M,1,0,0,0,0,0,1
Peebles,AA,F,27,20,2,5,16,91,161
Peebles,AA,M,20,11,6,4,2,4,47
Peebles,AAX,F,356,295,129,104,137,651,"1,672"
Peebles,AAX,M,316,167,10,1,1,5,500
Peebles,AR,F,0,0,0,1,0,0,1
Peebles,AY,F,0,0,0,0,0,10,10
Peebles,BA,F,0,1,0,0,0,6,7
Peebles,BA,M,0,1,0,0,0,1,2
Peebles,BABX,F,0,0,0,0,0,1,1
Peebles,BAX,F,21,7,2,3,2,52,87
Peebles,BAX,M,13,2,0,0,0,6,21
Peebles,BAZ X,F,0,0,0,0,0,1,1
Peebles,BAZX,F,0,0,0,3,0,1,4
Peebles,BB,F,4,1,3,1,2,26,37
Peebles,BB,M,8,1,1,3,0,1,14
Peebles,BBX,F,113,73,39,29,22,204,480
Peebles,BBX,M,101,43,2,0,2,0,148
Peebles,BF,F,0,0,0,3,4,5,12
Peebles,BF,M,6,1,0,0,0,0,7
Peebles,BFX,F,0,0,0,0,1,4,5
Peebles,BG,F,8,7,4,5,6,27,57
Peebles,BG,M,18,3,1,0,0,0,22
Peebles,BGX,F,4,1,3,0,1,3,12
Peebles,BGX,M,5,1,0,0,0,0,6
Peebles,BH,F,0,0,0,0,0,21,21
Peebles,BHX,F,0,0,0,0,0,5,5
Peebles,BLG,F,12,26,28,20,24,107,217
Peebles,BLG,M,9,39,1,1,0,0,50
Peebles,BLGX,F,0,0,0,0,0,2,2
Peebles,BS,F,0,0,0,0,0,1,1
Peebles,BSH,F,6,2,4,0,5,1,18
Peebles,BSH,M,7,5,0,0,1,0,13
Peebles,BSHX,F,43,11,1,7,4,25,91
Peebles,BSHX,M,36,1,0,0,0,0,37
Peebles,BSX,F,1,1,0,0,0,2,4
Peebles,BSX,M,0,0,0,1,0,0,1
Peebles,CB,F,0,0,0,0,0,39,39
Peebles,CH,F,8,12,9,7,4,24,64
Peebles,CH,M,12,14,16,12,13,45,112
Peebles,CHX,F,"1,063",580,54,22,6,319,"2,044"
Peebles,CHX,M,"1,151",352,20,2,1,134,"1,660"
Peebles,DE,F,0,0,0,0,0,3,3
Peebles,DE,M,0,0,0,0,0,1,1
Peebles,DEV,F,0,0,0,0,0,1,1
Peebles,DEVX,F,0,0,0,0,0,2,2
Peebles,DEX,F,15,6,8,3,6,22,60
Peebles,DEX,M,21,4,1,0,0,2,28
Peebles,FR,F,0,0,0,0,0,29,29
Peebles,FRX,F,0,0,0,0,0,2,2
Peebles,GA,F,8,13,8,11,11,83,134
Peebles,GA,M,13,16,2,1,0,0,32
Peebles,GASX,F,0,0,0,0,0,7,7
Peebles,GAX,F,18,1,2,0,3,63,87
Peebles,GAX,M,10,5,1,0,0,0,16
Peebles,GEX,F,0,0,0,0,1,0,1
Peebles,GLX,F,5,0,0,0,0,0,5
Peebles,GLX,M,2,0,0,0,0,0,2
Peebles,HE,F,0,0,7,1,5,16,29
Peebles,HE,M,0,4,0,0,0,0,4
Peebles,HEBLX,F,0,0,0,0,0,6,6
Peebles,HEX,F,13,7,12,5,5,99,141
Peebles,HEX,M,1,13,0,0,0,1,15
Peebles,HF,F,17,21,35,33,68,280,454
Peebles,HF,M,22,13,5,1,0,8,49
Peebles,HFX,F,1,5,3,1,2,10,22
Peebles,HFX,M,2,1,0,0,0,1,4
Peebles,HI,F,24,11,9,24,6,28,102
Peebles,HI,M,24,19,3,0,3,1,50
Peebles,HIX,F,0,0,0,0,0,1,1
Peebles,HIX,M,1,1,0,0,0,0,2
Peebles,HL,F,0,0,0,0,0,14,14
Peebles,HL,M,0,0,0,0,0,2,2
Peebles,HLX,F,0,0,0,0,0,2,2
Peebles,HO,F,189,144,143,96,111,201,884
Peebles,HO,M,8,5,5,0,0,1,19
Peebles,HOX,F,0,0,0,0,2,3,5
Peebles,HOX,M,1,0,0,0,0,0,1
Peebles,HX,F,0,0,0,0,0,6,6
Peebles,JE,F,0,0,0,0,1,3,4
Peebles,JE,M,2,0,0,0,0,0,2
Peebles,JEX,F,0,0,0,0,0,1,1
Peebles,LH,F,1,2,0,0,1,0,4
Peebles,LHX,F,2,0,0,0,0,1,3
Peebles,LHX,M,1,0,0,0,0,1,2
Peebles,LI,F,0,0,0,0,0,11,11
Peebles,LI,M,0,0,0,0,0,3,3
Peebles,LIM,F,54,43,30,77,33,147,384
Peebles,LIM,M,43,47,7,7,9,19,132
Peebles,LIMB,F,0,0,0,0,0,2,2
Peebles,LIMBX,F,0,0,0,0,0,58,58
Peebles,LIMR,F,0,0,0,0,0,1,1
Peebles,LIMR,M,0,0,0,0,0,2,2
Peebles,LIMRX,F,0,0,0,0,0,19,19
Peebles,LIMX,F,768,457,208,226,286,"1,156","3,101"
Peebles,LIMX,M,757,246,19,2,4,9,"1,037"
Peebles,LIX,F,0,0,0,0,0,119,119
Peebles,LM,F,0,0,0,0,0,52,52
Peebles,LM,M,0,0,0,0,0,7,7
Peebles,LMX,F,0,0,0,0,0,350,350
Peebles,LMX,M,0,0,0,0,0,60,60
Peebles,LU,F,51,50,29,26,28,90,274
Peebles,LU,M,75,9,2,1,1,2,90
Peebles,LUX,F,13,5,4,0,0,7,29
Peebles,LUX,M,13,0,0,0,0,0,13
Peebles,MO,F,0,0,0,1,0,0,1
Peebles,MOX,M,0,1,0,0,0,0,1
Peebles,MRI,M,0,0,1,0,0,0,1
Peebles,NS,F,0,0,0,0,0,18,18
Peebles,OB,F,0,0,0,0,0,2,2
Peebles,OO,F,0,0,0,0,0,1,1
Peebles,PAX,F,0,3,0,0,0,0,3
Peebles,PAX,M,0,3,0,0,0,0,3
Peebles,ROX,F,0,0,0,0,0,1,1
Peebles,SA,F,8,1,1,3,4,27,44
Peebles,SA,M,7,1,2,1,3,5,19
Peebles,SAX,F,151,149,101,72,90,255,818
Peebles,SAX,M,132,15,3,0,0,2,152
Peebles,SD,M,0,0,0,0,0,1,1
Peebles,SDX,F,5,1,8,0,0,0,14
Peebles,SDX,M,11,0,0,0,0,0,11
Peebles,SH,F,0,0,0,0,0,1,1
Peebles,SHO,F,1,0,0,1,2,2,6
Peebles,SHOX,F,6,7,3,3,2,104,125
Peebles,SHOX,M,1,10,1,0,0,2,14
Peebles,SHX,F,0,0,0,0,0,1,1
Peebles,SHX,M,0,1,0,0,0,0,1
Peebles,SM,F,29,18,20,14,14,70,165
Peebles,SM,M,25,10,3,5,3,23,69
Peebles,SMX,F,284,161,120,126,106,554,"1,351"
Peebles,SMX,M,196,80,3,1,0,15,295
Peebles,WB,F,0,0,0,0,0,4,4
Peebles,WB,M,0,1,0,0,0,0,1
Peebles,WBX,F,0,0,0,1,0,1,2
Peebles,WG,M,0,1,1,0,0,0,2
Peebles,WS,M,0,0,0,1,0,0,1
Peebles,WSX,F,1,8,12,7,5,73,106
Peebles,WSX,M,1,22,1,0,0,0,24
Perthshire,AA,F,485,390,261,186,186,821,"2,329"
Perthshire,AA,M,454,273,52,22,24,117,942
Perthshire,AAX,F,984,850,325,323,323,"1,656","4,461"
Perthshire,AAX,M,"1,013",688,69,3,2,61,"1,836"
Perthshire,AY,F,11,13,21,15,14,59,133
Perthshire,AY,M,13,4,2,0,0,3,22
Perthshire,AYX,F,5,5,6,8,5,3,32
Perthshire,AYX,M,3,0,0,0,0,0,3
Perthshire,BA,F,2,1,1,1,1,13,19
Perthshire,BA,M,2,1,2,0,0,6,11
Perthshire,BABX,F,0,0,0,0,0,1,1
Perthshire,BARX,F,0,0,0,0,0,2,2
Perthshire,BAWX,F,0,0,0,0,0,1,1
Perthshire,BAX,F,57,56,13,23,39,157,345
Perthshire,BAX,M,56,45,5,1,0,25,132
Perthshire,BAZ,M,0,0,1,0,0,2,3
Perthshire,BAZX,F,27,7,2,0,1,0,37
Perthshire,BAZX,M,21,11,0,0,0,0,32
Perthshire,BB,F,16,20,20,37,12,115,220
Perthshire,BB,M,9,4,3,6,3,17,42
Perthshire,BBX,F,311,266,214,180,162,887,"2,020"
Perthshire,BBX,M,278,206,16,1,1,25,527
Perthshire,BF,F,53,76,66,67,51,89,402
Perthshire,BF,M,47,29,16,0,1,2,95
Perthshire,BFX,F,1,4,4,2,2,8,21
Perthshire,BFX,M,1,3,0,0,0,0,4
Perthshire,BG,F,7,5,8,3,9,10,42
Perthshire,BG,M,9,5,2,2,0,1,19
Perthshire,BGX,F,1,1,0,0,0,9,11
Perthshire,BGX,M,0,1,0,0,0,0,1
Perthshire,BH,F,0,0,0,0,0,3,3
Perthshire,BLG,F,0,1,0,2,8,24,35
Perthshire,BLG,M,2,10,0,0,0,0,12
Perthshire,BLGX,F,0,0,0,0,0,11,11
Perthshire,BS,F,0,0,0,0,0,1,1
Perthshire,BSH,F,16,21,14,7,7,18,83
Perthshire,BSH,M,10,15,10,6,6,7,54
Perthshire,BSHX,F,125,51,48,37,43,42,346
Perthshire,BSHX,M,108,41,1,2,5,0,157
Perthshire,BSX,F,0,0,0,0,0,1,1
Perthshire,BU,F,2,1,0,3,0,0,6
Perthshire,BU,M,0,3,0,0,0,0,3
Perthshire,BW,F,0,0,0,0,0,3,3
Perthshire,BW,M,0,3,0,0,0,0,3
Perthshire,BWX,F,0,0,0,0,0,3,3
Perthshire,CB,F,0,0,0,0,0,23,23
Perthshire,CH,F,211,162,95,85,81,305,939
Perthshire,CH,M,209,92,21,30,25,106,483
Perthshire,CHX,F,"1,892","1,114",159,88,82,804,"4,139"
Perthshire,CHX,M,"1,930","1,508",160,9,0,134,"3,741"
Perthshire,DEV,F,0,0,0,0,0,1,1
Perthshire,DEVX,F,0,1,0,6,2,15,24
Perthshire,DEX,F,3,0,3,0,1,1,8
Perthshire,DEX,M,2,0,0,0,0,0,2
Perthshire,DEXX,F,0,0,0,0,0,1,1
Perthshire,DG,F,0,0,0,0,0,3,3
Perthshire,DS,M,0,0,1,0,0,0,1
Perthshire,DSX,F,0,2,0,0,0,1,3
Perthshire,DV,F,0,0,0,0,0,1,1
Perthshire,FR,F,0,0,0,0,0,216,216
Perthshire,FR,M,0,0,0,0,0,3,3
Perthshire,FRX,F,0,0,0,0,0,2,2
Perthshire,GA,F,24,20,21,24,26,96,211
Perthshire,GA,M,25,33,1,0,4,4,67
Perthshire,GASX,F,0,0,0,0,0,3,3
Perthshire,GAX,F,5,1,2,4,7,71,90
Perthshire,GAX,M,9,2,0,2,0,1,14
Perthshire,GBX,M,1,0,0,0,0,0,1
Perthshire,GEX,F,0,0,0,0,8,2,10
Perthshire,GEX,M,0,1,0,0,0,0,1
Perthshire,GLX,F,0,0,0,0,0,2,2
Perthshire,H,F,0,0,0,0,0,2,2
Perthshire,HE,F,22,24,9,15,14,62,146
Perthshire,HE,M,14,9,10,1,1,1,36
Perthshire,HEBLX,F,0,0,0,0,0,26,26
Perthshire,HER,F,0,0,0,0,0,1,1
Perthshire,HERX,F,0,0,0,0,0,6,6
Perthshire,HEX,F,44,31,34,97,36,426,668
Perthshire,HEX,M,43,24,7,0,0,5,79
Perthshire,HF,F,469,626,440,433,293,820,"3,081"
Perthshire,HF,M,297,177,116,7,4,28,629
Perthshire,HFX,F,0,1,0,0,1,12,14
Perthshire,HFX,M,10,3,3,0,0,2,18
Perthshire,HI,F,173,142,113,117,95,482,"1,122"
Perthshire,HI,M,298,234,75,17,8,33,665
Perthshire,HIX,F,12,19,6,2,11,47,97
Perthshire,HIX,M,14,18,3,0,0,0,35
Perthshire,HL,F,0,0,0,0,0,191,191
Perthshire,HL,M,0,0,0,0,0,10,10
Perthshire,HLX,F,0,0,0,0,0,27,27
Perthshire,HLX,M,0,0,0,0,0,1,1
Perthshire,HO,F,112,42,18,15,10,45,242
Perthshire,HO,M,6,1,10,2,0,0,19
Perthshire,HOX,F,0,0,0,1,0,3,4
Perthshire,HX,F,0,0,0,0,0,16,16
Perthshire,JE,F,0,0,2,2,2,2,8
Perthshire,JE,M,1,1,8,0,0,0,10
Perthshire,JEX,F,0,0,0,0,0,1,1
Perthshire,JEX,M,1,2,0,0,0,0,3
Perthshire,LH,F,8,4,9,4,4,27,56
Perthshire,LH,M,14,10,1,1,0,2,28
Perthshire,LHX,F,4,2,2,2,0,1,11
Perthshire,LHX,M,5,0,0,0,0,0,5
Perthshire,LI,F,0,0,0,0,0,31,31
Perthshire,LI,M,0,0,0,0,0,9,9
Perthshire,LIM,F,271,261,148,134,126,393,"1,333"
Perthshire,LIM,M,240,177,56,45,36,111,665
Perthshire,LIM X,F,0,0,0,0,0,2,2
Perthshire,LIMB,F,0,0,0,0,0,10,10
Perthshire,LIMB,M,0,0,0,0,0,3,3
Perthshire,LIMBX,F,0,0,0,0,0,100,100
Perthshire,LIMBX,M,0,0,0,0,0,2,2
Perthshire,LIMR,F,0,0,0,0,0,9,9
Perthshire,LIMR,M,0,0,0,0,0,5,5
Perthshire,LIMRX,F,0,0,0,0,0,57,57
Perthshire,LIMRX,M,0,0,0,0,0,1,1
Perthshire,LIMX,F,"3,789","2,767",958,866,913,"3,039","12,332"
Perthshire,LIMX,M,"3,747","2,227",248,9,4,35,"6,270"
Perthshire,LIX,F,0,0,0,0,0,134,134
Perthshire,LM,F,0,0,0,0,0,186,186
Perthshire,LM,M,0,0,0,0,0,42,42
Perthshire,LMX,F,0,0,0,0,0,"1,579","1,579"
Perthshire,LMX,M,0,0,0,0,0,217,217
Perthshire,LU,F,157,141,124,71,74,297,864
Perthshire,LU,M,113,85,5,3,1,10,217
Perthshire,LUX,F,16,24,19,22,9,70,160
Perthshire,LUX,M,12,21,0,0,0,1,34
Perthshire,MG,F,0,0,0,0,2,7,9
Perthshire,MO,F,0,0,0,0,0,1,1
Perthshire,MO,M,0,0,0,1,0,0,1
Perthshire,MOX,F,53,47,26,25,27,32,210
Perthshire,MOX,M,59,26,0,0,0,0,85
Perthshire,MRIX,F,0,0,0,1,0,2,3
Perthshire,NOX,F,0,0,0,0,0,1,1
Perthshire,NRX,F,3,0,0,0,0,0,3
Perthshire,NS,F,0,0,0,0,0,83,83
Perthshire,OB,F,0,0,0,0,0,38,38
Perthshire,OB,M,0,0,0,0,0,2,2
Perthshire,OO,F,0,0,0,0,0,20,20
Perthshire,OO,M,0,0,0,0,0,1,1
Perthshire,PAX,F,0,0,0,0,0,1,1
Perthshire,PAX,M,0,1,0,0,0,0,1
Perthshire,PI,F,0,0,0,3,0,0,3
Perthshire,PIX,F,0,0,0,3,0,3,6
Perthshire,RO,F,0,0,0,0,0,9,9
Perthshire,RO,M,0,0,0,0,0,3,3
Perthshire,ROX,F,0,0,0,1,1,22,24
Perthshire,ROX,M,0,0,0,0,0,5,5
Perthshire,RP,F,2,1,0,0,1,2,6
Perthshire,RP,M,0,1,0,0,1,0,2
Perthshire,RPX,F,17,17,5,0,0,1,40
Perthshire,RPX,M,17,12,1,0,0,0,30
Perthshire,RWFR,F,0,0,0,0,0,2,2
Perthshire,SA,F,27,26,11,20,11,73,168
Perthshire,SA,M,37,13,5,2,2,9,68
Perthshire,SAX,F,129,132,62,58,49,524,954
Perthshire,SAX,M,103,65,2,0,0,52,222
Perthshire,SD,F,6,2,5,4,6,10,33
Perthshire,SD,M,6,4,0,2,2,1,15
Perthshire,SDX,F,38,55,21,27,29,58,228
Perthshire,SDX,M,44,43,11,1,0,1,100
Perthshire,SH,F,0,2,1,2,1,5,11
Perthshire,SH,M,2,4,0,0,0,0,6
Perthshire,SHO,F,1,2,5,5,0,25,38
Perthshire,SHO,M,0,2,0,0,4,4,10
Perthshire,SHOX,F,197,204,167,113,95,622,"1,398"
Perthshire,SHOX,M,223,146,19,1,4,22,415
Perthshire,SHX,F,2,1,1,1,1,15,21
Perthshire,SHX,M,1,2,0,0,0,1,4
Perthshire,SM,F,107,102,73,95,69,419,865
Perthshire,SM,M,92,77,24,38,20,78,329
Perthshire,SMX,F,"1,745","1,467",964,848,729,"3,987","9,740"
Perthshire,SMX,M,"1,675","1,103",122,6,5,147,"3,058"
Perthshire,ST,F,51,12,0,0,0,0,63
Perthshire,ST,M,28,1,1,1,0,0,31
Perthshire,STX,F,1,0,0,0,0,0,1
Perthshire,SU,F,0,0,0,0,0,2,2
Perthshire,SU,M,0,0,0,0,0,2,2
Perthshire,SUX,F,11,10,2,0,2,6,31
Perthshire,SUX,M,11,3,0,0,1,0,15
Perthshire,WB,F,7,14,2,8,3,57,91
Perthshire,WB,M,11,5,0,0,1,0,17
Perthshire,WBX,F,0,0,0,1,0,2,3
Perthshire,WPX,F,0,0,0,0,0,1,1
Perthshire,WPX,M,0,1,0,0,0,0,1
Perthshire,WS,F,4,7,9,1,1,3,25
Perthshire,WS,M,1,2,1,1,0,4,9
Perthshire,WSX,F,49,16,7,31,23,83,209
Perthshire,WSX,M,61,14,3,0,0,1,79
Renfrew,AA,F,121,122,55,62,32,284,676
Renfrew,AA,M,136,92,17,10,4,30,289
Renfrew,AAX,F,448,375,235,170,139,817,"2,184"
Renfrew,AAX,M,447,454,110,1,2,42,"1,056"
Renfrew,ARX,F,0,0,1,0,0,0,1
Renfrew,ARX,M,0,0,1,0,0,0,1
Renfrew,AY,F,121,132,124,107,57,199,740
Renfrew,AY,M,40,52,8,2,1,1,104
Renfrew,AYX,F,2,2,3,1,0,1,9
Renfrew,AYX,M,3,0,0,1,0,0,4
Renfrew,BA,F,2,1,1,0,0,4,8
Renfrew,BA,M,0,0,1,1,1,1,4
Renfrew,BAX,F,31,23,13,8,16,159,250
Renfrew,BAX,M,43,22,4,0,0,15,84
Renfrew,BAZ,F,1,1,0,0,0,1,3
Renfrew,BAZ,M,0,0,1,0,0,0,1
Renfrew,BB,F,7,7,8,17,5,13,57
Renfrew,BB,M,9,13,3,0,1,5,31
Renfrew,BBX,F,260,153,94,70,82,212,871
Renfrew,BBX,M,256,110,23,4,1,10,404
Renfrew,BF,F,203,246,238,201,213,385,"1,486"
Renfrew,BF,M,259,208,68,4,2,4,545
Renfrew,BFX,F,14,13,16,13,11,13,80
Renfrew,BFX,M,27,23,3,1,1,1,56
Renfrew,BG,F,0,0,0,0,0,3,3
Renfrew,BGX,F,1,1,0,0,1,5,8
Renfrew,BGX,M,4,2,0,0,0,1,7
Renfrew,BH,F,0,0,0,0,0,35,35
Renfrew,BH,M,2,0,0,0,0,0,2
Renfrew,BHX,F,0,0,0,0,0,7,7
Renfrew,BLG,F,0,0,0,0,1,1,2
Renfrew,BLGX,F,0,0,0,0,0,1,1
Renfrew,BRX,F,1,0,0,0,0,0,1
Renfrew,BS,F,1,0,1,0,0,3,5
Renfrew,BS,M,1,1,0,0,0,0,2
Renfrew,BSH,F,0,0,2,1,1,0,4
Renfrew,BSH,M,3,4,1,0,1,2,11
Renfrew,BSHX,F,8,0,0,1,12,11,32
Renfrew,BSHX,M,6,8,1,0,0,0,15
Renfrew,BSX,F,5,0,0,0,0,6,11
Renfrew,BSX,M,2,0,0,0,0,0,2
Renfrew,CB,F,0,0,0,0,0,21,21
Renfrew,CH,F,27,8,11,6,20,81,153
Renfrew,CH,M,34,14,11,7,4,69,139
Renfrew,CHLX,M,1,0,0,0,0,0,1
Renfrew,CHX,F,553,329,39,39,27,219,"1,206"
Renfrew,CHX,M,582,538,40,5,1,73,"1,239"
Renfrew,DEVX,F,0,0,0,0,1,0,1
Renfrew,DR,F,0,0,1,0,0,0,1
Renfrew,DSX,F,0,0,0,0,0,3,3
Renfrew,FR,F,0,0,0,0,0,315,315
Renfrew,FR,M,0,0,0,0,0,12,12
Renfrew,FRX,F,0,0,0,0,0,6,6
Renfrew,GA,F,0,0,0,1,6,43,50
Renfrew,GA,M,1,0,0,1,0,0,2
Renfrew,GAS,F,0,0,1,0,0,0,1
Renfrew,GASX,F,0,1,0,1,0,0,2
Renfrew,GAX,F,0,0,0,1,0,25,26
Renfrew,GAX,M,0,3,0,0,0,0,3
Renfrew,GBX,F,0,0,0,1,0,0,1
Renfrew,H,F,0,0,0,0,0,1,1
Renfrew,HE,F,5,3,2,1,7,29,47
Renfrew,HE,M,5,3,0,1,0,0,9
Renfrew,HEBLX,F,0,0,0,0,0,6,6
Renfrew,HERX,F,0,0,0,0,0,6,6
Renfrew,HEX,F,21,9,21,21,33,161,266
Renfrew,HEX,M,34,21,8,2,1,3,69
Renfrew,HF,F,954,960,848,708,510,"1,698","5,678"
Renfrew,HF,M,720,721,271,15,7,61,"1,795"
Renfrew,HFX,F,9,5,22,22,13,33,104
Renfrew,HFX,M,34,27,13,1,2,1,78
Renfrew,HI,F,50,45,71,42,20,131,359
Renfrew,HI,M,46,68,11,7,0,5,137
Renfrew,HIX,F,0,0,2,0,1,0,3
Renfrew,HIX,M,0,1,1,0,0,0,2
Renfrew,HL,F,0,0,0,0,0,47,47
Renfrew,HL,M,0,0,0,0,0,4,4
Renfrew,HLX,F,0,0,0,0,0,1,1
Renfrew,HLX,M,0,0,0,0,0,1,1
Renfrew,HO,F,61,71,44,20,88,101,385
Renfrew,HO,M,66,192,37,0,0,1,296
Renfrew,HOX,F,48,54,100,73,65,125,465
Renfrew,HOX,M,31,14,15,1,0,1,62
Renfrew,HX,F,0,0,0,0,0,3,3
Renfrew,IMX,F,0,0,0,0,0,2,2
Renfrew,JE,F,2,1,2,1,2,1,9
Renfrew,JE,M,0,1,1,0,0,0,2
Renfrew,JEX,F,0,0,1,6,0,0,7
Renfrew,JEX,M,0,0,1,0,0,0,1
Renfrew,JY,F,1,0,0,0,0,2,3
Renfrew,LH,F,0,0,0,1,1,1,3
Renfrew,LHX,M,1,1,0,0,0,0,2
Renfrew,LI,F,0,0,0,0,0,1,1
Renfrew,LI,M,0,0,0,0,0,3,3
Renfrew,LIM,F,136,69,72,43,50,79,449
Renfrew,LIM,M,110,51,23,18,6,21,229
Renfrew,LIMB,F,0,0,0,0,0,2,2
Renfrew,LIMB,M,0,0,0,0,0,1,1
Renfrew,LIMBX,F,0,0,0,0,0,50,50
Renfrew,LIMR,F,0,0,0,0,0,2,2
Renfrew,LIMR,M,0,0,0,0,0,1,1
Renfrew,LIMRX,F,0,0,0,0,0,11,11
Renfrew,LIMX,F,"1,132","1,002",400,253,264,851,"3,902"
Renfrew,LIMX,M,"1,007",793,104,10,4,15,"1,933"
Renfrew,LIX,F,0,0,0,0,0,11,11
Renfrew,LIX,M,0,0,0,0,0,1,1
Renfrew,LM,F,0,0,0,0,0,96,96
Renfrew,LM,M,0,0,0,0,0,17,17
Renfrew,LMX,F,0,0,0,0,0,321,321
Renfrew,LMX,M,0,0,0,0,0,54,54
Renfrew,LR,F,0,0,0,0,1,2,3
Renfrew,LRX,F,1,0,3,0,1,2,7
Renfrew,LRX,M,0,0,0,1,0,0,1
Renfrew,LU,F,1,0,0,0,4,3,8
Renfrew,LUX,F,0,0,1,1,0,1,3
Renfrew,LUX,M,12,1,0,0,0,0,13
Renfrew,MO,F,3,2,0,4,1,0,10
Renfrew,MO,M,0,1,2,0,0,0,3
Renfrew,MOX,F,39,41,6,4,0,1,91
Renfrew,MOX,M,22,10,0,0,0,2,34
Renfrew,MRI,F,0,0,0,0,0,1,1
Renfrew,MRIX,F,5,0,0,0,0,3,8
Renfrew,MRIX,M,2,0,0,0,0,0,2
Renfrew,NRX,F,5,1,2,2,1,0,11
Renfrew,NRX,M,2,0,0,0,0,0,2
Renfrew,NS,F,0,0,0,0,0,45,45
Renfrew,OB,F,0,0,0,0,0,4,4
Renfrew,OO,F,0,0,0,0,0,10,10
Renfrew,OO,M,0,0,0,0,0,1,1
Renfrew,PA,M,0,0,0,1,0,0,1
Renfrew,PAX,F,13,0,0,0,0,0,13
Renfrew,PAX,M,22,0,0,0,0,0,22
Renfrew,PIX,F,0,0,0,0,0,1,1
Renfrew,RO,M,0,0,0,0,0,1,1
Renfrew,ROX,F,0,0,0,0,0,10,10
Renfrew,RP,F,0,0,0,0,0,1,1
Renfrew,SA,F,5,0,3,0,1,14,23
Renfrew,SA,M,4,0,0,1,1,0,6
Renfrew,SAX,F,28,5,21,5,4,84,147
Renfrew,SAX,M,42,10,0,2,0,6,60
Renfrew,SD,F,0,0,0,0,2,6,8
Renfrew,SD,M,0,2,0,0,0,0,2
Renfrew,SDX,F,1,6,7,0,0,0,14
Renfrew,SDX,M,0,1,0,0,0,0,1
Renfrew,SH,F,0,0,0,0,0,1,1
Renfrew,SHO,F,0,2,0,0,2,2,6
Renfrew,SHO,M,0,18,0,0,0,2,20
Renfrew,SHOX,F,71,56,19,29,27,48,250
Renfrew,SHOX,M,65,68,10,0,0,1,144
Renfrew,SHX,F,0,0,0,0,1,4,5
Renfrew,SM,F,50,53,35,29,25,173,365
Renfrew,SM,M,46,44,9,6,3,13,121
Renfrew,SMX,F,445,345,192,135,128,641,"1,886"
Renfrew,SMX,M,444,336,54,2,4,43,883
Renfrew,SRW,M,7,2,0,0,0,0,9
Renfrew,STX,M,0,1,0,0,0,0,1
Renfrew,SUX,M,0,1,0,0,0,0,1
Renfrew,WPX,F,7,5,1,0,0,0,13
Renfrew,WPX,M,6,1,0,0,0,0,7
Renfrew,WS,M,0,0,0,1,0,0,1
Renfrew,WSX,F,4,0,0,0,1,1,6
Renfrew,WSX,M,10,2,0,0,0,0,12
Ross & Comarty,AA,F,150,103,78,64,36,277,708
Ross & Comarty,AA,M,138,76,22,14,14,41,305
Ross & Comarty,AAX,F,879,473,295,221,234,"1,242","3,344"
Ross & Comarty,AAX,M,883,319,28,1,1,27,"1,259"
Ross & Comarty,AY,F,0,2,0,0,1,1,4
Ross & Comarty,AY,M,0,0,0,0,0,1,1
Ross & Comarty,AYX,F,0,0,0,0,0,2,2
Ross & Comarty,BA,F,0,1,0,0,2,1,4
Ross & Comarty,BA,M,0,0,1,0,1,2,4
Ross & Comarty,BAX,F,43,55,16,7,15,48,184
Ross & Comarty,BAX,M,52,43,3,1,0,2,101
Ross & Comarty,BAZ,M,0,1,0,0,0,0,1
Ross & Comarty,BAZX,F,3,4,18,10,1,6,42
Ross & Comarty,BAZX,M,3,4,0,0,0,0,7
Ross & Comarty,BB,F,0,4,0,4,1,30,39
Ross & Comarty,BB,M,1,0,0,2,0,5,8
Ross & Comarty,BBX,F,120,86,89,97,47,287,726
Ross & Comarty,BBX,M,117,31,3,2,0,3,156
Ross & Comarty,BF,F,58,93,81,81,63,66,442
Ross & Comarty,BF,M,71,37,1,0,0,4,113
Ross & Comarty,BFX,F,0,0,0,0,0,1,1
Ross & Comarty,BG,F,0,2,3,2,2,2,11
Ross & Comarty,BG,M,1,1,1,0,0,0,3
Ross & Comarty,BGX,F,1,3,0,1,0,6,11
Ross & Comarty,BGX,M,1,1,0,0,0,0,2
Ross & Comarty,BLG,F,1,1,6,3,2,47,60
Ross & Comarty,BLG,M,0,3,0,0,0,0,3
Ross & Comarty,BLGX,M,1,0,0,0,0,0,1
Ross & Comarty,BSH,F,13,7,5,5,2,2,34
Ross & Comarty,BSH,M,7,4,1,4,2,0,18
Ross & Comarty,BSHX,F,52,26,22,27,12,16,155
Ross & Comarty,BSHX,M,45,12,1,0,0,0,58
Ross & Comarty,BW,F,0,0,0,1,0,0,1
Ross & Comarty,BX,F,0,0,0,0,0,1,1
Ross & Comarty,CB,F,0,0,0,1,0,29,30
Ross & Comarty,CH,F,29,37,11,11,13,44,145
Ross & Comarty,CH,M,19,22,12,15,13,39,120
Ross & Comarty,CHX,F,"1,088",687,137,116,128,643,"2,799"
Ross & Comarty,CHX,M,"1,068",620,27,7,3,70,"1,795"
Ross & Comarty,DEX,F,7,8,4,3,0,11,33
Ross & Comarty,DEX,M,1,1,1,1,0,0,4
Ross & Comarty,DEXX,F,0,0,0,1,0,1,2
Ross & Comarty,DEXX,M,1,0,0,0,0,0,1
Ross & Comarty,FR,F,0,0,0,0,0,89,89
Ross & Comarty,FR,M,0,0,0,0,0,1,1
Ross & Comarty,FRX,F,0,0,0,0,0,1,1
Ross & Comarty,GA,F,1,1,0,0,0,6,8
Ross & Comarty,GA,M,0,0,0,0,0,1,1
Ross & Comarty,GAS,M,0,3,1,0,0,0,4
Ross & Comarty,GASX,M,0,0,2,0,0,0,2
Ross & Comarty,GAX,F,5,0,1,5,0,21,32
Ross & Comarty,GAX,M,1,0,0,0,0,0,1
Ross & Comarty,HE,F,4,0,0,0,2,29,35
Ross & Comarty,HE,M,0,0,1,0,0,3,4
Ross & Comarty,HEBLX,F,0,0,0,0,0,11,11
Ross & Comarty,HERX,F,0,0,0,0,0,3,3
Ross & Comarty,HEX,F,56,25,29,8,29,139,286
Ross & Comarty,HEX,M,36,17,0,0,0,0,53
Ross & Comarty,HF,F,50,39,13,46,54,210,412
Ross & Comarty,HF,M,27,4,0,0,0,1,32
Ross & Comarty,HFX,F,0,0,0,0,0,11,11
Ross & Comarty,HFX,M,0,0,0,0,0,1,1
Ross & Comarty,HI,F,117,103,91,64,54,339,768
Ross & Comarty,HI,M,105,87,48,23,6,22,291
Ross & Comarty,HIX,F,18,7,9,9,10,24,77
Ross & Comarty,HIX,M,9,5,6,0,0,0,20
Ross & Comarty,HL,F,0,0,0,0,0,130,130
Ross & Comarty,HL,M,0,0,0,0,0,16,16
Ross & Comarty,HLX,F,0,0,0,0,0,8,8
Ross & Comarty,HLX,M,0,0,0,0,0,2,2
Ross & Comarty,HO,F,8,2,3,0,0,4,17
Ross & Comarty,HO,M,5,0,0,0,0,0,5
Ross & Comarty,HX,F,0,0,0,0,0,1,1
Ross & Comarty,JE,F,1,1,0,1,1,3,7
Ross & Comarty,JE,M,1,0,0,0,0,0,1
Ross & Comarty,KE,F,2,3,1,1,0,3,10
Ross & Comarty,KE,M,5,0,0,1,0,0,6
Ross & Comarty,LH,F,0,1,3,2,3,2,11
Ross & Comarty,LH,M,0,2,0,0,1,1,4
Ross & Comarty,LHX,F,2,3,0,1,0,2,8
Ross & Comarty,LHX,M,3,1,0,0,0,0,4
Ross & Comarty,LI,M,0,0,0,0,0,2,2
Ross & Comarty,LIM,F,44,37,15,11,20,61,188
Ross & Comarty,LIM,M,49,52,15,19,14,57,206
Ross & Comarty,LIMBX,F,0,0,0,0,0,15,15
Ross & Comarty,LIMR,F,0,0,0,0,0,1,1
Ross & Comarty,LIMRX,F,0,0,0,0,0,39,39
Ross & Comarty,LIMX,F,"1,588",980,342,372,393,"1,021","4,696"
Ross & Comarty,LIMX,M,"1,787","1,496",78,10,4,8,"3,383"
Ross & Comarty,LIX,F,0,0,0,0,0,7,7
Ross & Comarty,LM,F,0,0,0,0,0,36,36
Ross & Comarty,LM,M,0,0,0,0,0,11,11
Ross & Comarty,LMX,F,0,0,0,0,0,660,660
Ross & Comarty,LMX,M,0,0,0,0,0,56,56
Ross & Comarty,LRX,F,0,0,0,0,0,2,2
Ross & Comarty,LU,F,6,2,4,10,5,22,49
Ross & Comarty,LU,M,3,2,0,0,0,2,7
Ross & Comarty,LUX,F,11,11,7,8,8,43,88
Ross & Comarty,LUX,M,10,13,0,0,0,0,23
Ross & Comarty,MRIX,F,0,0,0,0,0,1,1
Ross & Comarty,NS,F,0,0,0,0,0,30,30
Ross & Comarty,OB,F,0,0,0,0,0,17,17
Ross & Comarty,OB,M,0,0,0,0,0,1,1
Ross & Comarty,OD,F,0,0,0,0,0,2,2
Ross & Comarty,OO,F,0,0,0,0,0,3,3
Ross & Comarty,RO,F,0,0,0,1,0,6,7
Ross & Comarty,RO,M,0,0,1,0,0,0,1
Ross & Comarty,ROX,F,0,4,9,9,3,23,48
Ross & Comarty,SA,F,7,8,3,3,4,19,44
Ross & Comarty,SA,M,12,3,1,2,1,5,24
Ross & Comarty,SAX,F,169,92,51,27,60,388,787
Ross & Comarty,SAX,M,177,57,1,1,0,4,240
Ross & Comarty,SD,M,0,0,0,0,0,2,2
Ross & Comarty,SDX,F,20,29,10,2,1,0,62
Ross & Comarty,SDX,M,19,8,0,0,0,0,27
Ross & Comarty,SH,F,5,7,8,7,8,6,41
Ross & Comarty,SH,M,8,6,0,0,0,0,14
Ross & Comarty,SHO,F,8,4,3,3,3,24,45
Ross & Comarty,SHO,M,8,1,1,1,1,4,16
Ross & Comarty,SHOX,F,93,78,83,72,48,421,795
Ross & Comarty,SHOX,M,102,40,7,1,1,4,155
Ross & Comarty,SHX,F,2,1,0,0,2,21,26
Ross & Comarty,SHX,M,1,3,0,0,0,0,4
Ross & Comarty,SM,F,24,15,14,32,26,125,236
Ross & Comarty,SM,M,11,18,8,7,5,34,83
Ross & Comarty,SMX,F,472,377,311,231,202,"1,941","3,534"
Ross & Comarty,SMX,M,562,297,16,1,1,43,920
Ross & Comarty,SUX,F,0,0,0,0,0,2,2
Ross & Comarty,WB,F,0,0,1,0,0,0,1
Ross & Comarty,WBX,F,0,0,1,1,0,5,7
Ross & Comarty,WS,F,0,1,0,0,0,0,1
Ross & Comarty,WS,M,0,0,0,1,1,0,2
Ross & Comarty,WSX,F,5,4,10,19,15,9,62
Ross & Comarty,WSX,M,7,0,0,0,0,0,7
Roxburgh,AA,F,264,201,134,141,155,505,"1,400"
Roxburgh,AA,M,308,144,32,24,21,66,595
Roxburgh,AAX,F,"1,678","1,304",538,456,483,"2,353","6,812"
Roxburgh,AAX,M,"1,796","1,193",40,2,5,124,"3,160"
Roxburgh,ARX,M,0,1,0,0,0,0,1
Roxburgh,AY,M,1,1,0,0,0,0,2
Roxburgh,AYX,F,1,0,0,0,0,0,1
Roxburgh,AYX,M,1,0,0,0,0,0,1
Roxburgh,BA,F,8,11,6,5,1,61,92
Roxburgh,BA,M,8,8,6,5,3,21,51
Roxburgh,BABX,F,0,0,0,0,0,12,12
Roxburgh,BABX,M,0,0,0,0,0,1,1
Roxburgh,BARX,F,0,0,0,0,0,1,1
Roxburgh,BAX,F,361,336,42,43,67,355,"1,204"
Roxburgh,BAX,M,372,255,9,0,0,97,733
Roxburgh,BAZ,M,0,0,1,0,0,0,1
Roxburgh,BAZX,F,1,1,0,0,1,0,3
Roxburgh,BAZX,M,5,1,0,0,0,0,6
Roxburgh,BB,F,3,8,10,8,8,72,109
Roxburgh,BB,M,4,6,0,5,3,18,36
Roxburgh,BBX,F,392,348,148,180,148,639,"1,855"
Roxburgh,BBX,M,359,170,14,0,1,55,599
Roxburgh,BF,F,8,16,15,27,18,29,113
Roxburgh,BF,M,11,8,4,0,0,0,23
Roxburgh,BFX,F,0,0,0,1,1,7,9
Roxburgh,BFX,M,18,2,0,0,0,0,20
Roxburgh,BG,F,2,0,0,0,1,5,8
Roxburgh,BG,M,1,0,0,0,0,0,1
Roxburgh,BGX,F,0,0,1,0,0,3,4
Roxburgh,BH,F,0,0,0,0,0,23,23
Roxburgh,BLG,F,19,28,19,12,29,177,284
Roxburgh,BLG,M,4,16,2,0,0,0,22
Roxburgh,BLGX,F,0,0,0,0,0,4,4
Roxburgh,BR,F,0,0,0,0,1,0,1
Roxburgh,BSH,F,35,27,35,18,15,17,147
Roxburgh,BSH,M,43,33,8,2,4,3,93
Roxburgh,BSHX,F,83,75,41,20,6,20,245
Roxburgh,BSHX,M,73,66,0,0,0,0,139
Roxburgh,BSX,F,0,0,1,0,0,0,1
Roxburgh,CB,F,0,0,0,0,0,46,46
Roxburgh,CH,F,81,57,37,36,42,127,380
Roxburgh,CH,M,76,47,20,18,13,63,237
Roxburgh,CHX,F,"1,277",799,56,35,28,511,"2,706"
Roxburgh,CHX,M,"1,267",629,29,3,0,274,"2,202"
Roxburgh,DEV,F,0,0,0,0,0,1,1
Roxburgh,DEVX,F,0,0,0,0,0,1,1
Roxburgh,DEX,F,0,3,0,0,0,0,3
Roxburgh,DS,F,0,0,0,0,0,1,1
Roxburgh,DS,M,3,0,0,0,0,0,3
Roxburgh,DV,F,0,0,0,0,0,4,4
Roxburgh,DVX,F,0,0,0,0,0,1,1
Roxburgh,EP,F,2,0,0,0,0,0,2
Roxburgh,EP,M,2,0,0,0,0,0,2
Roxburgh,FR,F,0,0,0,0,0,39,39
Roxburgh,FR,M,0,0,0,0,0,1,1
Roxburgh,FRX,F,0,0,0,0,0,1,1
Roxburgh,FRX,M,0,0,0,0,0,1,1
Roxburgh,GA,F,77,59,65,68,69,437,775
Roxburgh,GA,M,88,23,1,2,3,9,126
Roxburgh,GAX,F,0,3,3,0,1,123,130
Roxburgh,GAX,M,3,18,0,0,0,0,21
Roxburgh,GEX,F,0,0,0,0,2,2,4
Roxburgh,GL,M,1,0,0,0,0,0,1
Roxburgh,H,F,0,0,0,0,0,4,4
Roxburgh,H,M,0,0,0,0,0,1,1
Roxburgh,HE,F,31,21,10,14,16,77,169
Roxburgh,HE,M,28,8,2,3,0,6,47
Roxburgh,HEBL,F,0,0,0,0,0,7,7
Roxburgh,HEBLX,F,0,0,0,0,0,29,29
Roxburgh,HERX,F,0,0,0,0,0,13,13
Roxburgh,HEX,F,60,143,103,60,106,431,903
Roxburgh,HEX,M,44,55,0,0,0,3,102
Roxburgh,HF,F,172,159,166,135,109,266,"1,007"
Roxburgh,HF,M,230,33,2,0,1,12,278
Roxburgh,HFX,F,1,0,1,0,0,7,9
Roxburgh,HFX,M,2,3,0,0,0,2,7
Roxburgh,HI,F,33,22,27,13,18,59,172
Roxburgh,HI,M,20,7,5,3,6,14,55
Roxburgh,HIX,F,0,1,1,1,1,8,12
Roxburgh,HIX,M,2,0,0,0,0,0,2
Roxburgh,HL,F,0,0,0,0,0,20,20
Roxburgh,HL,M,0,0,0,0,0,2,2
Roxburgh,HO,F,89,119,118,76,53,64,519
Roxburgh,HO,M,39,1,2,0,0,1,43
Roxburgh,HX,F,0,0,0,0,0,19,19
Roxburgh,JE,F,29,18,19,10,11,55,142
Roxburgh,JE,M,14,11,7,0,1,1,34
Roxburgh,JEX,F,0,0,1,2,0,2,5
Roxburgh,JEX,M,0,1,1,2,0,0,4
Roxburgh,JY,F,0,0,0,0,0,18,18
Roxburgh,JYX,F,0,0,0,0,0,2,2
Roxburgh,JYX,M,0,0,0,0,0,1,1
Roxburgh,LH,F,9,8,3,3,7,10,40
Roxburgh,LH,M,9,4,1,0,0,2,16
Roxburgh,LHX,F,2,3,0,1,0,2,8
Roxburgh,LHX,M,3,4,0,0,0,0,7
Roxburgh,LI,F,0,0,0,0,0,42,42
Roxburgh,LI,M,0,0,0,0,0,6,6
Roxburgh,LIM,F,109,74,65,70,44,234,596
Roxburgh,LIM,M,88,78,28,30,19,67,310
Roxburgh,LIMB,F,0,0,0,0,0,4,4
Roxburgh,LIMB,M,0,0,0,0,0,1,1
Roxburgh,LIMBX,F,0,0,0,0,0,148,148
Roxburgh,LIMR,F,0,0,0,0,0,1,1
Roxburgh,LIMR,M,0,0,0,0,0,2,2
Roxburgh,LIMRX,F,0,0,0,0,0,42,42
Roxburgh,LIMX,F,"2,493","1,775",626,466,559,"2,458","8,377"
Roxburgh,LIMX,M,"2,430","1,437",69,5,5,11,"3,957"
Roxburgh,LIX,F,0,0,0,0,0,348,348
Roxburgh,LM,F,0,0,0,0,0,95,95
Roxburgh,LM,M,0,0,0,0,0,49,49
Roxburgh,LMX,F,0,0,0,0,0,778,778
Roxburgh,LMX,M,0,0,0,0,0,273,273
Roxburgh,LR,F,2,2,0,3,0,3,10
Roxburgh,LR,M,1,2,0,0,1,0,4
Roxburgh,LRX,F,0,1,0,8,3,11,23
Roxburgh,LU,F,233,200,135,103,115,511,"1,297"
Roxburgh,LU,M,218,33,4,7,2,12,276
Roxburgh,LUX,F,17,27,8,8,0,19,79
Roxburgh,LUX,M,14,8,1,0,0,0,23
Roxburgh,MO,M,1,0,0,0,0,0,1
Roxburgh,MOX,F,6,6,0,0,0,1,13
Roxburgh,MOX,M,2,0,0,0,0,0,2
Roxburgh,MRI,F,0,0,0,0,0,1,1
Roxburgh,MRIX,F,1,6,6,6,1,1,21
Roxburgh,MRIX,M,0,9,4,0,0,0,13
Roxburgh,NO,F,0,2,0,4,0,1,7
Roxburgh,NO,M,0,2,0,2,0,0,4
Roxburgh,NOX,F,17,15,9,9,0,18,68
Roxburgh,NOX,M,18,1,0,0,0,0,19
Roxburgh,NS,F,0,0,0,0,0,26,26
Roxburgh,NS,M,0,0,0,0,0,2,2
Roxburgh,OB,F,0,0,0,0,0,23,23
Roxburgh,OB,M,0,0,0,0,0,9,9
Roxburgh,OE,F,0,1,0,0,0,0,1
Roxburgh,OO,F,0,0,0,0,0,31,31
Roxburgh,OO,M,0,0,0,0,0,9,9
Roxburgh,PAX,F,0,0,0,0,0,2,2
Roxburgh,PIX,F,0,0,0,0,0,4,4
Roxburgh,RP,F,0,0,0,0,0,1,1
Roxburgh,RPX,F,0,0,0,3,9,0,12
Roxburgh,RWFR,F,0,0,0,0,0,1,1
Roxburgh,SA,F,106,66,87,46,54,217,576
Roxburgh,SA,M,93,31,6,5,1,13,149
Roxburgh,SAX,F,233,196,118,115,169,795,"1,626"
Roxburgh,SAX,M,215,194,11,1,3,4,428
Roxburgh,SD,F,0,0,0,0,0,14,14
Roxburgh,SDX,F,1,3,1,0,3,8,16
Roxburgh,SDX,M,0,1,0,0,0,0,1
Roxburgh,SH,F,0,0,0,0,0,1,1
Roxburgh,SHO,F,0,1,1,6,3,31,42
Roxburgh,SHO,M,2,3,0,0,1,3,9
Roxburgh,SHOX,F,135,72,46,58,42,464,817
Roxburgh,SHOX,M,128,59,1,0,0,10,198
Roxburgh,SHX,F,1,0,1,0,1,2,5
Roxburgh,SM,F,42,58,27,20,27,180,354
Roxburgh,SM,M,57,39,7,10,12,24,149
Roxburgh,SMX,F,714,555,273,203,215,"1,066","3,026"
Roxburgh,SMX,M,696,425,15,0,0,75,"1,211"
Roxburgh,SRWX,M,1,0,0,0,0,0,1
Roxburgh,ST,M,0,2,1,0,0,0,3
Roxburgh,STX,F,3,0,0,0,0,0,3
Roxburgh,STX,M,1,0,5,0,0,0,6
Roxburgh,WB,F,0,1,4,1,1,4,11
Roxburgh,WBX,F,0,0,0,1,0,3,4
Roxburgh,WBX,M,1,0,0,0,0,0,1
Roxburgh,WP,F,0,1,4,0,0,2,7
Roxburgh,WP,M,0,0,0,0,0,1,1
Roxburgh,WS,F,1,1,2,0,1,6,11
Roxburgh,WS,M,1,1,3,1,0,5,11
Roxburgh,WSX,F,40,11,25,5,5,39,125
Roxburgh,WSX,M,65,24,9,0,0,0,98
Selkirk,AA,F,87,42,28,29,21,118,325
Selkirk,AA,M,82,20,6,2,5,10,125
Selkirk,AAX,F,268,118,76,104,61,562,"1,189"
Selkirk,AAX,M,310,40,4,2,0,8,364
Selkirk,AMX,F,0,0,0,0,0,1,1
Selkirk,AY,F,0,0,0,0,0,1,1
Selkirk,AY,M,0,0,0,7,3,0,10
Selkirk,BA,F,0,4,0,0,0,2,6
Selkirk,BA,M,0,0,1,1,0,2,4
Selkirk,BABX,F,0,0,0,0,0,1,1
Selkirk,BAX,F,45,6,3,0,0,36,90
Selkirk,BAX,M,45,0,1,0,0,5,51
Selkirk,BAZ,M,0,0,1,0,0,0,1
Selkirk,BAZX,F,1,0,0,0,0,1,2
Selkirk,BAZX,M,3,0,0,0,0,0,3
Selkirk,BB,F,5,2,2,1,2,10,22
Selkirk,BB,M,3,1,0,0,1,1,6
Selkirk,BBX,F,26,30,18,28,15,69,186
Selkirk,BBX,M,20,14,1,1,0,0,36
Selkirk,BF,F,0,0,0,0,0,1,1
Selkirk,BG,F,0,0,0,1,0,2,3
Selkirk,BG,M,0,0,0,1,0,1,2
Selkirk,BGX,F,0,0,0,0,0,2,2
Selkirk,BLG,F,31,20,29,13,22,72,187
Selkirk,BLG,M,18,1,0,0,0,0,19
Selkirk,BSH,F,0,3,2,3,0,0,8
Selkirk,BSH,M,0,1,1,1,1,0,4
Selkirk,BSHX,F,19,11,15,7,1,19,72
Selkirk,BSHX,M,21,0,0,0,0,0,21
Selkirk,BW,F,0,0,0,0,0,1,1
Selkirk,BWX,F,0,0,0,0,0,7,7
Selkirk,CB,F,0,0,0,0,0,9,9
Selkirk,CH,F,11,6,7,3,3,21,51
Selkirk,CH,M,12,7,8,5,11,11,54
Selkirk,CHX,F,446,124,9,2,16,126,723
Selkirk,CHX,M,514,89,10,0,1,78,692
Selkirk,DBX,F,0,0,0,0,0,1,1
Selkirk,DEX,M,0,1,1,0,0,0,2
Selkirk,GA,F,90,55,36,32,37,216,466
Selkirk,GA,M,70,44,26,1,3,10,154
Selkirk,GAX,F,0,1,0,0,1,53,55
Selkirk,GAX,M,0,2,0,0,0,0,2
Selkirk,GEX,F,0,0,0,1,0,6,7
Selkirk,GLX,F,0,0,0,0,0,4,4
Selkirk,HE,F,0,0,1,0,0,2,3
Selkirk,HEBLX,F,0,0,0,0,0,4,4
Selkirk,HERX,F,0,0,0,0,0,2,2
Selkirk,HEX,F,0,2,8,8,19,103,140
Selkirk,HEX,M,1,0,3,0,0,1,5
Selkirk,HF,F,0,0,0,0,0,2,2
Selkirk,HF,M,2,2,1,0,0,9,14
Selkirk,HI,F,5,0,2,8,4,16,35
Selkirk,HI,M,7,0,2,0,0,0,9
Selkirk,HL,F,0,0,0,0,0,2,2
Selkirk,HX,F,0,0,0,0,0,2,2
Selkirk,KE,F,2,0,0,0,0,5,7
Selkirk,KE,M,2,0,0,0,1,0,3
Selkirk,KEX,F,0,0,0,0,0,1,1
Selkirk,LH,F,0,0,0,0,0,6,6
Selkirk,LI,F,0,0,0,0,0,3,3
Selkirk,LIM,F,3,2,4,1,11,29,50
Selkirk,LIM,M,9,2,4,4,4,15,38
Selkirk,LIMBX,F,0,0,0,0,0,15,15
Selkirk,LIMR,M,0,0,0,0,0,1,1
Selkirk,LIMRX,F,0,0,0,0,0,7,7
Selkirk,LIMX,F,554,277,94,116,116,508,"1,665"
Selkirk,LIMX,M,504,144,5,1,0,5,659
Selkirk,LIX,F,0,0,0,0,0,17,17
Selkirk,LM,F,0,0,0,0,0,18,18
Selkirk,LM,M,0,0,0,0,0,4,4
Selkirk,LMX,F,0,0,0,0,0,220,220
Selkirk,LMX,M,0,0,0,0,0,44,44
Selkirk,LR,F,0,0,0,0,0,1,1
Selkirk,LU,F,28,26,20,14,9,74,171
Selkirk,LU,M,27,25,1,1,0,1,55
Selkirk,LUX,F,19,4,2,5,6,23,59
Selkirk,LUX,M,10,0,0,0,0,0,10
Selkirk,MAR,F,0,0,0,0,1,0,1
Selkirk,MOX,F,0,0,0,0,0,1,1
Selkirk,MRIX,F,0,0,0,1,0,0,1
Selkirk,NOX,F,0,2,6,0,0,23,31
Selkirk,NOX,M,0,0,1,0,0,0,1
Selkirk,NS,F,0,0,0,0,0,9,9
Selkirk,OB,F,0,0,0,0,0,9,9
Selkirk,OB,M,0,0,0,0,0,2,2
Selkirk,OO,F,0,0,0,0,0,3,3
Selkirk,OO,M,0,0,0,0,0,1,1
Selkirk,PAX,F,0,0,0,0,0,2,2
Selkirk,ROX,F,0,0,0,0,0,1,1
Selkirk,SA,F,18,23,5,15,1,63,125
Selkirk,SA,M,26,3,0,1,0,16,46
Selkirk,SAX,F,43,9,11,8,12,136,219
Selkirk,SAX,M,53,16,3,0,0,4,76
Selkirk,SD,M,0,0,2,0,0,0,2
Selkirk,SDX,F,0,0,0,0,0,1,1
Selkirk,SHO,F,3,5,2,3,0,6,19
Selkirk,SHO,M,4,0,0,0,1,1,6
Selkirk,SHOX,F,82,59,69,52,56,262,580
Selkirk,SHOX,M,72,8,0,0,0,1,81
Selkirk,SHX,F,0,0,0,0,0,3,3
Selkirk,SM,F,0,0,3,5,1,15,24
Selkirk,SM,M,1,3,4,4,2,5,19
Selkirk,SMX,F,188,122,120,126,76,411,"1,043"
Selkirk,SMX,M,195,78,6,6,0,36,321
Selkirk,WB,F,0,5,3,3,11,18,40
Selkirk,WB,M,0,0,8,1,0,0,9
Selkirk,WBX,F,0,0,0,1,0,4,5
Selkirk,WBX,M,0,0,1,0,0,0,1
Selkirk,WS,F,2,1,1,0,0,2,6
Selkirk,WS,M,1,0,0,1,0,1,3
Selkirk,WSX,F,0,8,16,3,4,73,104
Shetland,AA,F,34,23,32,34,26,84,233
Shetland,AA,M,49,6,4,4,4,11,78
Shetland,AAX,F,123,90,58,90,99,255,715
Shetland,AAX,M,128,26,2,1,1,10,168
Shetland,AY,F,0,0,1,2,4,4,11
Shetland,AY,M,1,0,0,0,0,0,1
Shetland,BA,F,0,0,0,0,0,1,1
Shetland,BAX,F,17,0,0,1,5,15,38
Shetland,BAX,M,19,0,0,0,0,3,22
Shetland,BBX,F,8,4,6,10,4,7,39
Shetland,BBX,M,6,0,1,0,0,0,7
Shetland,BF,F,14,19,10,2,11,9,65
Shetland,BF,M,0,2,0,0,0,0,2
Shetland,BFX,F,1,1,0,6,4,5,17
Shetland,BFX,M,0,0,0,1,0,0,1
Shetland,BHX,F,0,0,0,0,0,1,1
Shetland,BSH,F,12,8,8,15,2,10,55
Shetland,BSH,M,18,2,2,2,4,3,31
Shetland,BSHX,F,41,26,4,8,3,18,100
Shetland,BSHX,M,34,4,0,0,0,0,38
Shetland,BSX,F,0,0,2,0,0,0,2
Shetland,CB,F,0,0,0,0,0,1,1
Shetland,CD,F,0,0,0,0,0,1,1
Shetland,CH,F,3,4,1,2,2,7,19
Shetland,CH,M,5,3,4,3,4,8,27
Shetland,CHX,F,144,18,11,12,4,81,270
Shetland,CHX,M,140,17,0,0,0,17,174
Shetland,FR,F,0,0,0,0,0,14,14
Shetland,FRX,F,0,0,0,0,0,1,1
Shetland,GA,F,2,1,3,0,2,6,14
Shetland,GU,F,0,0,1,0,0,0,1
Shetland,HE,F,1,3,1,1,0,6,12
Shetland,HE,M,1,4,1,4,0,1,11
Shetland,HEX,F,23,21,15,9,9,27,104
Shetland,HEX,M,25,4,0,0,0,1,30
Shetland,HF,F,30,29,43,49,51,158,360
Shetland,HF,M,8,0,0,0,0,3,11
Shetland,HFX,F,5,10,13,7,5,9,49
Shetland,HI,F,4,2,0,1,1,5,13
Shetland,HI,M,0,1,2,1,0,1,5
Shetland,HL,F,0,0,0,0,0,4,4
Shetland,HO,F,12,0,0,3,6,11,32
Shetland,HO,M,4,0,0,1,0,1,6
Shetland,HOX,F,0,0,0,2,1,17,20
Shetland,JE,F,0,0,0,0,0,1,1
Shetland,LHX,F,1,0,0,1,0,0,2
Shetland,LIM,F,0,0,0,2,1,0,3
Shetland,LIM,M,0,0,3,5,1,6,15
Shetland,LIMBX,F,0,0,0,0,0,1,1
Shetland,LIMR,M,0,0,0,0,0,1,1
Shetland,LIMRX,F,0,0,0,0,0,3,3
Shetland,LIMX,F,103,45,39,35,25,75,322
Shetland,LIMX,M,99,30,2,0,0,0,131
Shetland,LM,F,0,0,0,0,0,3,3
Shetland,LM,M,0,0,0,0,0,3,3
Shetland,LMX,F,0,0,0,0,0,36,36
Shetland,LMX,M,0,0,0,0,0,7,7
Shetland,LU,F,9,3,3,2,3,9,29
Shetland,LU,M,2,6,2,0,0,1,11
Shetland,LUX,F,12,3,3,5,0,2,25
Shetland,LUX,M,11,0,0,0,0,0,11
Shetland,MAX,F,0,0,0,0,0,2,2
Shetland,MO,F,8,8,6,6,10,10,48
Shetland,MO,M,1,6,0,1,0,0,8
Shetland,MOX,F,10,5,0,4,0,0,19
Shetland,MOX,M,1,1,0,0,0,0,2
Shetland,NRX,F,4,0,0,0,0,0,4
Shetland,NRX,M,2,0,0,0,0,0,2
Shetland,NS,F,0,0,0,0,0,8,8
Shetland,OB,F,0,0,0,0,0,9,9
Shetland,OB,M,0,0,0,0,0,3,3
Shetland,OO,F,0,0,0,0,0,1,1
Shetland,OO,M,0,0,0,0,0,1,1
Shetland,SA,F,2,4,3,3,3,3,18
Shetland,SA,M,1,1,1,0,1,1,5
Shetland,SAX,F,27,19,10,12,14,48,130
Shetland,SAX,M,14,7,1,0,0,5,27
Shetland,SH,F,76,50,38,45,34,112,355
Shetland,SH,M,39,42,13,6,2,4,106
Shetland,SHO,F,0,2,1,0,6,27,36
Shetland,SHO,M,1,0,0,0,1,3,5
Shetland,SHOX,F,23,16,10,6,11,47,113
Shetland,SHOX,M,23,6,0,0,0,2,31
Shetland,SHX,F,9,8,4,2,10,7,40
Shetland,SHX,M,7,1,1,0,0,0,9
Shetland,SM,F,0,0,1,2,2,5,10
Shetland,SM,M,0,0,3,1,3,5,12
Shetland,SMX,F,89,34,37,32,37,125,354
Shetland,SMX,M,106,23,1,0,0,18,148
Stirling,AA,F,40,21,15,23,18,145,262
Stirling,AA,M,54,92,28,7,5,19,205
Stirling,AAX,F,346,302,186,164,167,672,"1,837"
Stirling,AAX,M,383,434,106,18,4,26,971
Stirling,ARX,F,1,0,0,0,0,0,1
Stirling,AY,F,7,4,6,10,21,42,90
Stirling,AY,M,11,1,4,4,0,5,25
Stirling,AYX,F,0,0,1,4,0,3,8
Stirling,AYX,M,1,1,0,0,0,0,2
Stirling,BA,F,8,2,3,4,3,19,39
Stirling,BA,M,11,2,3,0,2,7,25
Stirling,BABX,F,0,0,0,0,0,1,1
Stirling,BAR,F,0,0,0,0,0,2,2
Stirling,BARX,F,0,0,0,0,0,4,4
Stirling,BAX,F,98,77,45,44,39,149,452
Stirling,BAX,M,99,66,11,4,1,7,188
Stirling,BAZ,M,0,2,0,1,0,0,3
Stirling,BAZX,F,0,0,1,0,1,0,2
Stirling,BB,F,19,25,3,15,7,23,92
Stirling,BB,M,27,23,4,3,2,8,67
Stirling,BBX,F,244,281,156,103,111,292,"1,187"
Stirling,BBX,M,262,251,70,5,1,8,597
Stirling,BF,F,60,74,167,199,133,175,808
Stirling,BF,M,79,107,32,6,5,4,233
Stirling,BFX,F,1,1,4,3,2,8,19
Stirling,BFX,M,0,1,11,5,2,0,19
Stirling,BG,F,6,6,8,3,0,11,34
Stirling,BG,M,4,2,0,1,0,1,8
Stirling,BGX,F,0,0,1,3,0,8,12
Stirling,BGX,M,1,1,0,0,0,1,3
Stirling,BH,F,0,0,0,0,0,51,51
Stirling,BH,M,0,0,0,0,0,2,2
Stirling,BHX,F,0,0,0,0,0,2,2
Stirling,BHX,M,0,0,0,0,0,1,1
Stirling,BLG,F,0,0,8,7,19,19,53
Stirling,BLGX,F,0,0,0,0,0,1,1
Stirling,BR,M,0,0,1,0,0,0,1
Stirling,BS,F,1,0,1,0,0,2,4
Stirling,BS,M,0,1,0,1,0,0,2
Stirling,BSH,F,3,2,4,4,0,1,14
Stirling,BSH,M,2,3,1,0,1,2,9
Stirling,BSHX,F,3,7,8,8,2,11,39
Stirling,BSHX,M,9,15,3,0,0,0,27
Stirling,BSX,F,0,1,1,2,0,1,5
Stirling,BSX,M,1,13,2,0,0,0,16
Stirling,BWX,M,0,1,0,0,0,0,1
Stirling,CB,F,0,0,0,0,0,3,3
Stirling,CH,F,63,72,41,36,29,126,367
Stirling,CH,M,86,42,16,15,21,47,227
Stirling,CHX,F,941,685,63,75,27,349,"2,140"
Stirling,CHX,M,"1,063",846,68,2,2,98,"2,079"
Stirling,DEVX,F,0,0,0,0,1,31,32
Stirling,DEX,F,2,1,0,0,0,3,6
Stirling,DEX,M,0,2,0,1,0,0,3
Stirling,DEXX,F,0,0,0,1,0,0,1
Stirling,DG,F,0,0,0,0,0,5,5
Stirling,DSX,M,0,0,0,0,1,0,1
Stirling,FR,F,0,0,0,0,0,227,227
Stirling,FR,M,0,0,0,0,0,2,2
Stirling,FRX,F,0,0,0,0,0,2,2
Stirling,GA,F,35,32,9,7,7,63,153
Stirling,GA,M,31,38,4,3,3,2,81
Stirling,GASX,F,0,0,0,0,0,1,1
Stirling,GAX,F,1,1,1,0,4,21,28
Stirling,GAX,M,2,6,2,1,0,0,11
Stirling,GU,F,0,2,0,1,1,2,6
Stirling,GUX,F,1,1,0,0,0,0,2
Stirling,GUX,M,1,0,0,0,0,0,1
Stirling,HE,F,22,18,22,7,6,66,141
Stirling,HE,M,25,14,3,0,0,4,46
Stirling,HEBL,F,0,0,0,0,0,3,3
Stirling,HEBLX,F,0,0,0,0,0,1,1
Stirling,HERX,F,0,0,0,0,0,1,1
Stirling,HEX,F,17,21,23,33,22,168,284
Stirling,HEX,M,17,33,3,0,1,1,55
Stirling,HF,F,605,603,466,352,329,"1,125","3,480"
Stirling,HF,M,363,367,201,53,25,57,"1,066"
Stirling,HFX,F,24,31,28,13,9,19,124
Stirling,HFX,M,19,43,10,6,3,3,84
Stirling,HI,F,62,57,54,59,45,152,429
Stirling,HI,M,75,108,31,16,5,12,247
Stirling,HIX,F,9,7,3,2,13,40,74
Stirling,HIX,M,7,4,4,2,0,0,17
Stirling,HL,F,0,0,0,0,0,65,65
Stirling,HL,M,0,0,0,0,0,4,4
Stirling,HLX,F,0,0,0,0,0,6,6
Stirling,HO,F,206,226,229,232,216,351,"1,460"
Stirling,HO,M,60,15,38,14,6,14,147
Stirling,HOX,F,0,1,0,0,0,3,4
Stirling,HOX,M,1,5,0,0,0,2,8
Stirling,HX,F,0,0,0,0,0,2,2
Stirling,IM,F,0,0,0,0,0,1,1
Stirling,JE,F,97,76,121,63,62,183,602
Stirling,JE,M,45,1,2,0,0,2,50
Stirling,JEX,F,0,0,2,0,1,0,3
Stirling,JEX,M,0,2,0,0,0,0,2
Stirling,JY,F,1,0,0,0,0,18,19
Stirling,JY,M,0,0,0,0,0,2,2
Stirling,LHX,F,0,1,0,0,0,5,6
Stirling,LHX,M,0,0,0,0,1,0,1
Stirling,LI,F,0,0,0,0,0,5,5
Stirling,LI,M,0,0,0,0,0,4,4
Stirling,LIM,F,253,223,184,140,90,286,"1,176"
Stirling,LIM,M,269,186,46,34,28,50,613
Stirling,LIMB,F,0,0,0,0,0,11,11
Stirling,LIMB,M,0,0,0,0,0,1,1
Stirling,LIMBX,F,0,0,0,0,0,100,100
Stirling,LIMBX,M,0,0,0,0,0,1,1
Stirling,LIMR,F,0,0,0,0,0,46,46
Stirling,LIMR,M,0,0,0,0,0,3,3
Stirling,LIMRX,F,0,0,0,0,0,47,47
Stirling,LIMRX,M,0,0,0,0,0,3,3
Stirling,LIMX,F,"1,788","1,388",554,479,392,"1,587","6,188"
Stirling,LIMX,M,"1,783","1,516",291,42,2,26,"3,660"
Stirling,LIX,F,0,0,0,0,0,45,45
Stirling,LM,F,0,0,0,0,0,177,177
Stirling,LM,M,0,0,0,0,0,69,69
Stirling,LMX,F,0,0,0,0,0,772,772
Stirling,LMX,M,0,0,0,0,0,204,204
Stirling,LR,F,0,0,0,0,0,2,2
Stirling,LRX,F,0,0,0,0,0,16,16
Stirling,LRX,M,0,0,2,0,0,0,2
Stirling,LU,F,9,3,3,6,1,18,40
Stirling,LU,M,4,19,0,1,0,0,24
Stirling,LUX,F,2,2,1,2,2,17,26
Stirling,LUX,M,9,1,1,0,0,1,12
Stirling,MG,F,0,0,0,0,1,0,1
Stirling,MGX,F,0,0,0,0,0,2,2
Stirling,MO,F,111,72,51,25,31,74,364
Stirling,MO,M,113,54,6,1,0,0,174
Stirling,MOX,F,66,41,56,47,29,72,311
Stirling,MOX,M,68,43,18,2,0,0,131
Stirling,MRI,F,0,4,5,3,0,5,17
Stirling,MRI,M,0,4,0,0,0,0,4
Stirling,MRIX,F,2,24,31,25,16,5,103
Stirling,MRIX,M,2,17,9,0,0,0,28
Stirling,NRX,F,7,0,0,0,0,0,7
Stirling,NRX,M,7,0,0,0,0,0,7
Stirling,NS,F,0,0,0,0,0,113,113
Stirling,OB,F,0,0,0,0,0,14,14
Stirling,OD,M,0,0,0,0,0,3,3
Stirling,OO,F,0,0,0,0,0,8,8
Stirling,OO,M,0,0,0,0,0,13,13
Stirling,PA,F,3,1,0,2,0,3,9
Stirling,PA,M,0,1,0,0,1,0,2
Stirling,PAX,F,16,21,4,1,0,0,42
Stirling,PAX,M,24,7,0,0,0,0,31
Stirling,PI,F,0,0,0,0,0,1,1
Stirling,PINX,F,0,0,0,0,0,1,1
Stirling,PIX,M,1,0,0,0,0,0,1
Stirling,RO,M,0,0,0,0,0,1,1
Stirling,ROX,F,0,1,0,0,1,9,11
Stirling,ROX,M,0,3,0,0,0,5,8
Stirling,SA,F,0,1,0,1,0,13,15
Stirling,SA,M,0,1,0,1,0,1,3
Stirling,SAX,F,9,18,21,22,21,138,229
Stirling,SAX,M,8,22,2,0,0,10,42
Stirling,SBX,F,0,0,0,0,1,0,1
Stirling,SDX,M,0,1,0,0,0,0,1
Stirling,SH,F,0,0,1,0,1,2,4
Stirling,SH,M,6,0,0,0,0,0,6
Stirling,SHO,F,52,48,37,31,18,79,265
Stirling,SHO,M,47,12,1,0,1,2,63
Stirling,SHOX,F,41,37,27,28,34,136,303
Stirling,SHOX,M,27,87,7,0,0,1,122
Stirling,SHX,F,1,2,0,0,0,0,3
Stirling,SM,F,84,55,43,36,25,164,407
Stirling,SM,M,79,25,11,7,11,29,162
Stirling,SMX,F,669,471,220,242,208,"1,398","3,208"
Stirling,SMX,M,810,630,54,13,4,89,"1,600"
Stirling,STX,F,0,0,0,2,0,0,2
Stirling,WB,M,0,0,0,0,0,3,3
Stirling,WBX,F,0,0,0,0,0,2,2
Stirling,WG,F,0,0,0,0,0,1,1
Stirling,WS,M,0,1,0,0,0,0,1
Stirling,WSX,F,0,16,21,11,8,14,70
Stirling,WSX,M,0,15,1,0,0,2,18
Sutherland,AA,F,28,10,16,16,23,89,182
Sutherland,AA,M,27,10,3,3,2,5,50
Sutherland,AAX,F,137,107,84,43,74,280,725
Sutherland,AAX,M,169,60,1,0,0,3,233
Sutherland,ARX,F,1,0,0,0,0,0,1
Sutherland,ARX,M,0,0,0,0,1,0,1
Sutherland,AY,F,0,0,0,0,0,8,8
Sutherland,AY,M,1,0,0,0,0,0,1
Sutherland,BAX,F,1,1,1,0,2,7,12
Sutherland,BAX,M,1,0,0,0,0,0,1
Sutherland,BAZX,F,0,1,1,1,1,0,4
Sutherland,BB,M,0,0,0,0,0,1,1
Sutherland,BBX,F,49,22,13,11,12,28,135
Sutherland,BBX,M,38,13,0,0,0,1,52
Sutherland,BG,F,0,0,2,0,1,6,9
Sutherland,BGX,F,1,1,0,0,0,8,10
Sutherland,BGX,M,1,1,0,0,0,0,2
Sutherland,BLG,F,0,0,0,7,16,4,27
Sutherland,BLGX,F,1,2,0,0,0,1,4
Sutherland,BLGX,M,0,2,0,0,0,0,2
Sutherland,BSH,F,5,4,1,0,1,4,15
Sutherland,BSH,M,0,0,0,1,3,6,10
Sutherland,BSHX,F,30,15,26,2,0,6,79
Sutherland,BSHX,M,21,8,0,0,0,0,29
Sutherland,CB,F,0,0,0,0,0,3,3
Sutherland,CH,F,4,1,0,0,0,5,10
Sutherland,CH,M,4,1,2,2,4,8,21
Sutherland,CHX,F,194,42,34,24,34,202,530
Sutherland,CHX,M,236,14,3,0,0,12,265
Sutherland,DEX,F,2,0,1,0,0,2,5
Sutherland,DEXX,F,0,0,0,0,1,0,1
Sutherland,GA,F,13,8,13,9,5,40,88
Sutherland,GA,M,23,5,3,0,0,1,32
Sutherland,GAS,F,13,14,6,0,7,22,62
Sutherland,GAS,M,7,4,0,1,0,1,13
Sutherland,GASX,F,3,0,1,4,2,0,10
Sutherland,GASX,M,4,1,0,0,0,0,5
Sutherland,GAX,F,0,4,1,2,1,56,64
Sutherland,HE,F,0,0,0,0,1,3,4
Sutherland,HEBLX,F,0,0,0,0,0,3,3
Sutherland,HEX,,1,0,0,0,0,0,1
Sutherland,HEX,F,10,8,2,1,7,28,56
Sutherland,HEX,M,11,3,0,0,0,0,14
Sutherland,HF,F,0,1,0,0,0,0,1
Sutherland,HF,M,16,7,0,0,0,0,23
Sutherland,HFX,F,0,0,0,0,0,1,1
Sutherland,HI,F,53,48,29,30,40,183,383
Sutherland,HI,M,52,39,12,8,1,3,115
Sutherland,HIX,F,10,5,1,1,5,3,25
Sutherland,HIX,M,4,3,1,2,0,0,10
Sutherland,HL,F,0,0,0,0,0,82,82
Sutherland,HL,M,0,0,0,0,0,1,1
Sutherland,HLX,F,0,0,0,0,0,2,2
Sutherland,HO,M,3,0,0,0,0,0,3
Sutherland,JE,F,0,0,0,0,0,1,1
Sutherland,JEX,F,0,0,0,0,1,1,2
Sutherland,KE,F,0,0,3,0,0,0,3
Sutherland,LH,F,0,1,0,0,0,1,2
Sutherland,LHX,F,0,1,0,0,0,1,2
Sutherland,LI,M,0,0,0,0,0,1,1
Sutherland,LIM,F,12,5,8,7,6,5,43
Sutherland,LIM,M,2,1,3,4,3,11,24
Sutherland,LIMBX,F,0,0,0,0,0,1,1
Sutherland,LIMRX,F,0,0,0,0,0,16,16
Sutherland,LIMX,F,393,199,141,138,127,299,"1,297"
Sutherland,LIMX,M,349,66,5,5,1,4,430
Sutherland,LIX,F,0,0,0,0,0,1,1
Sutherland,LM,F,0,0,0,0,0,4,4
Sutherland,LM,M,0,0,0,0,0,1,1
Sutherland,LMX,F,0,0,0,0,0,154,154
Sutherland,LMX,M,0,0,0,0,0,22,22
Sutherland,LU,F,10,16,16,0,12,43,97
Sutherland,LU,M,10,1,1,1,0,0,13
Sutherland,LUX,F,7,3,0,0,1,5,16
Sutherland,LUX,M,10,4,0,0,0,0,14
Sutherland,MGX,F,0,0,0,0,0,1,1
Sutherland,NS,F,0,0,0,0,0,19,19
Sutherland,OB,F,0,0,0,0,0,1,1
Sutherland,OO,F,0,0,0,0,0,1,1
Sutherland,RO,F,0,0,0,0,0,1,1
Sutherland,RPX,F,0,0,0,0,0,1,1
Sutherland,SA,F,1,0,0,0,0,5,6
Sutherland,SAX,F,0,5,3,2,5,116,131
Sutherland,SAX,M,0,0,0,0,0,1,1
Sutherland,SH,F,0,0,0,1,0,2,3
Sutherland,SH,M,2,0,0,0,0,0,2
Sutherland,SHO,F,1,2,0,0,0,4,7
Sutherland,SHO,M,2,1,0,0,0,4,7
Sutherland,SHOX,F,85,69,37,30,38,149,408
Sutherland,SHOX,M,86,14,1,0,0,1,102
Sutherland,SHX,F,0,0,0,0,0,3,3
Sutherland,SHX,M,3,0,0,0,0,0,3
Sutherland,SM,F,11,11,9,5,8,29,73
Sutherland,SM,M,6,4,1,3,3,8,25
Sutherland,SMX,F,175,96,62,34,41,515,923
Sutherland,SMX,M,149,14,2,0,0,12,177
Sutherland,WS,M,0,0,1,1,0,0,2
Sutherland,WSX,F,0,9,5,0,0,6,20
West Lothian,AA,F,53,16,15,21,16,72,193
West Lothian,AA,M,85,73,10,2,2,6,178
West Lothian,AAX,F,118,198,52,72,34,127,601
West Lothian,AAX,M,143,497,55,1,0,5,701
West Lothian,AY,F,1,0,10,24,21,53,109
West Lothian,AY,M,19,21,6,0,0,0,46
West Lothian,BA,F,3,1,2,0,1,5,12
West Lothian,BA,M,4,5,1,2,2,2,16
West Lothian,BAX,F,105,28,33,12,6,82,266
West Lothian,BAX,M,108,32,11,0,0,5,156
West Lothian,BAZ,F,1,1,1,3,1,7,14
West Lothian,BAZ,M,1,1,0,0,0,1,3
West Lothian,BAZX,F,31,41,8,12,10,12,114
West Lothian,BAZX,M,30,12,2,0,0,0,44
West Lothian,BB,F,3,12,9,4,1,9,38
West Lothian,BB,M,0,9,0,4,0,2,15
West Lothian,BBX,F,94,129,59,64,51,194,591
West Lothian,BBX,M,134,99,8,0,1,9,251
West Lothian,BF,F,165,144,152,176,100,226,963
West Lothian,BF,M,150,113,35,8,7,2,315
West Lothian,BFX,F,0,2,3,0,0,1,6
West Lothian,BG,F,2,7,5,7,3,27,51
West Lothian,BG,M,4,7,2,0,0,2,15
West Lothian,BGX,F,0,2,0,0,0,0,2
West Lothian,BGX,M,0,1,0,0,0,0,1
West Lothian,BH,F,0,0,0,0,0,1,1
West Lothian,BLG,F,0,0,0,0,0,17,17
West Lothian,BLG,M,1,0,0,0,0,0,1
West Lothian,BS,F,1,1,2,0,0,0,4
West Lothian,BS,M,0,1,0,1,0,0,2
West Lothian,BSH,F,0,2,0,2,0,1,5
West Lothian,BSH,M,1,1,1,1,0,0,4
West Lothian,BSHX,F,6,33,6,1,2,14,62
West Lothian,BSHX,M,5,9,5,0,0,0,19
West Lothian,BSX,F,30,88,54,15,0,3,190
West Lothian,BSX,M,28,12,6,0,0,0,46
West Lothian,BWX,F,0,1,0,0,0,0,1
West Lothian,CB,F,0,0,0,0,0,11,11
West Lothian,CB,M,0,0,1,0,0,0,1
West Lothian,CH,F,12,12,11,2,4,14,55
West Lothian,CH,M,12,18,7,4,4,8,53
West Lothian,CHX,F,247,305,30,5,19,103,709
West Lothian,CHX,M,213,484,33,1,1,23,755
West Lothian,DEVX,F,0,0,0,0,1,1,2
West Lothian,DEVX,M,1,0,0,0,0,0,1
West Lothian,DEX,F,0,0,0,0,0,1,1
West Lothian,FR,F,0,0,0,0,0,268,268
West Lothian,FR,M,0,0,0,0,0,10,10
West Lothian,GA,F,6,1,5,5,2,18,37
West Lothian,GA,M,5,10,2,1,0,1,19
West Lothian,GAX,F,8,6,0,1,1,10,26
West Lothian,GAX,M,5,6,1,0,0,0,12
West Lothian,GB,M,0,0,0,1,0,0,1
West Lothian,HE,F,0,0,0,0,1,9,10
West Lothian,HE,M,2,3,2,0,0,0,7
West Lothian,HEBLX,F,0,0,0,0,0,2,2
West Lothian,HERX,F,0,0,0,0,0,6,6
West Lothian,HEX,F,1,3,3,5,6,27,45
West Lothian,HEX,M,0,6,3,0,0,0,9
West Lothian,HF,F,198,247,287,247,275,665,"1,919"
West Lothian,HF,M,159,189,59,3,3,40,453
West Lothian,HFX,F,3,0,0,0,8,24,35
West Lothian,HFX,M,3,0,0,0,0,0,3
West Lothian,HI,F,2,6,7,1,0,4,20
West Lothian,HI,M,3,1,1,0,0,1,6
West Lothian,HIX,F,0,0,0,0,0,2,2
West Lothian,HIX,M,0,1,0,0,0,0,1
West Lothian,HL,F,0,0,0,0,0,1,1
West Lothian,HO,F,0,0,6,4,1,1,12
West Lothian,HO,M,0,0,0,1,0,0,1
West Lothian,HOX,F,0,0,0,0,0,1,1
West Lothian,HOX,M,0,0,1,0,0,0,1
West Lothian,HX,F,0,0,0,0,0,1,1
West Lothian,JE,F,0,0,0,2,2,3,7
West Lothian,JE,M,1,0,0,0,0,0,1
West Lothian,LHX,M,0,1,0,0,0,0,1
West Lothian,LI,F,0,0,0,0,0,5,5
West Lothian,LI,M,0,0,0,0,0,1,1
West Lothian,LIM,F,83,92,34,38,23,51,321
West Lothian,LIM,M,66,117,25,7,7,6,228
West Lothian,LIMB,F,0,0,0,0,0,1,1
West Lothian,LIMBX,F,0,0,0,0,0,42,42
West Lothian,LIMR,F,0,0,0,0,0,1,1
West Lothian,LIMR,M,0,0,0,0,0,3,3
West Lothian,LIMRX,F,0,0,0,0,0,4,4
West Lothian,LIMX,F,627,778,282,199,142,430,"2,458"
West Lothian,LIMX,M,627,"1,017",94,0,3,10,"1,751"
West Lothian,LIX,F,0,0,0,0,0,14,14
West Lothian,LM,F,0,0,0,0,0,22,22
West Lothian,LM,M,0,0,0,0,0,12,12
West Lothian,LMX,F,0,0,0,0,0,140,140
West Lothian,LMX,M,0,0,0,0,0,21,21
West Lothian,LRX,F,0,1,1,0,0,0,2
West Lothian,LRX,M,0,2,1,0,0,0,3
West Lothian,LU,F,55,68,51,18,29,128,349
West Lothian,LU,M,63,34,3,3,1,3,107
West Lothian,LUX,F,1,1,1,0,0,5,8
West Lothian,LUX,M,0,2,0,0,0,0,2
West Lothian,MO,F,0,1,1,0,3,2,7
West Lothian,MO,M,4,2,4,0,0,0,10
West Lothian,MOX,F,64,15,18,0,0,0,97
West Lothian,MOX,M,67,29,12,0,0,0,108
West Lothian,MRI,F,0,0,0,0,1,0,1
West Lothian,MRIX,F,0,0,6,0,0,0,6
West Lothian,MRIX,M,0,0,2,0,0,0,2
West Lothian,NS,F,0,0,0,0,0,4,4
West Lothian,OB,F,0,0,0,0,0,1,1
West Lothian,OO,F,0,0,0,0,0,1,1
West Lothian,OO,M,0,0,0,0,0,2,2
West Lothian,PAX,F,0,0,0,0,0,1,1
West Lothian,RPX,F,0,0,1,0,0,0,1
West Lothian,SA,F,0,0,0,0,0,3,3
West Lothian,SA,M,0,4,0,1,0,1,6
West Lothian,SAX,F,26,28,12,0,4,34,104
West Lothian,SAX,M,23,9,1,0,0,11,44
West Lothian,SDX,F,27,5,9,4,5,1,51
West Lothian,SDX,M,24,6,0,0,0,0,30
West Lothian,SH,F,1,0,0,0,0,0,1
West Lothian,SHO,F,0,0,0,0,0,1,1
West Lothian,SHO,M,0,6,1,0,1,1,9
West Lothian,SHOX,F,14,21,10,12,11,27,95
West Lothian,SHOX,M,6,38,5,0,0,1,50
West Lothian,SHX,F,0,0,0,0,0,9,9
West Lothian,SHX,M,0,1,0,0,0,0,1
West Lothian,SM,F,49,41,22,20,36,75,243
West Lothian,SM,M,73,23,9,5,6,10,126
West Lothian,SMX,F,363,306,150,109,118,573,"1,619"
West Lothian,SMX,M,397,286,37,2,0,33,755
West Lothian,WB,M,0,1,0,0,0,0,1
West Lothian,WBX,M,1,0,0,0,0,0,1
West Lothian,WG,F,0,2,0,0,0,0,2
West Lothian,WSX,F,0,2,1,0,0,0,3
West Lothian,WSX,M,0,13,0,0,0,0,13
Wigtown,AA,F,293,218,196,240,182,986,"2,115"
Wigtown,AA,M,301,255,51,42,25,76,750
Wigtown,AAX,F,"1,992","1,683",819,742,845,"5,067","11,148"
Wigtown,AAX,M,"2,079","1,640",176,8,12,155,"4,070"
Wigtown,ARX,F,0,0,1,0,0,0,1
Wigtown,AY,F,403,507,449,359,336,"1,146","3,200"
Wigtown,AY,M,215,100,41,10,3,18,387
Wigtown,AYX,F,5,8,13,8,5,33,72
Wigtown,AYX,M,1,3,1,0,0,0,5
Wigtown,BA,F,2,2,2,3,7,46,62
Wigtown,BA,M,6,8,3,7,1,16,41
Wigtown,BABX,F,0,0,0,0,0,10,10
Wigtown,BALX,F,0,0,0,0,0,1,1
Wigtown,BARX,F,0,0,0,0,0,3,3
Wigtown,BAX,F,332,210,66,35,47,356,"1,046"
Wigtown,BAX,M,365,168,19,3,3,48,606
Wigtown,BAZ,F,0,0,0,0,1,0,1
Wigtown,BAZX,M,1,0,0,0,0,0,1
Wigtown,BB,F,75,40,44,35,66,214,474
Wigtown,BB,M,87,39,12,10,11,34,193
Wigtown,BBX,F,890,572,235,243,231,"1,053","3,224"
Wigtown,BBX,M,913,509,50,8,4,90,"1,574"
Wigtown,BF,F,744,742,688,680,788,"1,140","4,782"
Wigtown,BF,M,760,513,105,25,18,16,"1,437"
Wigtown,BFX,F,18,21,22,72,42,32,207
Wigtown,BFX,M,18,36,13,1,0,2,70
Wigtown,BG,F,26,18,19,9,8,70,150
Wigtown,BG,M,26,14,9,0,1,54,104
Wigtown,BGX,F,9,5,1,2,4,3,24
Wigtown,BGX,M,9,5,2,0,0,2,18
Wigtown,BH,F,7,0,0,0,0,163,170
Wigtown,BH,M,2,0,0,0,0,3,5
Wigtown,BHX,F,13,0,0,0,0,9,22
Wigtown,BHX,M,4,0,0,0,0,0,4
Wigtown,BLG,F,2,11,1,7,26,90,137
Wigtown,BLG,M,0,20,0,0,0,0,20
Wigtown,BLGX,F,0,0,0,0,0,1,1
Wigtown,BR,F,0,0,0,1,0,0,1
Wigtown,BRX,F,0,0,1,0,0,0,1
Wigtown,BRX,M,1,0,0,0,0,0,1
Wigtown,BS,F,1,15,9,8,8,19,60
Wigtown,BS,M,3,0,0,0,9,0,12
Wigtown,BSH,F,23,16,21,15,3,28,106
Wigtown,BSH,M,25,5,1,2,0,0,33
Wigtown,BSHO,F,0,0,0,0,0,1,1
Wigtown,BSHX,F,43,33,80,78,25,30,289
Wigtown,BSHX,M,25,16,2,0,0,0,43
Wigtown,BSX,F,24,25,53,29,4,25,160
Wigtown,BSX,M,11,4,2,0,1,0,18
Wigtown,BWX,F,1,0,0,0,2,0,3
Wigtown,BX,F,0,0,0,0,0,1,1
Wigtown,CAX,F,0,0,0,0,0,1,1
Wigtown,CB,F,0,1,0,0,1,52,54
Wigtown,CH,F,133,120,38,19,31,148,489
Wigtown,CH,M,182,124,36,23,27,100,492
Wigtown,CHIX,F,0,0,0,0,0,2,2
Wigtown,CHX,F,"1,972","1,013",96,55,57,610,"3,803"
Wigtown,CHX,M,"2,045",998,80,9,5,278,"3,415"
Wigtown,DEV,F,0,0,0,0,0,3,3
Wigtown,DEV,M,0,1,0,0,0,0,1
Wigtown,DEVX,F,0,1,0,1,0,6,8
Wigtown,DEX,F,3,3,4,1,2,4,17
Wigtown,DEX,M,1,4,0,0,0,1,6
Wigtown,DEXX,F,0,0,1,0,0,0,1
Wigtown,DG,F,0,0,0,0,0,2,2
Wigtown,DGX,F,0,0,0,0,0,1,1
Wigtown,DR,F,0,0,1,0,0,0,1
Wigtown,DRX,F,0,0,2,0,0,0,2
Wigtown,DS,F,18,21,26,12,30,17,124
Wigtown,DS,M,18,5,0,1,0,0,24
Wigtown,DSX,F,0,0,0,0,2,0,2
Wigtown,DV,M,0,0,0,0,0,1,1
Wigtown,DVX,F,0,0,0,0,0,10,10
Wigtown,FR,F,0,0,0,0,0,"1,787","1,787"
Wigtown,FR,M,0,0,0,0,0,51,51
Wigtown,FRX,F,0,0,0,0,0,123,123
Wigtown,FRX,M,0,0,0,0,0,1,1
Wigtown,GA,F,88,94,59,58,50,292,641
Wigtown,GA,M,101,68,29,6,5,33,242
Wigtown,GASX,F,0,0,0,0,0,3,3
Wigtown,GAX,F,38,15,25,16,13,108,215
Wigtown,GAX,M,39,17,5,4,0,7,72
Wigtown,GBX,F,0,0,0,2,0,0,2
Wigtown,GL,F,0,0,0,0,0,1,1
Wigtown,GLX,F,0,0,0,0,0,1,1
Wigtown,GU,F,1,2,3,0,3,5,14
Wigtown,GUX,F,1,0,1,0,0,0,2
Wigtown,H,F,0,0,0,0,0,9,9
Wigtown,HE,F,45,41,18,19,26,168,317
Wigtown,HE,M,41,59,14,13,15,15,157
Wigtown,HEBL,F,0,0,0,0,0,9,9
Wigtown,HEBLX,F,0,0,0,0,0,92,92
Wigtown,HER,F,0,0,0,0,0,2,2
Wigtown,HERX,F,0,0,0,0,0,8,8
Wigtown,HEX,F,212,204,85,116,84,811,"1,512"
Wigtown,HEX,M,223,200,6,1,0,15,445
Wigtown,HF,F,"3,347","3,436","3,567","3,260","2,486","7,178","23,274"
Wigtown,HF,M,"2,372","1,257",330,42,44,407,"4,452"
Wigtown,HFX,F,412,344,348,287,213,483,"2,087"
Wigtown,HFX,M,204,85,33,5,5,35,367
Wigtown,HI,F,21,12,17,20,10,40,120
Wigtown,HI,M,14,13,17,2,2,3,51
Wigtown,HIX,F,0,0,0,0,0,5,5
Wigtown,HIX,M,0,0,0,0,0,1,1
Wigtown,HL,F,0,0,0,0,0,29,29
Wigtown,HLX,F,0,0,0,0,0,1,1
Wigtown,HO,F,808,732,775,611,551,"1,160","4,637"
Wigtown,HO,M,405,215,70,15,9,11,725
Wigtown,HOX,F,23,21,42,39,42,54,221
Wigtown,HOX,M,19,14,12,0,0,0,45
Wigtown,HX,F,0,0,0,0,0,17,17
Wigtown,IM,F,0,0,0,1,0,0,1
Wigtown,IM,M,0,0,0,0,0,2,2
Wigtown,IMX,F,0,0,0,0,0,1,1
Wigtown,IMX,M,1,0,0,0,0,0,1
Wigtown,JE,F,81,93,203,170,32,181,760
Wigtown,JE,M,3,15,7,4,0,1,30
Wigtown,JEX,F,115,149,91,54,45,44,498
Wigtown,JEX,M,7,1,6,0,0,0,14
Wigtown,JY,F,45,0,0,0,0,6,51
Wigtown,JY,M,1,0,0,0,0,1,2
Wigtown,JYX,F,2,0,0,0,0,6,8
Wigtown,KE,F,0,0,0,0,0,1,1
Wigtown,LH,F,1,0,0,2,0,0,3
Wigtown,LH,M,1,0,0,1,0,0,2
Wigtown,LHX,F,11,0,0,0,0,0,11
Wigtown,LHX,M,16,1,0,0,0,0,17
Wigtown,LI,F,0,0,0,0,0,33,33
Wigtown,LI,M,0,0,0,0,0,18,18
Wigtown,LIM,F,848,659,336,228,256,660,"2,987"
Wigtown,LIM,M,784,461,140,70,76,214,"1,745"
Wigtown,LIMB,F,0,0,0,0,0,5,5
Wigtown,LIMBX,F,0,0,0,0,0,273,273
Wigtown,LIMBX,M,0,0,0,0,0,2,2
Wigtown,LIMR,F,0,0,0,0,0,28,28
Wigtown,LIMR,M,0,0,0,0,0,11,11
Wigtown,LIMRX,F,0,0,0,0,0,106,106
Wigtown,LIMRX,M,0,0,0,0,0,3,3
Wigtown,LIMX,F,"6,305","4,069","1,543","1,075","1,182","4,243","18,417"
Wigtown,LIMX,M,"6,393","3,516",497,43,55,129,"10,633"
Wigtown,LIX,F,0,0,0,0,0,145,145
Wigtown,LM,F,0,0,0,0,0,627,627
Wigtown,LM,M,0,0,0,0,0,123,123
Wigtown,LMX,F,0,0,0,0,0,"2,160","2,160"
Wigtown,LMX,M,0,0,0,0,0,815,815
Wigtown,LR,M,0,0,0,1,0,0,1
Wigtown,LRX,F,11,0,0,1,0,0,12
Wigtown,LRX,M,6,0,0,0,0,0,6
Wigtown,LU,F,2,15,3,6,10,19,55
Wigtown,LU,M,19,15,4,0,0,0,38
Wigtown,LUX,F,0,1,0,0,0,6,7
Wigtown,LUX,M,0,1,0,0,0,0,1
Wigtown,MG,F,0,0,0,0,0,1,1
Wigtown,MO,F,23,15,9,18,15,12,92
Wigtown,MO,M,25,7,4,5,2,1,44
Wigtown,MOX,F,268,143,74,41,0,0,526
Wigtown,MOX,M,246,90,8,0,0,0,344
Wigtown,MRI,F,0,1,2,0,1,1,5
Wigtown,MRI,M,0,0,0,2,0,0,2
Wigtown,MRIX,F,0,1,6,23,4,3,37
Wigtown,MRIX,M,2,0,0,0,1,1,4
Wigtown,NDX,F,0,0,0,0,0,1,1
Wigtown,NOX,F,3,4,0,3,6,14,30
Wigtown,NOX,M,2,11,0,0,0,0,13
Wigtown,NR,M,1,0,0,0,0,0,1
Wigtown,NRX,F,8,0,0,0,0,0,8
Wigtown,NRX,M,3,0,0,0,0,0,3
Wigtown,NS,F,0,0,0,0,0,185,185
Wigtown,OB,F,0,0,0,0,0,27,27
Wigtown,OB,M,0,0,0,0,0,5,5
Wigtown,OD,F,0,0,0,0,0,26,26
Wigtown,OD,M,0,0,0,0,0,1,1
Wigtown,OO,F,0,0,0,0,0,35,35
Wigtown,OO,M,0,0,0,0,0,10,10
Wigtown,PA,F,4,0,0,2,1,2,9
Wigtown,PA,M,6,1,1,0,0,2,10
Wigtown,PAX,F,38,28,14,13,6,2,101
Wigtown,PAX,M,31,16,4,0,0,0,51
Wigtown,PI,F,0,0,1,2,1,0,4
Wigtown,PIX,F,0,0,0,1,0,24,25
Wigtown,PIX,M,0,0,0,0,0,7,7
Wigtown,RO,M,0,0,0,0,0,1,1
Wigtown,ROX,F,0,1,8,0,2,4,15
Wigtown,ROX,M,0,2,11,1,0,2,16
Wigtown,RPX,F,0,0,0,0,0,1,1
Wigtown,SA,F,6,8,5,7,5,39,70
Wigtown,SA,M,17,7,7,7,3,9,50
Wigtown,SAX,F,266,147,33,78,30,444,998
Wigtown,SAX,M,302,162,7,0,0,31,502
Wigtown,SBX,F,0,0,0,0,21,24,45
Wigtown,SD,F,19,12,1,14,10,28,84
Wigtown,SD,M,9,6,2,3,2,1,23
Wigtown,SDX,F,43,50,10,26,21,49,199
Wigtown,SDX,M,49,23,1,0,0,0,73
Wigtown,SH,F,0,0,0,0,2,0,2
Wigtown,SH,M,1,2,0,0,0,0,3
Wigtown,SHO,F,4,0,0,2,14,15,35
Wigtown,SHO,M,3,1,0,0,1,2,7
Wigtown,SHOX,F,74,76,34,17,62,345,608
Wigtown,SHOX,M,64,47,3,0,0,16,130
Wigtown,SHX,F,0,0,0,0,0,4,4
Wigtown,SHX,M,1,4,0,0,0,0,5
Wigtown,SM,F,193,173,124,91,53,391,"1,025"
Wigtown,SM,M,197,112,48,28,18,140,543
Wigtown,SMX,F,"1,939","1,583",387,412,313,"2,214","6,848"
Wigtown,SMX,M,"2,173","1,345",140,7,5,317,"3,987"
Wigtown,SRW,F,0,1,1,0,0,0,2
Wigtown,SRW,M,3,0,0,0,0,0,3
Wigtown,SRWX,F,6,5,13,4,19,0,47
Wigtown,SRWX,M,5,1,0,0,0,0,6
Wigtown,STX,M,0,14,4,0,0,0,18
Wigtown,SU,F,0,0,0,0,0,1,1
Wigtown,SUX,F,0,0,0,0,1,4,5
Wigtown,SUX,M,0,9,0,0,0,0,9
Wigtown,WB,F,0,2,2,0,0,9,13
Wigtown,WBX,F,0,0,0,0,0,2,2
Wigtown,WG,F,4,5,2,2,2,9,24
Wigtown,WG,M,2,5,3,1,0,0,11
Wigtown,WGX,F,0,0,0,0,1,0,1
Wigtown,WSX,F,13,13,25,9,4,99,163
Wigtown,WSX,M,6,15,0,0,0,2,23
Totals:,,,"2,527,196","2,096,432","899,332","613,819","544,302","2,271,321","8,952,402"
,,,,,,,,,
,,,,,,Excluded from above figures,,,Totals
,,,,,,Cattle on slaughterhouses,,,"26,482"
,,,,,,Cattle entered onto CTS Admin Locations (used for management purposes),,,"268,119"
,,,,,,Cattle with anomalous movement histories (e.g. due to unreported movements),,,"64,125"
,,,,,,Grand Total,,,"9,311,128"
